Project,Files,LOC,LLOC,SLOC,h1,h2,N1,N2,N,Length,Calculated_length,Difficulty,Effort,Time,Halstead_Volume,Cyclomatic_Complexity,Maintainabilty_Index
transformers_4.23.0,./hubconf.py,161,34,36,0,0,0,0,0,0,0,0,0,0,0,1,100
transformers_4.23.0,./conftest.py,77,30,34,2,4,2,4,6,6,10,1,15.5097750043269,0.861654166907052,15.5097750043269,5,87.9601513169638
transformers_4.23.0,./setup.py,442,79,303,3,108,54,108,111,162,734.282737735818,1.5,1651.04305552308,91.7246141957265,1100.69537034872,10,62.8428640283326
transformers_4.23.0,src/transformers/generation_flax_logits_process.py,268,118,122,12,52,42,69,64,111,339.442415351991,7.96153846153846,5302.38461538462,294.576923076923,666,31,60.0977536110766
transformers_4.23.0,src/transformers/feature_extraction_utils.py,576,234,261,10,36,23,39,46,62,219.336581000797,5.41666666666667,1854.99622357581,103.055345754212,342.460841275535,69,49.0981395181566
transformers_4.23.0,src/transformers/modeling_flax_outputs.py,642,211,116,0,0,0,0,0,0,0,0,0,0,0,1,100
transformers_4.23.0,src/transformers/modeling_tf_pytorch_utils.py,492,261,323,13,115,86,161,128,247,835.337072194437,9.1,15733.9,874.105555555556,1729,93,38.2395620963628
transformers_4.23.0,src/transformers/processing_utils.py,233,99,107,8,21,14,24,29,38,116.238665878354,4.57142857142857,843.900698582161,46.8833721434534,184.603277814848,37,63.9228448522255
transformers_4.23.0,src/transformers/activations_tf.py,134,49,57,6,44,26,51,50,77,255.724766224368,3.47727272727273,1511.14249481218,83.952360822899,434.576926612654,3,72.5876169799784
transformers_4.23.0,src/transformers/optimization_tf.py,365,133,207,12,43,27,51,55,78,276.348934460844,7.11627906976744,3209.05799168387,178.280999537993,450.946057654924,47,57.9383145982043
transformers_4.23.0,src/transformers/convert_tf_hub_seq_to_seq_bert_to_pytorch.py,88,26,58,1,2,1,2,3,3,2,0.5,2.37744375108173,0.13208020839343,4.75488750216347,3,90.7293933592469
transformers_4.23.0,src/transformers/debug_utils.py,346,129,132,9,24,16,31,33,47,138.568425030289,5.8125,1378.06541848224,76.5591899156799,237.086523609847,46,56.8954203872318
transformers_4.23.0,src/transformers/tokenization_utils.py,960,395,548,18,177,115,235,195,350,1396.82483239065,11.9491525423729,31815.402625724,1767.52236809578,2662.56560981236,150,28.3342227426208
transformers_4.23.0,src/transformers/convert_pytorch_checkpoint_to_tf2.py,491,93,430,11,39,29,54,50,83,244.184434340638,7.61538461538462,3567.35125472145,198.186180817859,468.440063751302,26,49.6127026616033
transformers_4.23.0,src/transformers/modeling_flax_utils.py,1093,415,589,15,97,73,138,112,211,698.794904626279,10.6701030927835,15326.0227283871,851.445707132617,1436.35188855415,121,33.7475435894916
transformers_4.23.0,src/transformers/configuration_utils.py,946,351,399,12,101,62,119,113,181,715.498909766585,7.06930693069307,8726.72285176995,484.817936209441,1234.45239219715,108,33.6503244864282
transformers_4.23.0,src/transformers/optimization.py,671,248,290,18,133,115,210,151,325,1013.41121394762,14.2105263157895,33430.0008355671,1857.22226864262,2352.48154028065,57,43.310290623821
transformers_4.23.0,src/transformers/trainer_pt_utils.py,1086,560,580,21,248,190,358,269,548,2064.8793508543,15.1572580645161,67042.9984170403,3724.61102316891,4423.16137468103,189,18.2532710505457
transformers_4.23.0,src/transformers/modeling_utils.py,3143,1392,1766,20,501,421,748,521,1169,4579.74062528855,14.9301397205589,157518.769160301,8751.04273112783,10550.3881483036,462,0
transformers_4.23.0,src/transformers/dependency_versions_table.py,82,2,79,0,0,0,0,0,0,0,0,0,0,0,1,100
transformers_4.23.0,src/transformers/tf_utils.py,70,17,15,3,6,3,6,9,9,20.2646625064904,1.5,42.7939875194712,2.37744375108173,28.5293250129808,5,57.7414711155087
transformers_4.23.0,src/transformers/dependency_versions_check.py,47,19,19,4,7,5,9,11,14,27.6514844544032,2.57142857142857,124.539538270943,6.9188632372746,48.4320426609222,7,84.2136442035513
transformers_4.23.0,src/transformers/trainer_utils.py,696,353,394,16,117,76,146,133,222,867.832672191258,9.98290598290598,15635.9531144933,868.664061916295,1566.27270068126,98,36.9063648348187
transformers_4.23.0,src/transformers/__init__.py,5571,1059,5432,2,54,46,54,56,100,312.763925116827,1,580.73549220576,32.26308290032,580.73549220576,107,6.84080715553065
transformers_4.23.0,src/transformers/file_utils.py,137,3,112,0,0,0,0,0,0,0,0,0,0,0,1,100
transformers_4.23.0,src/transformers/trainer.py,3609,1867,2446,20,746,607,1136,766,1743,7205.54029980815,15.2278820375335,254306.12667345,14128.118148525,16700.0326142952,762,0
transformers_4.23.0,src/transformers/dynamic_module_utils.py,441,161,208,11,57,41,72,68,113,370.528478612401,6.94736842105263,4778.97872316264,265.49881795348,687.883301061288,32,55.8753103634044
transformers_4.23.0,src/transformers/modeling_flax_pytorch_utils.py,352,179,218,10,130,100,180,140,280,946.127096642573,6.92307692307692,13819.8409251549,767.768940286381,1996.19924474459,64,44.9002052352233
transformers_4.23.0,src/transformers/modeling_tf_utils.py,3057,1345,1660,19,436,341,627,455,968,3903.63898835817,13.6616972477064,116768.870826722,6487.15949037345,8547.17160756331,426,0
transformers_4.23.0,src/transformers/generation_beam_constraints.py,520,275,287,15,84,60,105,99,165,595.558022447544,9.375,10254.7860216856,569.710334538092,1093.84384231314,108,39.4089262404964
transformers_4.23.0,src/transformers/modelcard.py,893,531,650,16,252,185,367,268,552,2074.27454072198,11.6507936507937,51874.9400812602,2881.94111562557,4452.48123313269,190,10.093806460719
transformers_4.23.0,src/transformers/keras_callbacks.py,410,221,258,14,100,63,118,114,181,717.688587886279,8.26,10215.5805445771,567.532252476508,1236.75309256382,90,43.6891804311453
transformers_4.23.0,src/transformers/generation_beam_search.py,897,376,577,20,139,138,254,159,392,1075.97137100631,18.273381294964,52383.3906540829,2910.18836967127,2866.65011847147,112,31.652577019179
transformers_4.23.0,src/transformers/convert_slow_tokenizers_checkpoints_to_fast.py,126,62,80,9,17,13,24,26,37,98.0161933142366,6.35294117647059,1104.87983021717,61.3822127898425,173.91626957122,15,67.5266417336722
transformers_4.23.0,src/transformers/modeling_tf_outputs.py,947,330,180,0,0,0,0,0,0,0,0,0,0,0,1,100
transformers_4.23.0,src/transformers/hf_argparser.py,307,154,162,11,60,44,86,71,130,392.467183541521,7.88333333333333,6302.46583963905,350.136991091058,799.467125535609,68,51.8624848250685
transformers_4.23.0,src/transformers/deepspeed.py,367,163,177,11,54,36,70,65,106,348.817672921838,7.12962962962963,4551.34871203132,252.852706223962,638.370988181016,41,55.722295874026
transformers_4.23.0,src/transformers/integrations.py,1319,827,941,13,271,182,338,284,520,2238.36810654273,8.1070110701107,34356.4468605422,1908.69149225234,4237.86850214244,287,0
transformers_4.23.0,src/transformers/generation_utils.py,3448,1073,1843,21,512,529,995,533,1524,4700.23866587835,20.4052734375,281682.135995809,15649.0075553227,13804.379385485,529,0
transformers_4.23.0,src/transformers/training_args.py,1732,682,1084,17,247,186,348,264,534,2032.73357450267,11.9757085020243,51444.128372078,2858.00713178211,4295.70645973741,223,11.5306855695881
transformers_4.23.0,src/transformers/feature_extraction_sequence_utils.py,367,132,186,15,82,56,110,97,166,579.922623312811,10.0609756097561,11022.6593138723,612.369961881793,1095.58553180306,66,52.6068453579491
transformers_4.23.0,src/transformers/image_utils.py,416,190,192,16,106,76,137,122,213,777.159568183699,10.3396226415094,15263.8374526357,847.99096959087,1476.24705290089,78,45.8150743676037
transformers_4.23.0,src/transformers/pytorch_utils.py,272,114,119,12,33,26,48,45,74,209.484555947483,8.72727272727273,3546.73858148418,197.041032304677,406.397129128396,24,61.3093609830403
transformers_4.23.0,src/transformers/generation_flax_utils.py,947,391,562,23,200,171,309,223,480,1632.81316294426,17.7675,66529.1947064803,3696.06637258224,3744.43195196175,102,33.2155508238226
transformers_4.23.0,src/transformers/activations.py,176,75,80,7,39,26,51,46,77,225.782170990031,4.57692307692308,1946.63070012886,108.146150007159,425.31427061639,18,67.3142614576239
transformers_4.23.0,src/transformers/training_args_tf.py,288,87,99,4,13,7,14,17,21,56.1057163358342,2.15384615384615,184.879088511938,10.2710604728855,85.8367196662571,22,57.2791943988896
transformers_4.23.0,src/transformers/testing_utils.py,1637,710,730,19,112,76,132,131,208,843.13437402588,11.1964285714286,16379.8373958662,909.990966437012,1462.95198431979,139,25.7557268009798
transformers_4.23.0,src/transformers/generation_stopping_criteria.py,132,58,73,9,17,13,24,26,37,98.0161933142366,6.35294117647059,1104.87983021717,61.3822127898425,173.91626957122,18,71.2650560714372
transformers_4.23.0,src/transformers/convert_slow_tokenizer.py,1162,492,923,12,58,49,88,70,137,382.782447726053,9.10344827586207,7644.27269506433,424.681816392463,839.711773321461,116,18.7615904257433
transformers_4.23.0,src/transformers/generation_tf_utils.py,3384,1261,1940,24,686,643,1201,710,1844,6573.57552961186,21.0087463556851,366933.91283094,20385.2173794967,17465.7690953389,469,0
transformers_4.23.0,src/transformers/trainer_callback.py,581,292,285,14,87,52,104,101,156,613.839053047646,8.36781609195402,8691.49151348455,482.860639638031,1038.68099130928,111,39.2533186939765
transformers_4.23.0,src/transformers/convert_graph_to_onnx.py,551,207,304,9,40,24,41,49,65,241.406448808475,4.6125,1683.36019513879,93.5200108410439,364.956139867489,36,55.3520507148969
transformers_4.23.0,src/transformers/trainer_seq2seq.py,253,84,119,11,62,47,88,73,135,407.213919048997,7.80645161290323,6523.27639801968,362.404244334427,835.626315448802,39,60.4923724245282
transformers_4.23.0,src/transformers/trainer_tf.py,804,377,452,18,135,110,214,153,324,1030.42875562782,14.2666666666667,33546.5495640625,1863.69719800347,2351.39366103242,121,32.095506319636
transformers_4.23.0,src/transformers/training_args_seq2seq.py,68,18,31,0,0,0,0,0,0,0,0,0,0,0,1,100
transformers_4.23.0,src/transformers/generation_logits_process.py,750,373,386,17,171,157,256,188,413,1337.93964834674,12.7251461988304,39703.0312627864,2205.72395904369,3120.04519574286,126,31.6436493158807
transformers_4.23.0,src/transformers/tokenization_utils_fast.py,763,315,494,12,137,101,203,149,304,1015.44994537425,8.89051094890511,19511.3574190406,1083.96430105781,2194.6272302205,134,31.2696701696404
transformers_4.23.0,src/transformers/generation_tf_logits_process.py,587,262,330,12,109,107,164,121,271,780.751641409339,9.02752293577982,16926.7132688495,940.372959380526,1875.01193730142,89,41.0582638702198
transformers_4.23.0,src/transformers/tokenization_utils_base.py,3737,1306,2133,18,505,370,702,523,1072,4610.02913673374,12.5108910891089,121116.374899838,6728.68749443546,9680.87517005672,481,0
transformers_4.23.0,src/transformers/modeling_outputs.py,1033,360,196,0,0,0,0,0,0,0,0,0,0,0,1,100
transformers_4.23.0,src/transformers/models/__init__.py,172,1,154,0,0,0,0,0,0,0,0,0,0,0,1,100
transformers_4.23.0,src/transformers/models/fnet/modeling_fnet.py,1199,552,814,13,90,130,221,103,351,632.372495005505,15.9611111111111,37460.1162284649,2081.11756824805,2346.96168504131,146,20.3901005544678
transformers_4.23.0,src/transformers/models/fnet/configuration_fnet.py,121,23,42,0,0,0,0,0,0,0,0,0,0,0,2,100
transformers_4.23.0,src/transformers/models/fnet/tokenization_fnet.py,315,124,155,10,73,48,88,83,136,485.076473747115,6.02739726027397,5225.78574755891,290.321430419939,867.005362663182,40,57.3881262375828
transformers_4.23.0,src/transformers/models/fnet/tokenization_fnet_fast.py,203,56,96,5,32,22,42,37,64,171.609640474437,3.28125,1093.98520678208,60.7769559323378,333.405015400253,13,70.5114527076085
transformers_4.23.0,src/transformers/models/fnet/convert_fnet_original_flax_checkpoint_to_pytorch.py,157,54,109,1,2,1,2,3,3,2,0.5,2.37744375108173,0.13208020839343,4.75488750216347,3,81.5475413145428
transformers_4.23.0,src/transformers/models/fnet/__init__.py,111,51,80,1,6,6,6,7,12,15.5097750043269,0.5,16.8441295323456,0.935784974019201,33.6882590646913,20,72.7463367205987
transformers_4.23.0,src/transformers/models/gpt_neo/configuration_gpt_neo.py,273,112,154,7,18,11,21,25,32,94.7101344803648,4.08333333333333,606.797208797231,33.7109560442906,148.603398072791,15,67.0847832123047
transformers_4.23.0,src/transformers/models/gpt_neo/__init__.py,85,37,56,1,4,4,4,5,8,8,0.5,9.28771237954945,0.51598402108608,18.5754247590989,14,81.1815199643737
transformers_4.23.0,src/transformers/models/gpt_neo/modeling_flax_gpt_neo.py,689,324,520,15,90,64,114,105,178,642.870137603799,9.5,11353.7891703734,630.766065020745,1195.13570214457,62,32.8687666238464
transformers_4.23.0,src/transformers/models/gpt_neo/modeling_gpt_neo.py,928,454,698,17,142,151,257,159,408,1084.75095927092,15.3838028169014,45899.9793581269,2549.99885322927,2983.65624575602,122,21.1027086114209
transformers_4.23.0,src/transformers/models/gpt_neo/convert_gpt_neo_mesh_tf_to_pytorch.py,72,21,42,1,2,1,2,3,3,2,0.5,2.37744375108173,0.13208020839343,4.75488750216347,2,94.7177109941608
transformers_4.23.0,src/transformers/models/mbart50/__init__.py,62,35,35,1,4,4,4,5,8,8,0.5,9.28771237954945,0.51598402108608,18.5754247590989,14,84.368768912279
transformers_4.23.0,src/transformers/models/mbart50/tokenization_mbart50_fast.py,276,98,153,7,44,30,57,51,87,259.866475674444,4.53409090909091,2237.5784192711,124.309912181728,493.50100475152,26,63.1221681850383
transformers_4.23.0,src/transformers/models/mbart50/tokenization_mbart50.py,353,144,178,11,71,42,81,82,123,474.685793289843,6.27464788732394,4906.64223128246,272.591235071248,781.978896568024,44,55.9747744120662
transformers_4.23.0,src/transformers/models/roberta/configuration_roberta.py,83,25,31,1,2,1,2,3,3,2,0.5,2.37744375108173,0.13208020839343,4.75488750216347,4,88.3713688664662
transformers_4.23.0,src/transformers/models/roberta/convert_roberta_original_pytorch_checkpoint_to_pytorch.py,178,101,124,4,9,10,17,13,27,36.5293250129808,3.77777777777778,377.444851250391,20.9691584027995,99.9118723898095,14,66.0276282077029
transformers_4.23.0,src/transformers/models/roberta/__init__.py,168,66,135,1,8,8,8,9,16,24,0.5,25.3594000115385,1.40885555619658,50.718800023077,26,64.0053657250376
transformers_4.23.0,src/transformers/models/roberta/tokenization_roberta.py,423,176,230,15,104,68,133,119,201,755.449089620801,9.59134615384615,13292.2473509503,738.458186163907,1385.8583704249,56,50.6983829737771
transformers_4.23.0,src/transformers/models/roberta/tokenization_roberta_fast.py,307,85,156,7,41,26,50,48,76,239.311116643745,4.26829268292683,1811.70734779491,100.650408210828,424.457150054808,23,65.564562842113
transformers_4.23.0,src/transformers/models/roberta/modeling_tf_roberta.py,1721,653,1243,12,133,160,277,145,437,981.372113930312,12.4962406015038,39208.457839273,2178.24765773739,3137.62027233653,184,11.7451903172859
transformers_4.23.0,src/transformers/models/roberta/modeling_roberta.py,1571,671,1112,15,173,211,365,188,576,1344.79404231528,15.8236994219653,68855.9289093948,3825.32938385527,4351.44317856632,193,10.0816071760933
transformers_4.23.0,src/transformers/models/roberta/modeling_flax_roberta.py,1494,611,1160,14,123,124,212,137,336,907.232253065533,12.0650406504065,28774.3833279196,1598.57685155109,2384.93877987474,130,15.908319747254
transformers_4.23.0,src/transformers/models/esm/convert_esm.py,264,141,187,5,15,14,24,20,38,70.2129994085646,4,656.933070422879,36.49628169016,164.23326760572,22,59.50641988339
transformers_4.23.0,src/transformers/models/esm/tokenization_esm.py,106,67,66,2,10,5,10,12,15,35.2192809488736,1,53.7744375108174,2.98746875060096,53.7744375108174,17,71.1487894961749
transformers_4.23.0,src/transformers/models/esm/modeling_esm.py,1241,578,875,16,182,188,330,198,518,1430.41862451616,14.5054945054945,57325.8118961059,3184.76732756144,3952.00672920124,161,15.7623296782151
transformers_4.23.0,src/transformers/models/esm/configuration_esm.py,142,29,50,0,0,0,0,0,0,0,0,0,0,0,2,100
transformers_4.23.0,src/transformers/models/esm/__init__.py,67,24,40,1,2,2,2,3,4,2,0.5,3.16992500144231,0.176106944524573,6.33985000288463,8,91.4547008233048
transformers_4.23.0,src/transformers/models/gpt_neox_japanese/modeling_gpt_neox_japanese.py,724,335,453,13,121,109,190,134,299,885.28816804606,10.2066115702479,21564.1274786313,1198.00708214618,2112.76066794687,78,38.1862012007681
transformers_4.23.0,src/transformers/models/gpt_neox_japanese/__init__.py,66,25,39,1,2,2,2,3,4,2,0.5,3.16992500144231,0.176106944524573,6.33985000288463,8,91.1896589477459
transformers_4.23.0,src/transformers/models/gpt_neox_japanese/configuration_gpt_neox_japanese.py,124,26,45,0,0,0,0,0,0,0,0,0,0,0,2,100
transformers_4.23.0,src/transformers/models/gpt_neox_japanese/tokenization_gpt_neox_japanese.py,379,214,253,15,125,82,159,140,241,929.326394516889,9.54,16391.2197555788,910.623319754381,1718.15720708374,60,45.0484917661514
transformers_4.23.0,src/transformers/models/albert/tokenization_albert.py,353,123,170,10,73,48,88,83,136,485.076473747115,6.02739726027397,5225.78574755891,290.321430419939,867.005362663182,40,57.4089591558754
transformers_4.23.0,src/transformers/models/albert/modeling_tf_albert.py,1500,530,1084,10,105,124,210,115,334,738.215060303816,10,22863.9367701542,1270.21870945301,2286.39367701542,134,20.7950161002422
transformers_4.23.0,src/transformers/models/albert/convert_albert_original_tf_checkpoint_to_pytorch.py,63,20,32,1,2,1,2,3,3,2,0.5,2.37744375108173,0.13208020839343,4.75488750216347,2,95.8446982931609
transformers_4.23.0,src/transformers/models/albert/modeling_albert.py,1407,624,998,17,195,206,368,212,574,1552.91627948243,16.0410256410256,71155.2040738231,3953.06689299017,4435.82634091928,168,13.1983008628233
transformers_4.23.0,src/transformers/models/albert/__init__.py,183,79,150,1,10,10,10,11,20,33.2192809488736,0.5,34.594316186373,1.9219064547985,69.188632372746,32,59.7286893556405
transformers_4.23.0,src/transformers/models/albert/modeling_flax_albert.py,1130,452,878,12,85,84,138,97,222,587.817779580359,9.74117647058823,14272.5832823467,792.921293463705,1465.18065096554,88,23.7025219553242
transformers_4.23.0,src/transformers/models/albert/configuration_albert.py,172,39,72,1,2,1,2,3,3,2,0.5,2.37744375108173,0.13208020839343,4.75488750216347,4,83.6917548443619
transformers_4.23.0,src/transformers/models/albert/tokenization_albert_fast.py,242,57,122,5,33,23,43,38,66,178.074646413266,3.25757575757576,1128.30441539037,62.6835786327984,346.363215887277,14,70.9045626182638
transformers_4.23.0,src/transformers/models/vit/modeling_tf_vit.py,819,309,565,14,77,57,103,91,160,535.845532542314,9.36363636363636,9749.85960640677,541.658867022599,1041.24714243179,75,36.2536483787462
transformers_4.23.0,src/transformers/models/vit/__init__.py,123,65,91,1,8,8,8,9,16,24,0.5,25.3594000115385,1.40885555619658,50.718800023077,26,67.3436109156158
transformers_4.23.0,src/transformers/models/vit/feature_extraction_vit.py,149,40,59,5,20,11,21,25,32,98.0482023721841,2.625,390.083919941077,21.6713288856154,148.603398072791,20,72.030995504123
transformers_4.23.0,src/transformers/models/vit/convert_vit_timm_to_pytorch.py,250,161,182,4,17,20,29,21,49,77.4868683012558,3.41176470588235,734.292124443367,40.7940069135204,215.223553716159,28,54.8203280607518
transformers_4.23.0,src/transformers/models/vit/modeling_flax_vit.py,675,293,517,13,60,54,100,73,154,402.519152072345,10.8333333333333,10326.6906390648,573.705035503602,953.232982067523,61,32.1342070066803
transformers_4.23.0,src/transformers/models/vit/convert_dino_to_pytorch.py,219,124,150,5,11,10,16,16,26,49.6633882794471,3.63636363636364,378.181818181818,21.010101010101,104,21,62.2265837826217
transformers_4.23.0,src/transformers/models/vit/configuration_vit.py,144,38,59,0,0,0,0,0,0,0,0,0,0,0,4,100
transformers_4.23.0,src/transformers/models/vit/modeling_vit.py,821,374,558,16,134,112,202,150,314,1010.85595152134,12.0597014925373,27373.7022030312,1520.76123350173,2269.84906881571,96,30.2693986796823
transformers_4.23.0,src/transformers/models/trocr/configuration_trocr.py,153,31,66,0,0,0,0,0,0,0,0,0,0,0,2,100
transformers_4.23.0,src/transformers/models/trocr/__init__.py,63,24,36,1,2,2,2,3,4,2,0.5,3.16992500144231,0.176106944524573,6.33985000288463,8,91.9167547932775
transformers_4.23.0,src/transformers/models/trocr/processing_trocr.py,107,50,47,4,7,8,16,11,24,27.6514844544032,4.57142857142857,379.549069016206,21.0860593897892,83.0263588472952,14,73.56470321431
transformers_4.23.0,src/transformers/models/trocr/convert_trocr_unilm_to_pytorch.py,238,116,163,8,52,45,65,60,110,320.422865343337,5,3248.78982758469,180.488323754705,649.757965516937,22,57.1282003791488
transformers_4.23.0,src/transformers/models/trocr/modeling_trocr.py,1013,391,570,17,146,145,258,163,403,1119.20125389774,15.0205479452055,44483.9152014944,2471.32862230525,2961.53744615512,123,31.4277327828255
transformers_4.23.0,src/transformers/models/qdqbert/__init__.py,75,23,48,1,2,2,2,3,4,2,0.5,3.16992500144231,0.176106944524573,6.33985000288463,8,90.8165051883758
transformers_4.23.0,src/transformers/models/qdqbert/modeling_qdqbert.py,1753,776,1258,16,191,224,388,207,612,1511.28890615483,16.2513089005236,76517.8906379041,4250.993924328,4708.41401798959,218,4.38881001483466
transformers_4.23.0,src/transformers/models/qdqbert/configuration_qdqbert.py,123,24,44,0,0,0,0,0,0,0,0,0,0,0,2,100
transformers_4.23.0,src/transformers/models/phobert/tokenization_phobert.py,362,166,191,12,85,58,109,97,167,587.817779580359,7.69411764705882,8480.3444799764,471.130248887578,1102.18544464525,44,53.5304816363404
transformers_4.23.0,src/transformers/models/phobert/__init__.py,33,9,8,0,0,0,0,0,0,0,0,0,0,0,2,100
transformers_4.23.0,src/transformers/models/bort/__init__.py,0,0,0,0,0,0,0,0,0,0,0,0,0,0,1,100
transformers_4.23.0,src/transformers/models/bort/convert_bort_original_gluonnlp_checkpoint_to_pytorch.py,319,105,207,3,10,5,10,13,15,37.9741684510371,1.5,83.2598936581746,4.62554964767637,55.5065957721164,6,69.6035940930104
transformers_4.23.0,src/transformers/models/plbart/modeling_plbart.py,1741,636,1145,16,180,221,394,196,615,1412.53355733934,17.5111111111111,82005.3485478914,4555.85269710508,4683.04655413085,209,11.007929597779
transformers_4.23.0,src/transformers/models/plbart/__init__.py,85,37,56,1,4,4,4,5,8,8,0.5,9.28771237954945,0.51598402108608,18.5754247590989,14,81.1815199643737
transformers_4.23.0,src/transformers/models/plbart/tokenization_plbart.py,462,171,266,12,98,62,121,110,183,691.261114731944,7.40816326530612,9193.44784509652,510.747102505362,1240.98882757501,55,51.0014910657313
transformers_4.23.0,src/transformers/models/plbart/convert_plbart_original_checkpoint_to_torch.py,94,44,65,2,3,2,3,5,5,6.75488750216347,1,11.6096404744368,0.644980026357601,11.6096404744368,7,79.7328658111599
transformers_4.23.0,src/transformers/models/plbart/configuration_plbart.py,192,50,96,0,0,0,0,0,0,0,0,0,0,0,5,100
transformers_4.23.0,src/transformers/models/dit/__init__.py,0,0,0,0,0,0,0,0,0,0,0,0,0,0,1,100
transformers_4.23.0,src/transformers/models/dit/convert_dit_unilm_to_pytorch.py,228,112,155,5,14,12,23,19,35,64.9126093832433,4.10714285714286,610.639580057515,33.9244211143064,148.677462970525,21,61.3909289643245
transformers_4.23.0,src/transformers/models/donut/processing_donut.py,156,96,88,8,34,25,49,42,74,196.973736602512,5.76470588235294,2300.29917352892,127.794398529384,399.031489285628,32,63.4421122623057
transformers_4.23.0,src/transformers/models/donut/feature_extraction_donut.py,208,71,100,11,49,33,62,60,95,313.174530166655,6.95918367346939,3905.17797642322,216.954332023512,561.154606582809,38,64.1661722440081
transformers_4.23.0,src/transformers/models/donut/convert_donut_to_pytorch.py,234,125,179,9,42,38,71,51,109,255.006656769689,7.60714285714286,4703.45354159115,261.302974532842,618.294362274893,33,50.3923960979287
transformers_4.23.0,src/transformers/models/donut/__init__.py,76,38,48,1,4,4,4,5,8,8,0.5,9.28771237954945,0.51598402108608,18.5754247590989,14,81.9838688722816
transformers_4.23.0,src/transformers/models/donut/configuration_donut_swin.py,140,32,54,3,6,3,6,9,9,20.2646625064904,1.5,42.7939875194712,2.37744375108173,28.5293250129808,2,77.3218581581907
transformers_4.23.0,src/transformers/models/donut/modeling_donut_swin.py,941,492,611,18,197,181,327,215,508,1576.60285845887,14.9390862944162,58801.4681757443,3266.74823198579,3936.08196759145,105,27.4468707397113
transformers_4.23.0,src/transformers/models/tapex/__init__.py,34,9,8,0,0,0,0,0,0,0,0,0,0,0,2,100
transformers_4.23.0,src/transformers/models/tapex/tokenization_tapex.py,1488,435,1089,19,227,145,284,246,429,1857.33712937047,11.8854625550661,40497.7968021536,2249.87760011964,3407.33872279053,155,21.477777250025
transformers_4.23.0,src/transformers/models/xlm_roberta_xl/configuration_xlm_roberta_xl.py,155,39,64,1,2,1,2,3,3,2,0.5,2.37744375108173,0.13208020839343,4.75488750216347,4,83.4281056551258
transformers_4.23.0,src/transformers/models/xlm_roberta_xl/__init__.py,78,23,52,1,2,2,2,3,4,2,0.5,3.16992500144231,0.176106944524573,6.33985000288463,8,90.2847497769009
transformers_4.23.0,src/transformers/models/xlm_roberta_xl/modeling_xlm_roberta_xl.py,1540,673,1106,15,174,216,372,189,588,1353.67552721181,16.0344827586207,71298.9077113974,3961.05042841097,4446.59854544199,192,9.78084708367457
transformers_4.23.0,src/transformers/models/xlm_roberta_xl/convert_xlm_roberta_xl_original_pytorch_checkpoint_to_pytorch.py,183,104,126,4,9,10,17,13,27,36.5293250129808,3.77777777777778,377.444851250391,20.9691584027995,99.9118723898095,14,65.8541243962747
transformers_4.23.0,src/transformers/models/mvp/tokenization_mvp.py,404,175,211,15,104,68,133,119,201,755.449089620801,9.59134615384615,13292.2473509503,738.458186163907,1385.8583704249,56,50.7661655714477
transformers_4.23.0,src/transformers/models/mvp/__init__.py,83,38,56,1,4,4,4,5,8,8,0.5,9.28771237954945,0.51598402108608,18.5754247590989,14,80.928873413069
transformers_4.23.0,src/transformers/models/mvp/configuration_mvp.py,182,41,81,2,4,2,4,6,6,10,1,15.5097750043269,0.861654166907052,15.5097750043269,4,80.8437780780212
transformers_4.23.0,src/transformers/models/mvp/modeling_mvp.py,2056,748,1398,17,202,256,451,219,707,1616.44558781712,18.9777227722772,104316.261675434,5795.34787085744,5496.77445113803,244,3.03567040126771
transformers_4.23.0,src/transformers/models/mvp/tokenization_mvp_fast.py,287,86,133,7,41,26,50,48,76,239.311116643745,4.26829268292683,1811.70734779491,100.650408210828,424.457150054808,25,64.4750947599492
transformers_4.23.0,src/transformers/models/segformer/modeling_segformer.py,831,399,554,15,109,102,180,124,282,796.335450334813,12.3853211009174,24288.6471134338,1349.36928407966,1961.0833595291,100,31.2989932463601
transformers_4.23.0,src/transformers/models/segformer/__init__.py,117,51,88,1,6,6,6,7,12,15.5097750043269,0.5,16.8441295323456,0.935784974019201,33.6882590646913,20,71.9676260652893
transformers_4.23.0,src/transformers/models/segformer/configuration_segformer.py,176,49,80,3,6,3,6,9,9,20.2646625064904,1.5,42.7939875194712,2.37744375108173,28.5293250129808,7,78.987398037054
transformers_4.23.0,src/transformers/models/segformer/modeling_tf_segformer.py,900,392,622,15,89,83,144,104,227,634.943634290137,12.1348314606742,18457.0764190952,1025.39313439418,1520.99981601803,89,32.2652517030118
transformers_4.23.0,src/transformers/models/segformer/convert_segformer_original_to_pytorch.py,388,201,314,7,450,440,492,457,932,3985.85302050207,3.82666666666667,31513.361242298,1750.74229123878,8235.19893091412,56,34.5148431800765
transformers_4.23.0,src/transformers/models/segformer/feature_extraction_segformer.py,258,89,126,7,37,27,51,44,78,212.401258982674,4.82432432432432,2054.36936287262,114.131631270701,425.835666253709,45,61.8283871502036
transformers_4.23.0,src/transformers/models/realm/configuration_realm.py,189,33,76,0,0,0,0,0,0,0,0,0,0,0,2,100
transformers_4.23.0,src/transformers/models/realm/__init__.py,89,40,60,1,4,4,4,5,8,8,0.5,9.28771237954945,0.51598402108608,18.5754247590989,14,79.9339278310666
transformers_4.23.0,src/transformers/models/realm/retrieval_realm.py,165,90,98,8,30,26,46,38,72,171.206717868256,6.13333333333333,2317.48478993669,128.749154996483,377.850780967938,20,62.2446443857778
transformers_4.23.0,src/transformers/models/realm/tokenization_realm.py,608,264,335,17,144,89,182,161,271,1101.95606850895,10.7430555555556,21342.997216876,1185.72206760422,1986.67847396906,94,40.6387634108578
transformers_4.23.0,src/transformers/models/realm/tokenization_realm_fast.py,321,75,163,6,39,23,47,45,70,221.640461539955,3.61538461538462,1389.86128360959,77.2145157560882,384.429716743077,18,67.5940587514377
transformers_4.23.0,src/transformers/models/realm/modeling_realm.py,1857,813,1197,18,220,212,375,238,587,1786.95778700139,15.3409090909091,71093.7310969702,3949.65172760946,4634.25802706176,203,9.85011343190848
transformers_4.23.0,src/transformers/models/conditional_detr/modeling_conditional_detr.py,2647,1176,1496,21,388,376,684,409,1060,3429.00484864696,18.5103092783505,170230.326843358,9457.24038018656,9196.51445491826,266,0
transformers_4.23.0,src/transformers/models/conditional_detr/convert_conditional_detr_original_pytorch_checkpoint_to_pytorch.py,325,169,252,7,30,22,39,37,61,166.858202322659,4.55,1445.88378163032,80.3268767572397,317.776655303366,32,51.0656098026008
transformers_4.23.0,src/transformers/models/conditional_detr/__init__.py,87,37,58,1,4,4,4,5,8,8,0.5,9.28771237954945,0.51598402108608,18.5754247590989,14,80.9249967887991
transformers_4.23.0,src/transformers/models/conditional_detr/configuration_conditional_detr.py,240,70,115,0,0,0,0,0,0,0,0,0,0,0,7,100
transformers_4.23.0,src/transformers/models/conditional_detr/feature_extraction_conditional_detr.py,973,528,556,21,227,195,343,248,538,1868.86517249339,15.8656387665198,67894.7420721576,3771.93011511987,4279.35761498814,156,22.9881716255864
transformers_4.23.0,src/transformers/models/ibert/__init__.py,66,23,40,1,2,2,2,3,4,2,0.5,3.16992500144231,0.176106944524573,6.33985000288463,8,91.8578971704303
transformers_4.23.0,src/transformers/models/ibert/quant_modules.py,823,402,467,16,240,212,387,256,599,1961.65374294604,12.9,61816.8,3434.26666666667,4792,71,36.5586583362483
transformers_4.23.0,src/transformers/models/ibert/modeling_ibert.py,1373,571,1039,14,116,143,247,130,390,848.828764343605,14.9051724137931,40821.1451724415,2267.84139846897,2738.7234470811,132,17.5443882578094
transformers_4.23.0,src/transformers/models/ibert/configuration_ibert.py,147,39,66,1,2,1,2,3,3,2,0.5,2.37744375108173,0.13208020839343,4.75488750216347,4,85.6555289355881
transformers_4.23.0,src/transformers/models/reformer/modeling_reformer.py,2720,1107,1784,20,446,498,831,466,1329,4011.6399172622,18.6322869955157,219497.720044171,12194.3177802317,11780.5033862455,298,0
transformers_4.23.0,src/transformers/models/reformer/__init__.py,107,51,76,1,6,6,6,7,12,15.5097750043269,0.5,16.8441295323456,0.935784974019201,33.6882590646913,20,73.1622139871993
transformers_4.23.0,src/transformers/models/reformer/convert_reformer_trax_checkpoint_to_pytorch.py,222,91,154,6,18,19,31,24,50,90.5684250302886,5.16666666666667,1184.44864601963,65.8027025566462,229.248125036058,12,62.5579455967732
transformers_4.23.0,src/transformers/models/reformer/tokenization_reformer.py,179,72,86,6,15,9,15,21,24,74.1131339384547,3,316.246854440071,17.569269691115,105.41561814669,20,71.8688539355058
transformers_4.23.0,src/transformers/models/reformer/configuration_reformer.py,238,43,87,0,0,0,0,0,0,0,0,0,0,0,3,100
transformers_4.23.0,src/transformers/models/reformer/tokenization_reformer_fast.py,132,39,67,3,9,6,9,12,15,33.2842125151443,1.5,80.661656266226,4.48120312590145,53.7744375108174,9,81.1902706401068
transformers_4.23.0,src/transformers/models/mobilevit/convert_mlcvnets_to_pytorch.py,312,207,240,9,133,123,181,142,304,966.881888934639,6.12406015037594,13310.7863516264,739.488130645913,2173.52312432942,63,35.1348572130307
transformers_4.23.0,src/transformers/models/mobilevit/modeling_tf_mobilevit.py,1166,488,827,17,104,98,182,121,280,766.332598987929,14.875,28817.0653832487,1600.94807684715,1937.28170643689,115,23.6263305815742
transformers_4.23.0,src/transformers/models/mobilevit/configuration_mobilevit.py,185,53,85,1,2,1,2,3,3,2,0.5,2.37744375108173,0.13208020839343,4.75488750216347,6,83.8989425786344
transformers_4.23.0,src/transformers/models/mobilevit/modeling_mobilevit.py,1087,491,786,17,123,121,222,140,343,923.416152457982,15.3414634146341,37515.1566599226,2084.1753699957,2445.34407481212,125,20.3748587044368
transformers_4.23.0,src/transformers/models/mobilevit/__init__.py,120,58,89,1,7,7,7,8,14,19.6514844544032,0.5,21,1.16666666666667,42,23,69.5824312048386
transformers_4.23.0,src/transformers/models/mobilevit/feature_extraction_mobilevit.py,199,62,81,6,24,13,25,30,38,125.548875021635,3.125,582.693258228512,32.3718476793618,186.461842633124,29,66.9220240209899
transformers_4.23.0,src/transformers/models/imagegpt/feature_extraction_imagegpt.py,176,60,66,10,29,17,30,39,47,174.100729807573,5.17241379310345,1284.89950493031,71.3833058294614,248.413904286526,19,66.1256091868112
transformers_4.23.0,src/transformers/models/imagegpt/__init__.py,79,37,50,1,4,4,4,5,8,8,0.5,9.28771237954945,0.51598402108608,18.5754247590989,14,81.9700739406769
transformers_4.23.0,src/transformers/models/imagegpt/configuration_imagegpt.py,142,31,56,0,0,0,0,0,0,0,0,0,0,0,2,100
transformers_4.23.0,src/transformers/models/imagegpt/convert_imagegpt_original_tf2_to_pytorch.py,72,27,41,2,8,5,10,10,15,26,1.25,62.2861517791381,3.46034176550767,49.8289214233104,2,85.4866750136756
transformers_4.23.0,src/transformers/models/imagegpt/modeling_imagegpt.py,1208,572,829,19,251,244,426,270,670,2081.56805479707,16.1235059760956,87251.8116464038,4847.32286924466,5411.46645002406,181,13.7150212898511
transformers_4.23.0,src/transformers/models/flaubert/__init__.py,105,38,76,1,4,4,4,5,8,8,0.5,9.28771237954945,0.51598402108608,18.5754247590989,14,78.5670625626584
transformers_4.23.0,src/transformers/models/flaubert/modeling_flaubert.py,446,166,293,13,54,55,99,67,154,358.869641452662,11.9166666666667,11132.2846793551,618.460259964172,934.177735330497,46,50.5922758871237
transformers_4.23.0,src/transformers/models/flaubert/modeling_tf_flaubert.py,915,384,645,16,98,89,164,114,253,712.241564723291,13.3877551020408,23143.6957116509,1285.76087286949,1728.72117358368,91,32.0958274790202
transformers_4.23.0,src/transformers/models/flaubert/tokenization_flaubert.py,605,284,367,13,99,66,129,112,195,704.412021723716,8.46969696969697,11242.9655042256,624.6091946792,1327.43420980123,64,44.3348768525651
transformers_4.23.0,src/transformers/models/flaubert/configuration_flaubert.py,238,62,108,2,4,2,4,6,6,10,1,15.5097750043269,0.861654166907052,15.5097750043269,5,77.3983396436384
transformers_4.23.0,src/transformers/models/speech_encoder_decoder/modeling_flax_speech_encoder_decoder.py,932,275,624,12,93,77,144,105,221,651.161319441701,9.29032258064516,13785.428990594,765.85716614411,1483.84825940421,83,38.5763060527886
transformers_4.23.0,src/transformers/models/speech_encoder_decoder/convert_mbart_wav2vec2_seq2seq_original_to_pytorch.py,358,177,290,9,58,60,114,67,174,368.29222273038,8.8448275862069,9335.71126411451,518.65062578414,1055.49951913965,53,39.0794074004351
transformers_4.23.0,src/transformers/models/speech_encoder_decoder/modeling_speech_encoder_decoder.py,608,181,389,11,76,66,125,87,191,512.896238826723,9.04605263157895,11132.0923394557,618.449574414208,1230.60220770711,73,45.8785284835706
transformers_4.23.0,src/transformers/models/speech_encoder_decoder/__init__.py,64,37,36,1,4,4,4,5,8,8,0.5,9.28771237954945,0.51598402108608,18.5754247590989,14,83.7399613756134
transformers_4.23.0,src/transformers/models/speech_encoder_decoder/configuration_speech_encoder_decoder.py,121,34,36,2,5,3,6,7,9,13.6096404744368,1.2,30.3194331582221,1.68441295323456,25.2661942985184,6,69.1170415408439
transformers_4.23.0,src/transformers/models/speech_encoder_decoder/convert_speech_to_text_wav2vec2_seq2seq_original_to_pytorch.py,317,154,245,8,53,46,87,61,133,327.57978409185,6.56603773584906,5179.21220625964,287.734011458869,788.788065895864,38,43.8970171618603
transformers_4.23.0,src/transformers/models/deberta/modeling_deberta.py,1470,762,1054,19,210,243,404,229,647,1700.70218146531,18.2761904761905,92696.1957035681,5149.78865019823,5071.96485089872,200,5.1539937638482
transformers_4.23.0,src/transformers/models/deberta/__init__.py,124,52,92,1,6,6,6,7,12,15.5097750043269,0.5,16.8441295323456,0.935784974019201,33.6882590646913,20,71.4191641741579
transformers_4.23.0,src/transformers/models/deberta/tokenization_deberta_fast.py,211,51,105,3,28,18,36,31,54,139.360825319776,1.92857142857143,515.94415861029,28.6635643672384,267.526600760891,11,72.841007352305
transformers_4.23.0,src/transformers/models/deberta/tokenization_deberta.py,223,55,112,7,57,33,65,64,98,352.126215261793,3.99122807017544,2346.84210526316,130.380116959064,588,21,68.5851200728429
transformers_4.23.0,src/transformers/models/deberta/configuration_deberta.py,184,59,97,4,12,6,12,16,18,51.0195500086539,2,144,8,72,12,75.6573206659985
transformers_4.23.0,src/transformers/models/deberta/modeling_tf_deberta.py,1476,651,1085,16,187,191,324,203,515,1475.26926399899,13.8609625668449,54718.2011183537,3039.90006213076,3947.64799735037,168,9.94365890628988
transformers_4.23.0,src/transformers/models/cvt/__init__.py,59,23,32,1,2,2,2,3,4,2,0.5,3.16992500144231,0.176106944524573,6.33985000288463,8,92.6799652842344
transformers_4.23.0,src/transformers/models/cvt/convert_cvt_original_pytorch_checkpoint_to_pytorch.py,362,115,290,3,12,9,16,15,25,47.7744375108174,2,195.344529780426,10.8524738766903,97.672264890213,11,59.9814725928404
transformers_4.23.0,src/transformers/models/cvt/modeling_cvt.py,734,346,530,13,75,69,124,88,193,515.267118123025,10.7466666666667,13397.5501830931,744.308343505171,1246.670302397,84,33.401648710331
transformers_4.23.0,src/transformers/models/cvt/configuration_cvt.py,147,32,56,0,0,0,0,0,0,0,0,0,0,0,2,100
transformers_4.23.0,src/transformers/models/longformer/convert_longformer_original_pytorch_lightning_to_pytorch.py,87,32,49,1,2,1,2,3,3,2,0.5,2.37744375108173,0.13208020839343,4.75488750216347,4,90.2397471354111
transformers_4.23.0,src/transformers/models/longformer/tokenization_longformer.py,432,175,236,15,104,68,133,119,201,755.449089620801,9.59134615384615,13292.2473509503,738.458186163907,1385.8583704249,56,50.7503645047142
transformers_4.23.0,src/transformers/models/longformer/__init__.py,139,52,108,1,6,6,6,7,12,15.5097750043269,0.5,16.8441295323456,0.935784974019201,33.6882590646913,20,70.1068985562834
transformers_4.23.0,src/transformers/models/longformer/modeling_longformer.py,2347,864,1401,16,251,307,540,267,847,2064.85743204164,17.2111553784861,117507.604947737,6528.20027487429,6827.40945413936,196,11.1274269294721
transformers_4.23.0,src/transformers/models/longformer/tokenization_longformer_fast.py,96,16,66,0,0,0,0,0,0,0,0,0,0,0,1,100
transformers_4.23.0,src/transformers/models/longformer/configuration_longformer.py,227,72,114,1,4,2,4,5,6,8,0.5,6.96578428466209,0.38698801581456,13.9315685693242,11,78.6047191239632
transformers_4.23.0,src/transformers/models/longformer/modeling_tf_longformer.py,2707,904,1802,15,254,303,540,269,843,2087.72926937426,15.9448818897638,108492.847343003,6027.3804079446,6804.24277163524,198,7.91601427090701
transformers_4.23.0,src/transformers/models/trajectory_transformer/configuration_trajectory_transformer.py,167,36,70,0,0,0,0,0,0,0,0,0,0,0,2,100
transformers_4.23.0,src/transformers/models/trajectory_transformer/__init__.py,68,23,40,1,2,2,2,3,4,2,0.5,3.16992500144231,0.176106944524573,6.33985000288463,8,92.1383550729973
transformers_4.23.0,src/transformers/models/trajectory_transformer/convert_trajectory_transformer_original_pytorch_checkpoint_to_pytorch.py,70,31,28,1,2,1,2,3,3,2,0.5,2.37744375108173,0.13208020839343,4.75488750216347,3,89.8138998348558
transformers_4.23.0,src/transformers/models/trajectory_transformer/modeling_trajectory_transformer.py,617,315,415,17,125,96,177,142,273,940.209903884017,12.036,23492.8392781878,1305.1577376771,1951.88096362478,75,37.1673413384071
transformers_4.23.0,src/transformers/models/mluke/__init__.py,48,21,21,1,2,2,2,3,4,2,0.5,3.16992500144231,0.176106944524573,6.33985000288463,8,92.8814536032276
transformers_4.23.0,src/transformers/models/mluke/convert_mluke_original_pytorch_checkpoint_to_pytorch.py,229,132,159,7,42,35,61,49,96,246.128816211111,5.08333333333333,2739.97840392822,152.221022440457,539.01214503506,26,54.5497934499181
transformers_4.23.0,src/transformers/models/mluke/tokenization_mluke.py,1632,527,1106,18,431,293,577,449,870,3846.97413949336,12.0487238979118,92355.8461584997,5130.88034213887,7665.1973222248,221,9.88311281567391
transformers_4.23.0,src/transformers/models/retribert/modeling_retribert.py,220,84,135,7,21,16,32,28,48,111.890150332757,5.33333333333333,1230.68286004675,68.371270002597,230.753036258765,17,67.351432807122
transformers_4.23.0,src/transformers/models/retribert/__init__.py,77,38,48,1,4,4,4,5,8,8,0.5,9.28771237954945,0.51598402108608,18.5754247590989,14,81.9838688722816
transformers_4.23.0,src/transformers/models/retribert/configuration_retribert.py,111,25,44,0,0,0,0,0,0,0,0,0,0,0,2,100
transformers_4.23.0,src/transformers/models/retribert/tokenization_retribert_fast.py,205,50,88,5,32,18,37,37,55,171.609640474437,2.890625,828.221687426165,46.0123159681203,286.519935109592,10,70.5151890393385
transformers_4.23.0,src/transformers/models/retribert/tokenization_retribert.py,524,239,281,17,137,84,172,154,256,1041.91726366685,10.6715328467153,19852.2243223282,1102.90135124046,1860.2973544179,86,42.8862296847106
transformers_4.23.0,src/transformers/models/vit_msn/configuration_vit_msn.py,117,24,40,0,0,0,0,0,0,0,0,0,0,0,2,100
transformers_4.23.0,src/transformers/models/vit_msn/__init__.py,57,23,32,1,2,2,2,3,4,2,0.5,3.16992500144231,0.176106944524573,6.33985000288463,8,92.6799652842344
transformers_4.23.0,src/transformers/models/vit_msn/modeling_vit_msn.py,698,325,441,15,107,90,162,122,252,779.94032647905,11.3551401869159,19832.2725048131,1101.79291693406,1746.54580906585,84,36.9438374955971
transformers_4.23.0,src/transformers/models/vit_msn/convert_msn_to_pytorch.py,245,131,175,4,19,22,33,23,55,88.7106227554281,3.47368421052632,864.238415815103,48.0132453230613,248.795907583136,22,56.1985804985394
transformers_4.23.0,src/transformers/models/levit/__init__.py,75,37,48,1,4,4,4,5,8,8,0.5,9.28771237954945,0.51598402108608,18.5754247590989,14,82.2365154235863
transformers_4.23.0,src/transformers/models/levit/feature_extraction_levit.py,158,44,67,7,20,11,21,27,32,106.090046352151,3.675,559.174770254424,31.0652650141347,152.156400069231,20,72.6529581343469
transformers_4.23.0,src/transformers/models/levit/configuration_levit.py,146,39,62,1,4,2,4,5,6,8,0.5,6.96578428466209,0.38698801581456,13.9315685693242,4,82.149169584657
transformers_4.23.0,src/transformers/models/levit/convert_levit_timm_to_pytorch.py,181,81,138,3,12,9,17,15,26,47.7744375108174,2.125,215.855705407371,11.9919836337428,101.579155485821,14,60.890817718116
transformers_4.23.0,src/transformers/models/levit/modeling_levit.py,744,390,552,17,127,122,223,144,345,957.049823521321,14.9251968503937,36919.3270069346,2051.07372260748,2473.6241254976,92,27.8851069153136
transformers_4.23.0,src/transformers/models/barthez/tokenization_barthez.py,300,100,130,8,65,39,75,73,114,415.45390784685,4.61538461538462,3256.79999867225,180.93333325957,705.639999712322,31,60.1882086552957
transformers_4.23.0,src/transformers/models/barthez/__init__.py,64,35,35,1,4,4,4,5,8,8,0.5,9.28771237954945,0.51598402108608,18.5754247590989,14,84.368768912279
transformers_4.23.0,src/transformers/models/barthez/tokenization_barthez_fast.py,216,55,99,5,35,24,45,40,69,191.134546067511,3.21428571428571,1180.3276239018,65.5737568834336,367.213038547228,14,70.475531785257
transformers_4.23.0,src/transformers/models/t5/modeling_t5.py,1858,847,1358,19,305,287,532,324,819,2597.77357965275,16.5704918032787,113182.045796853,6287.89143315849,6830.33715236251,268,0
transformers_4.23.0,src/transformers/models/t5/modeling_tf_t5.py,1661,627,1212,13,207,198,362,220,560,1640.65751653819,11.3671497584541,49533.0534653004,2751.8363036278,4357.56143957381,177,12.7497172389788
transformers_4.23.0,src/transformers/models/t5/__init__.py,158,79,122,1,10,10,10,11,20,33.2192809488736,0.5,34.594316186373,1.9219064547985,69.188632372746,32,61.3564632464777
transformers_4.23.0,src/transformers/models/t5/configuration_t5.py,165,59,90,7,15,9,17,22,26,78.254843388531,3.96666666666667,459.916047602127,25.5508915334515,115.94522208457,11,74.5876240195466
transformers_4.23.0,src/transformers/models/t5/modeling_flax_t5.py,1800,675,1341,16,193,181,331,209,512,1529.34420819274,13.720207253886,54142.2411122077,3007.90228401154,3946.16787562541,152,12.8272770940735
transformers_4.23.0,src/transformers/models/t5/tokenization_t5_fast.py,237,73,128,9,44,32,61,53,93,268.744316233022,6.23863636363636,3323.30039373447,184.627799651915,532.696602274378,24,66.2527519218281
transformers_4.23.0,src/transformers/models/t5/convert_t5_original_tf_checkpoint_to_pytorch.py,60,19,30,1,2,1,2,3,3,2,0.5,2.37744375108173,0.13208020839343,4.75488750216347,2,96.3176030216455
transformers_4.23.0,src/transformers/models/t5/convert_t5x_checkpoint_to_flax.py,234,92,159,2,6,3,6,8,9,17.5097750043269,1,27,1.5,27,9,69.8514594568958
transformers_4.23.0,src/transformers/models/t5/tokenization_t5.py,339,132,177,13,87,54,104,100,158,608.641800474674,7.77011494252874,8156.51714847654,453.13984158203,1049.72927798441,44,55.9072944602496
transformers_4.23.0,src/transformers/models/maskformer/feature_extraction_maskformer.py,881,329,423,18,136,106,191,154,297,1038.95359643601,12.6397058823529,27279.4632415147,1515.52573563971,2158.23560258639,92,37.7923105012679
transformers_4.23.0,src/transformers/models/maskformer/__init__.py,74,37,46,1,4,4,4,5,8,8,0.5,9.28771237954945,0.51598402108608,18.5754247590989,14,82.5026769126246
transformers_4.23.0,src/transformers/models/maskformer/configuration_maskformer.py,205,59,94,2,7,4,8,9,12,21.6514844544032,1.14285714285714,43.4732571626374,2.41518095347986,38.0391000173078,8,76.0328775309955
transformers_4.23.0,src/transformers/models/maskformer/convert_maskformer_original_pytorch_checkpoint_to_pytorch.py,737,321,564,9,34,29,50,43,79,201.503061615492,6.61764705882353,2836.81929455382,157.601071919657,428.674915621466,40,39.001827116844
transformers_4.23.0,src/transformers/models/maskformer/modeling_maskformer.py,2599,1200,1461,20,384,378,682,404,1060,3383.06416217467,17.7604166666667,162999.850133097,9055.5472296165,9177.7041717169,271,0
transformers_4.23.0,src/transformers/models/blenderbot/configuration_blenderbot.py,400,162,274,6,25,17,31,31,48,131.606179748695,3.72,884.621293182681,49.1456273990378,237.80142289857,34,57.7089291080966
transformers_4.23.0,src/transformers/models/blenderbot/__init__.py,146,66,111,1,8,8,8,9,16,24,0.5,25.3594000115385,1.40885555619658,50.718800023077,26,65.5742131178831
transformers_4.23.0,src/transformers/models/blenderbot/convert_blenderbot_original_pytorch_checkpoint_to_pytorch.py,114,60,76,3,10,5,10,13,15,37.9741684510371,1.5,83.2598936581746,4.62554964767637,55.5065957721164,12,72.5411890301915
transformers_4.23.0,src/transformers/models/blenderbot/modeling_flax_blenderbot.py,1507,609,1140,14,146,146,261,160,407,1103.01735450529,12.513698630137,37291.1314393781,2071.72952440989,2980.02473461916,146,14.7638030694853
transformers_4.23.0,src/transformers/models/blenderbot/modeling_blenderbot.py,1619,579,1032,16,158,187,335,174,522,1217.99735821198,16.9620253164557,65901.1407148895,3661.17448416053,3885.21650483304,189,15.9578421840469
transformers_4.23.0,src/transformers/models/blenderbot/tokenization_blenderbot.py,427,188,218,15,98,64,124,113,188,706.844923657418,9.48979591836735,12167.7560182518,675.986445458431,1282.19364493406,60,49.6816659915356
transformers_4.23.0,src/transformers/models/blenderbot/tokenization_blenderbot_fast.py,312,99,138,9,36,24,45,45,69,214.646625064904,5.625,2131.52548301296,118.418082389609,378.937863646748,27,62.2137428173594
transformers_4.23.0,src/transformers/models/blenderbot/modeling_tf_blenderbot.py,1476,502,1027,14,124,143,251,138,394,915.623311396779,14.1693548387097,39684.9429306479,2204.71905170266,2800.7586359706,144,22.2442852347088
transformers_4.23.0,src/transformers/models/pegasus_x/__init__.py,62,23,34,1,2,2,2,3,4,2,0.5,3.16992500144231,0.176106944524573,6.33985000288463,8,92.6799652842344
transformers_4.23.0,src/transformers/models/pegasus_x/configuration_pegasus_x.py,183,43,80,0,0,0,0,0,0,0,0,0,0,0,4,100
transformers_4.23.0,src/transformers/models/pegasus_x/modeling_pegasus_x.py,1692,667,1067,16,166,189,336,182,525,1288.25654560359,16.1927710843373,63825.2999774,3545.84999874444,3941.59218610432,169,17.7060544881202
transformers_4.23.0,src/transformers/models/nezha/__init__.py,74,23,46,1,2,2,2,3,4,2,0.5,3.16992500144231,0.176106944524573,6.33985000288463,8,91.4389435481603
transformers_4.23.0,src/transformers/models/nezha/configuration_nezha.py,110,25,47,0,0,0,0,0,0,0,0,0,0,0,2,100
transformers_4.23.0,src/transformers/models/nezha/modeling_nezha.py,1719,771,1227,16,182,214,371,198,585,1430.41862451616,16.3076923076923,72784.0621555595,4043.55900864219,4463.17362274657,205,6.49259030425104
transformers_4.23.0,src/transformers/models/dpr/modeling_tf_dpr.py,792,246,515,9,25,41,72,34,113,144.625729757349,12.96,7450.4875817543,413.915976764128,574.883301061288,60,45.9715914795052
transformers_4.23.0,src/transformers/models/dpr/modeling_dpr.py,676,231,415,9,30,55,100,39,155,175.736042881236,15,12288.5601588547,682.69778660304,819.237343923649,60,47.2598690345134
transformers_4.23.0,src/transformers/models/dpr/__init__.py,152,52,120,1,6,6,6,7,12,15.5097750043269,0.5,16.8441295323456,0.935784974019201,33.6882590646913,20,69.2537504963292
transformers_4.23.0,src/transformers/models/dpr/configuration_dpr.py,132,25,59,0,0,0,0,0,0,0,0,0,0,0,2,100
transformers_4.23.0,src/transformers/models/dpr/tokenization_dpr_fast.py,411,123,296,13,49,41,74,62,115,323.226498697479,9.81632653061224,6721.55854916429,373.419919398016,684.732575694491,32,54.2639028222691
transformers_4.23.0,src/transformers/models/dpr/convert_dpr_original_checkpoint_to_pytorch.py,143,94,103,6,14,10,17,20,27,68.8127439131334,3.64285714285714,425.092499047136,23.6162499470631,116.692058561959,23,61.668448329815
transformers_4.23.0,src/transformers/models/dpr/tokenization_dpr.py,411,122,297,14,49,41,74,63,115,328.423751270452,10.5714285714286,7266.66459271204,403.703588484002,687.38719120249,32,54.3023534383743
transformers_4.23.0,src/transformers/models/nystromformer/modeling_nystromformer.py,1127,533,841,15,136,176,292,151,468,1022.49830534417,16.1029411764706,54549.895481096,3030.54974894978,3387.57341800414,138,16.6347113834966
transformers_4.23.0,src/transformers/models/nystromformer/__init__.py,72,23,44,1,2,2,2,3,4,2,0.5,3.16992500144231,0.176106944524573,6.33985000288463,8,91.6811790568426
transformers_4.23.0,src/transformers/models/nystromformer/convert_nystromformer_original_pytorch_checkpoint_to_pytorch.py,112,65,76,6,31,25,49,37,74,169.08986062632,4.74193548387097,1828.01399068747,101.556332815971,385.499549056542,22,62.6595934697162
transformers_4.23.0,src/transformers/models/nystromformer/configuration_nystromformer.py,133,27,49,0,0,0,0,0,0,0,0,0,0,0,2,100
transformers_4.23.0,src/transformers/models/wavlm/convert_wavlm_original_s3prl_checkpoint_to_pytorch.py,110,59,70,1,2,1,2,3,3,2,0.5,2.37744375108173,0.13208020839343,4.75488750216347,7,80.6205714250733
transformers_4.23.0,src/transformers/models/wavlm/modeling_wavlm.py,1844,855,1287,19,232,273,477,251,750,1903.76221362502,19.5323275862069,116777.100047612,6487.61666931177,5978.65766546308,222,2.19936571055682
transformers_4.23.0,src/transformers/models/wavlm/convert_wavlm_original_pytorch_checkpoint_to_pytorch.py,208,107,154,9,53,46,88,62,134,332.10910910483,7.47169811320755,5961.38628328999,331.188126849444,797.862305591841,37,50.6882652383361
transformers_4.23.0,src/transformers/models/wavlm/__init__.py,63,23,38,1,2,2,2,3,4,2,0.5,3.16992500144231,0.176106944524573,6.33985000288463,8,92.0976746936954
transformers_4.23.0,src/transformers/models/wavlm/configuration_wavlm.py,339,73,141,2,9,5,11,11,16,30.5293250129808,1.22222222222222,67.6511072089072,3.75839484493929,55.3509058981968,7,68.360102025498
transformers_4.23.0,src/transformers/models/x_clip/modeling_x_clip.py,1497,615,941,17,172,185,323,189,508,1346.80440611002,15.9622093023256,61320.7289561341,3406.70716422967,3841.61915150431,135,22.1225497122306
transformers_4.23.0,src/transformers/models/x_clip/processing_x_clip.py,109,31,26,3,7,9,18,10,27,24.4063719565667,3.85714285714286,345.955083024698,19.2197268347055,89.6920585619588,12,47.5288313941766
transformers_4.23.0,src/transformers/models/x_clip/__init__.py,73,24,48,1,2,2,2,3,4,2,0.5,3.16992500144231,0.176106944524573,6.33985000288463,8,90.4133088412504
transformers_4.23.0,src/transformers/models/x_clip/configuration_x_clip.py,368,100,154,5,16,10,22,21,32,75.6096404744368,3.4375,483.154916505664,26.8419398058702,140.55415752892,18,64.169285615364
transformers_4.23.0,src/transformers/models/x_clip/convert_x_clip_original_pytorch_to_hf.py,387,253,322,8,71,77,146,79,223,460.632045484832,8.22535211267606,11562.7320337549,642.374001875274,1405.74310684349,67,33.8097659700391
transformers_4.23.0,src/transformers/models/sew/__init__.py,60,23,34,1,2,2,2,3,4,2,0.5,3.16992500144231,0.176106944524573,6.33985000288463,8,92.5173434722518
transformers_4.23.0,src/transformers/models/sew/modeling_sew.py,1218,569,838,19,173,188,327,192,515,1366.90130613658,17.9566473988439,70143.2560368352,3896.84755760196,3906.2556878714,148,17.586609778638
transformers_4.23.0,src/transformers/models/sew/convert_sew_original_pytorch_checkpoint_to_pytorch.py,305,180,243,10,65,54,102,75,156,424.673188795723,7.84615384615385,7624.07407716696,423.55967095372,971.695715717357,51,40.0969604825372
transformers_4.23.0,src/transformers/models/sew/configuration_sew.py,252,53,102,2,7,4,9,9,13,21.6514844544032,1.28571428571429,52.9830321669644,2.94350178705358,41.2090250187501,6,71.4766935552031
transformers_4.23.0,src/transformers/models/clip/modeling_flax_clip.py,1180,460,872,15,91,100,176,106,276,650.812671192209,14.5054945054945,26935.3404396315,1496.40780220175,1856.90604545944,106,22.3932465352785
transformers_4.23.0,src/transformers/models/clip/__init__.py,177,81,142,1,10,10,10,11,20,33.2192809488736,0.5,34.594316186373,1.9219064547985,69.188632372746,32,59.9171783034246
transformers_4.23.0,src/transformers/models/clip/tokenization_clip.py,523,281,311,17,168,110,222,185,332,1311.39619532809,11.2321428571429,28085.0594220839,1560.28107900466,2500.41864489142,96,38.4720873612017
transformers_4.23.0,src/transformers/models/clip/processing_clip.py,107,31,26,3,7,9,18,10,27,24.4063719565667,3.85714285714286,345.955083024698,19.2197268347055,89.6920585619588,12,48.9891926560218
transformers_4.23.0,src/transformers/models/clip/tokenization_clip_fast.py,175,49,86,4,25,19,37,29,56,124.096404744368,2.96,805.258929752346,44.7366072084637,272.046935727144,9,73.8619689295218
transformers_4.23.0,src/transformers/models/clip/configuration_clip.py,373,112,176,5,16,10,22,21,32,75.6096404744368,3.4375,483.154916505664,26.8419398058702,140.55415752892,24,65.4978343534348
transformers_4.23.0,src/transformers/models/clip/modeling_clip.py,1076,418,683,13,126,127,224,139,351,927.242986696824,11.5555555555556,28874.4249909665,1604.13472172036,2498.74831652595,97,32.0622993740294
transformers_4.23.0,src/transformers/models/clip/feature_extraction_clip.py,165,47,71,5,25,14,28,30,42,127.706045218805,2.8,577.050334043562,32.058351891309,206.089405015558,26,70.2537102930574
transformers_4.23.0,src/transformers/models/clip/convert_clip_original_pytorch_to_hf.py,148,75,75,2,4,2,4,6,6,10,1,15.5097750043269,0.861654166907052,15.5097750043269,6,78.0359973581544
transformers_4.23.0,src/transformers/models/clip/modeling_tf_clip.py,1415,449,921,13,104,96,165,117,261,744.951447022508,10.3125,18492.0160405537,1027.33422447521,1793.16519181127,91,31.5204861113578
transformers_4.23.0,src/transformers/models/squeezebert/tokenization_squeezebert.py,517,238,288,17,137,84,172,154,256,1041.91726366685,10.6715328467153,19852.2243223282,1102.90135124046,1860.2973544179,86,42.8911161215739
transformers_4.23.0,src/transformers/models/squeezebert/tokenization_squeezebert_fast.py,212,49,101,5,32,18,37,37,55,171.609640474437,2.890625,828.221687426165,46.0123159681203,286.519935109592,10,72.7343760300529
transformers_4.23.0,src/transformers/models/squeezebert/__init__.py,97,38,68,1,4,4,4,5,8,8,0.5,9.28771237954945,0.51598402108608,18.5754247590989,14,79.4552471452037
transformers_4.23.0,src/transformers/models/squeezebert/configuration_squeezebert.py,176,44,76,1,2,1,2,3,3,2,0.5,2.37744375108173,0.13208020839343,4.75488750216347,4,84.1227710719319
transformers_4.23.0,src/transformers/models/squeezebert/modeling_squeezebert.py,1098,469,767,13,86,119,202,99,321,600.764485240215,15.2674418604651,32489.4746829629,1804.97081572016,2128.02347504555,123,24.4007811010333
transformers_4.23.0,src/transformers/models/herbert/__init__.py,49,23,22,1,2,2,2,3,4,2,0.5,3.16992500144231,0.176106944524573,6.33985000288463,8,92.2814655295801
transformers_4.23.0,src/transformers/models/herbert/tokenization_herbert_fast.py,174,45,74,3,44,27,54,47,81,244.969878722205,1.84090909090909,828.264942178568,46.0147190099204,449.921696985889,10,70.7663990533407
transformers_4.23.0,src/transformers/models/herbert/tokenization_herbert.py,649,351,413,16,159,103,207,175,310,1226.74838989021,10.4150943396226,24057.5706689952,1336.53170383307,2309.87544466802,105,34.3796221891146
transformers_4.23.0,src/transformers/models/big_bird/tokenization_big_bird.py,278,100,132,6,59,35,67,65,102,362.585714916676,3.40677966101695,2092.72177801202,116.262321000668,614.281516928902,33,61.1882287152221
transformers_4.23.0,src/transformers/models/big_bird/__init__.py,151,65,120,1,8,8,8,9,16,24,0.5,25.3594000115385,1.40885555619658,50.718800023077,26,65.0885508848959
transformers_4.23.0,src/transformers/models/big_bird/modeling_flax_big_bird.py,2582,1062,1850,20,299,363,637,319,1000,2545.41506248298,21.304347826087,177197.05133673,9844.28062981832,8317.41261376487,219,0.354200151779616
transformers_4.23.0,src/transformers/models/big_bird/tokenization_big_bird_fast.py,258,73,125,7,55,35,67,62,102,337.626268698259,4.26363636363636,2589.42584632989,143.856991462771,607.328023659461,25,65.1746927275884
transformers_4.23.0,src/transformers/models/big_bird/modeling_big_bird.py,3162,1350,2133,21,455,583,1020,476,1603,4109.76251034251,23.5384615384615,335620.632278637,18645.5906821465,14258.3928745826,339,0
transformers_4.23.0,src/transformers/models/big_bird/configuration_big_bird.py,180,44,82,1,2,1,2,3,3,2,0.5,2.37744375108173,0.13208020839343,4.75488750216347,4,85.3609652734538
transformers_4.23.0,src/transformers/models/big_bird/convert_bigbird_original_tf_checkpoint_to_pytorch.py,71,23,39,1,2,1,2,3,3,2,0.5,2.37744375108173,0.13208020839343,4.75488750216347,3,94.0021979131326
transformers_4.23.0,src/transformers/models/openai/convert_openai_original_tf_checkpoint_to_pytorch.py,75,27,44,2,10,6,12,12,18,35.2192809488736,1.2,77.435190015577,4.30195500086539,64.5293250129808,3,84.0639376134171
transformers_4.23.0,src/transformers/models/openai/modeling_openai.py,856,414,600,17,128,142,243,145,385,965.486868301256,16.13671875,44606.1668499137,2478.12038055076,2764.26499965575,106,28.523651497381
transformers_4.23.0,src/transformers/models/openai/tokenization_openai_fast.py,76,27,28,0,0,0,0,0,0,0,0,0,0,0,4,100
transformers_4.23.0,src/transformers/models/openai/__init__.py,123,52,92,1,6,6,6,7,12,15.5097750043269,0.5,16.8441295323456,0.935784974019201,33.6882590646913,20,71.4191641741579
transformers_4.23.0,src/transformers/models/openai/configuration_openai.py,161,30,51,0,0,0,0,0,0,0,0,0,0,0,2,100
transformers_4.23.0,src/transformers/models/openai/tokenization_openai.py,393,248,247,15,105,70,141,120,211,763.599138289071,10.0714285714286,14677.6358649964,815.42421472202,1457.3539156734,84,41.8736709521676
transformers_4.23.0,src/transformers/models/openai/modeling_tf_openai.py,920,367,667,14,93,106,173,107,279,661.444738341853,13.0215053763441,24491.7495615954,1360.65275342196,1880.86928920592,87,31.7335026861135
transformers_4.23.0,src/transformers/models/mbart/modeling_mbart.py,1898,693,1269,17,197,242,430,214,672,1571.03107673416,18.5532994923858,96519.1957021271,5362.17753900706,5202.26581486157,223,7.49982216591628
transformers_4.23.0,src/transformers/models/mbart/convert_mbart_original_checkpoint_to_pytorch.py,83,36,54,2,4,2,4,6,6,10,1,15.5097750043269,0.861654166907052,15.5097750043269,6,82.3436322371481
transformers_4.23.0,src/transformers/models/mbart/__init__.py,152,79,118,1,10,10,10,11,20,33.2192809488736,0.5,34.594316186373,1.9219064547985,69.188632372746,32,61.624608595515
transformers_4.23.0,src/transformers/models/mbart/modeling_flax_mbart.py,1777,709,1351,14,170,172,304,184,476,1312.89942805222,12.5176470588235,44828.3915589701,2490.46619772056,3581.21549108314,164,9.4422964847129
transformers_4.23.0,src/transformers/models/mbart/configuration_mbart.py,390,151,263,8,32,19,35,40,54,184,4.375,1257.30551241714,69.8503062453966,287.384117123918,32,58.3970310746081
transformers_4.23.0,src/transformers/models/mbart/tokenization_mbart_fast.py,292,108,170,8,57,40,77,65,117,356.47473080739,5.40350877192982,3807.40432474199,211.522462485666,704.617034124329,29,59.6523475722994
transformers_4.23.0,src/transformers/models/mbart/tokenization_mbart.py,355,154,199,11,84,52,101,95,153,575.008411318426,6.61309523809524,6647.40336827928,369.300187126627,1005.18790807464,47,53.3349878124428
transformers_4.23.0,src/transformers/models/mbart/modeling_tf_mbart.py,1491,498,1029,14,132,154,270,146,424,983.162992664122,14.3181818181818,43648.7712765462,2424.9317375859,3048.48561296513,147,21.7085958411166
transformers_4.23.0,src/transformers/models/xglm/tokenization_xglm_fast.py,205,54,88,6,32,22,41,38,63,175.509775004327,3.84375,1270.81844692732,70.6010248292957,330.619433346946,16,69.9624183302324
transformers_4.23.0,src/transformers/models/xglm/__init__.py,143,79,105,1,10,10,10,11,20,33.2192809488736,0.5,34.594316186373,1.9219064547985,69.188632372746,32,63.0679857480712
transformers_4.23.0,src/transformers/models/xglm/tokenization_xglm.py,313,107,130,9,67,40,77,76,117,434.957300773652,5.17164179104478,3780.50903520537,210.028279733632,731.0075190729,34,58.3702013069251
transformers_4.23.0,src/transformers/models/xglm/convert_xglm_original_ckpt_to_trfms.py,68,35,53,2,3,2,3,5,5,6.75488750216347,1,11.6096404744368,0.644980026357601,11.6096404744368,4,66.5342362045567
transformers_4.23.0,src/transformers/models/xglm/modeling_tf_xglm.py,1001,353,743,16,128,126,223,144,349,960,13.9375,34875.8595679532,1937.54775377518,2502.30382550337,97,27.9670205328571
transformers_4.23.0,src/transformers/models/xglm/modeling_flax_xglm.py,818,369,617,15,115,94,167,130,261,845.834714792731,10.8913043478261,19961.9964695525,1108.99980386403,1832.83799920043,81,29.3797380699329
transformers_4.23.0,src/transformers/models/xglm/configuration_xglm.py,140,28,58,0,0,0,0,0,0,0,0,0,0,0,2,100
transformers_4.23.0,src/transformers/models/xglm/modeling_xglm.py,951,385,617,16,144,147,260,160,407,1096.46920020769,14.4444444444444,43044.8017222767,2391.37787345982,2980.02473461916,115,29.9531238688346
transformers_4.23.0,src/transformers/models/pegasus/modeling_tf_pegasus.py,1503,513,1033,16,136,152,269,152,421,1027.89494641005,15.8235294117647,48283.5613511749,2682.42007506527,3051.37748315975,148,21.4509496746326
transformers_4.23.0,src/transformers/models/pegasus/modeling_flax_pegasus.py,1529,619,1153,16,154,151,273,170,424,1183.08512726701,14.1818181818182,44553.3412799902,2475.18562666612,3141.58175692239,148,14.2572294518168
transformers_4.23.0,src/transformers/models/pegasus/tokenization_pegasus.py,298,124,158,10,55,39,74,65,113,351.19406519273,6.72727272727273,4578.09451386763,254.338584103757,680.527562872215,44,57.7821802296221
transformers_4.23.0,src/transformers/models/pegasus/__init__.py,144,79,110,1,10,10,10,11,20,33.2192809488736,0.5,34.594316186373,1.9219064547985,69.188632372746,32,62.1930992384778
transformers_4.23.0,src/transformers/models/pegasus/configuration_pegasus.py,169,40,73,0,0,0,0,0,0,0,0,0,0,0,4,100
transformers_4.23.0,src/transformers/models/pegasus/convert_pegasus_tf_to_pytorch.py,132,76,93,8,30,17,34,38,51,171.206717868256,4.53333333333333,1213.32084110816,67.4067133948976,267.644303185623,21,63.1177563168072
transformers_4.23.0,src/transformers/models/pegasus/modeling_pegasus.py,1716,618,1046,18,167,194,349,185,543,1308.13726686913,18.8083832335329,76917.6380715125,4273.20211508403,4089.54013306036,200,14.8132679379197
transformers_4.23.0,src/transformers/models/pegasus/tokenization_pegasus_fast.py,218,70,115,9,41,28,52,50,80,248.188957202322,5.70731707317073,2576.90214323373,143.161230179652,451.508495181978,26,66.9040778688273
transformers_4.23.0,src/transformers/models/layoutlm/modeling_tf_layoutlm.py,1542,513,1010,11,114,118,207,125,325,817.003209419791,9.98684210526316,22609.0110318292,1256.05616843496,2263.87989251518,140,24.2283906909127
transformers_4.23.0,src/transformers/models/layoutlm/tokenization_layoutlm.py,63,18,27,0,0,0,0,0,0,0,0,0,0,0,1,100
transformers_4.23.0,src/transformers/models/layoutlm/__init__.py,124,52,94,1,6,6,6,7,12,15.5097750043269,0.5,16.8441295323456,0.935784974019201,33.6882590646913,20,71.2427478278226
transformers_4.23.0,src/transformers/models/layoutlm/configuration_layoutlm.py,196,51,94,4,8,5,8,12,13,32,2,93.2090250187501,5.17827916770834,46.604512509375,7,78.3257001073671
transformers_4.23.0,src/transformers/models/layoutlm/tokenization_layoutlm_fast.py,73,20,37,0,0,0,0,0,0,0,0,0,0,0,1,100
transformers_4.23.0,src/transformers/models/layoutlm/modeling_layoutlm.py,1368,558,891,14,165,176,308,179,484,1268.74613425937,13.0666666666667,47329.6466596264,2629.42481442369,3622.1668361959,155,20.3728466931184
transformers_4.23.0,src/transformers/models/convbert/__init__.py,134,52,102,1,6,6,6,7,12,15.5097750043269,0.5,16.8441295323456,0.935784974019201,33.6882590646913,20,70.5734836890522
transformers_4.23.0,src/transformers/models/convbert/convert_convbert_original_tf1_checkpoint_to_pytorch_and_tf2.py,57,19,31,1,2,1,2,3,3,2,0.5,2.37744375108173,0.13208020839343,4.75488750216347,2,96.0901158808716
transformers_4.23.0,src/transformers/models/convbert/modeling_tf_convbert.py,1332,535,1012,14,92,119,205,106,324,653.470668866052,15.5978260869565,34000.862349398,1888.93679718878,2179.84622727848,138,15.7291976282997
transformers_4.23.0,src/transformers/models/convbert/modeling_convbert.py,1351,647,1068,16,128,171,290,144,461,960,18.125,59909.2045901764,3328.28914389869,3305.33542566491,159,9.2821254916945
transformers_4.23.0,src/transformers/models/convbert/tokenization_convbert_fast.py,198,49,88,5,32,18,37,37,55,171.609640474437,2.890625,828.221687426165,46.0123159681203,286.519935109592,10,71.4560943447924
transformers_4.23.0,src/transformers/models/convbert/tokenization_convbert.py,515,238,286,17,137,84,172,154,256,1041.91726366685,10.6715328467153,19852.2243223282,1102.90135124046,1860.2973544179,86,42.9061925674413
transformers_4.23.0,src/transformers/models/convbert/configuration_convbert.py,165,41,79,1,2,1,2,3,3,2,0.5,2.37744375108173,0.13208020839343,4.75488750216347,4,86.8456558531749
transformers_4.23.0,src/transformers/models/gpt2/modeling_gpt2.py,1544,716,1124,18,218,248,421,236,669,1768.52283282733,17.3807339449541,91657.0953664561,5092.060853692,5273.48820002307,196,7.76421977005667
transformers_4.23.0,src/transformers/models/gpt2/tokenization_gpt2.py,361,181,223,15,78,52,100,93,152,548.864732005383,9.61538461538462,9557.23210854251,530.957339363473,993.952139288421,55,50.0305445388402
transformers_4.23.0,src/transformers/models/gpt2/modeling_flax_gpt2.py,779,369,597,12,102,83,149,114,232,723.606934889746,8.76470588235294,13894.0789417439,771.893274541329,1585.23048328622,79,28.6981454635937
transformers_4.23.0,src/transformers/models/gpt2/convert_gpt2_original_tf_checkpoint_to_pytorch.py,69,27,38,2,10,6,12,12,18,35.2192809488736,1.2,77.435190015577,4.30195500086539,64.5293250129808,3,84.63504312428
transformers_4.23.0,src/transformers/models/gpt2/configuration_gpt2.py,274,85,138,3,6,4,6,9,10,20.2646625064904,1.5,47.5488750216347,2.64160416786859,31.6992500144231,14,74.3541382992479
transformers_4.23.0,src/transformers/models/gpt2/__init__.py,141,66,109,1,8,8,8,9,16,24,0.5,25.3594000115385,1.40885555619658,50.718800023077,26,65.7220303882475
transformers_4.23.0,src/transformers/models/gpt2/modeling_tf_gpt2.py,1232,462,889,14,136,149,247,150,396,1017.19791531885,12.7132352941176,36393.0624726727,2021.83680403737,2862.61220143637,124,24.0537290642265
transformers_4.23.0,src/transformers/models/gpt2/tokenization_gpt2_fast.py,190,53,99,6,12,8,13,18,21,58.5293250129808,3.25,284.597381348438,15.8109656304688,87.5684250302886,12,76.4019380811255
transformers_4.23.0,src/transformers/models/vision_text_dual_encoder/configuration_vision_text_dual_encoder.py,128,41,37,2,6,4,8,8,12,17.5097750043269,1.33333333333333,48,2.66666666666667,36,8,66.9393787053133
transformers_4.23.0,src/transformers/models/vision_text_dual_encoder/__init__.py,72,38,40,1,4,4,4,5,8,8,0.5,9.28771237954945,0.51598402108608,18.5754247590989,14,83.3057187569031
transformers_4.23.0,src/transformers/models/vision_text_dual_encoder/processing_vision_text_dual_encoder.py,110,31,26,3,7,9,18,10,27,24.4063719565667,3.85714285714286,345.955083024698,19.2197268347055,89.6920585619588,12,47.5288313941766
transformers_4.23.0,src/transformers/models/vision_text_dual_encoder/modeling_flax_vision_text_dual_encoder.py,603,169,402,10,52,42,74,62,116,329.64214629221,7.11538461538462,4914.50203157317,273.027890642954,690.686772004878,43,50.2877113536836
transformers_4.23.0,src/transformers/models/vision_text_dual_encoder/modeling_vision_text_dual_encoder.py,538,128,293,11,40,30,56,51,86,250.930871600505,7.7,3756.28006145352,208.682225636307,487.828579409549,32,60.0051078610637
transformers_4.23.0,src/transformers/models/rag/__init__.py,86,39,57,1,4,4,4,5,8,8,0.5,9.28771237954945,0.51598402108608,18.5754247590989,14,80.55404780271
transformers_4.23.0,src/transformers/models/rag/tokenization_rag.py,120,52,87,1,6,4,8,7,12,15.5097750043269,0.666666666666667,22.4588393764608,1.24771329869227,33.6882590646913,15,72.5498154265381
transformers_4.23.0,src/transformers/models/rag/modeling_rag.py,1728,510,1005,15,156,183,332,171,515,1195.12610507664,15.9615384615385,60976.1741824611,3387.56523235895,3820.19404516624,144,25.5874885726905
transformers_4.23.0,src/transformers/models/rag/modeling_tf_rag.py,1826,531,1061,15,170,187,338,185,525,1318.19981807754,14.9117647058824,58960.7488309685,3275.59715727603,3953.97526677106,143,25.2176454842779
transformers_4.23.0,src/transformers/models/rag/retrieval_rag.py,652,278,368,14,70,43,81,84,124,482.352780094954,8.1,6420.44361943899,356.691312191055,792.647360424566,85,44.0303880779056
transformers_4.23.0,src/transformers/models/rag/configuration_rag.py,194,51,146,3,7,4,8,10,12,24.4063719565667,1.71428571428571,68.3368065233972,3.79648925129984,39.8631371386484,6,72.8469665143728
transformers_4.23.0,src/transformers/models/megatron_bert/convert_megatron_bert_checkpoint.py,338,156,160,11,69,56,112,80,168,459.541935322704,8.92753623188406,9481.79267657541,526.766259809745,1062.08391994108,30,55.9513446418277
transformers_4.23.0,src/transformers/models/megatron_bert/__init__.py,73,23,48,1,2,2,2,3,4,2,0.5,3.16992500144231,0.176106944524573,6.33985000288463,8,90.8165051883758
transformers_4.23.0,src/transformers/models/megatron_bert/modeling_megatron_bert.py,1845,781,1279,16,197,237,409,213,646,1565.54420843291,16.6091370558376,82989.5865014558,4610.53258341421,4996.62241466589,222,4.9306572053256
transformers_4.23.0,src/transformers/models/megatron_bert/configuration_megatron_bert.py,127,24,42,0,0,0,0,0,0,0,0,0,0,0,2,100
transformers_4.23.0,src/transformers/models/data2vec/convert_data2vec_vision_original_pytorch_checkpoint_to_pytorch.py,374,198,278,12,38,25,46,50,71,242.44079551951,7.26315789473684,2910.44752354804,161.691529086002,400.713789474005,28,49.5585286129199
transformers_4.23.0,src/transformers/models/data2vec/__init__.py,139,33,112,1,2,2,2,3,4,2,0.5,3.16992500144231,0.176106944524573,6.33985000288463,10,80.5435554716329
transformers_4.23.0,src/transformers/models/data2vec/configuration_data2vec_audio.py,284,59,115,2,9,5,11,11,16,30.5293250129808,1.22222222222222,67.6511072089072,3.75839484493929,55.3509058981968,7,69.338744611581
transformers_4.23.0,src/transformers/models/data2vec/modeling_data2vec_audio.py,1543,715,1052,19,184,213,368,203,581,1465.04602266992,19,84617.6431898072,4700.98017721151,4453.56016788459,192,9.91982275222786
transformers_4.23.0,src/transformers/models/data2vec/configuration_data2vec_text.py,151,39,62,1,2,1,2,3,3,2,0.5,2.37744375108173,0.13208020839343,4.75488750216347,4,83.6240648105622
transformers_4.23.0,src/transformers/models/data2vec/modeling_tf_data2vec_vision.py,1482,654,1013,16,186,164,298,202,462,1466.28353886609,12.8172043010753,45348.4698537349,2519.3594363186,3538.09370503133,159,16.0951608203911
transformers_4.23.0,src/transformers/models/data2vec/modeling_data2vec_vision.py,1218,583,810,16,190,174,318,206,492,1502.27256558288,13.3894736842105,50635.7526939359,2813.09737188533,3781.75825937414,153,19.2919702409173
transformers_4.23.0,src/transformers/models/data2vec/convert_data2vec_text_original_pytorch_checkpoint_to_pytorch.py,204,106,147,4,11,10,19,15,29,46.0537478050103,3.45454545454545,391.399403305508,21.7444112947504,113.299827272647,16,64.0620679495186
transformers_4.23.0,src/transformers/models/data2vec/convert_data2vec_audio_original_pytorch_checkpoint_to_pytorch.py,286,175,211,10,51,48,81,61,129,322.51297338942,7.94117647058824,6075.51710197986,337.52872788777,765.065116545612,37,44.7127095271232
transformers_4.23.0,src/transformers/models/data2vec/configuration_data2vec_vision.py,202,52,88,0,0,0,0,0,0,0,0,0,0,0,4,100
transformers_4.23.0,src/transformers/models/data2vec/modeling_data2vec_text.py,1570,674,1107,15,178,215,373,193,588,1389.28390964615,15.7162921348315,70163.2604174909,3897.95891208283,4464.36473791363,197,9.4976543765851
transformers_4.23.0,src/transformers/models/luke/tokenization_luke.py,1391,450,1023,18,365,252,497,383,749,3181.84836865105,12.2547945205479,78765.4765534515,4375.85980852508,6427.31923586179,195,12.9000601121994
transformers_4.23.0,src/transformers/models/luke/__init__.py,77,24,50,1,2,2,2,3,4,2,0.5,3.16992500144231,0.176106944524573,6.33985000288463,8,90.1468673583409
transformers_4.23.0,src/transformers/models/luke/modeling_luke.py,2236,849,1407,14,125,227,370,139,597,924.026004491567,20.72,88060.1620390182,4892.2312243899,4250.00782041593,199,11.1773414435457
transformers_4.23.0,src/transformers/models/luke/configuration_luke.py,137,28,49,0,0,0,0,0,0,0,0,0,0,0,2,100
transformers_4.23.0,src/transformers/models/luke/convert_luke_original_pytorch_checkpoint_to_pytorch.py,170,85,114,7,42,36,56,49,92,246.128816211111,4.66666666666667,2410.58209307346,133.92122739297,516.553305658599,19,61.379505334579
transformers_4.23.0,src/transformers/models/bloom/tokenization_bloom_fast.py,170,50,81,6,14,10,15,20,25,68.8127439131334,3.21428571428571,347.297793339163,19.2943218521757,108.048202372184,14,75.7184916205729
transformers_4.23.0,src/transformers/models/bloom/__init__.py,81,37,54,1,4,4,4,5,8,8,0.5,9.28771237954945,0.51598402108608,18.5754247590989,14,81.4416407607028
transformers_4.23.0,src/transformers/models/bloom/modeling_bloom.py,1262,521,861,18,205,201,378,223,579,1649.35207042458,16.5951219512195,74955.536512523,4164.19647291795,4516.72104205386,137,21.0173279771659
transformers_4.23.0,src/transformers/models/bloom/convert_bloom_original_checkpoint_to_pytorch.py,254,129,184,11,52,37,72,63,109,334.476613148347,7.61538461538462,4961.60212726828,275.644562626015,651.523511661491,38,51.1224403747277
transformers_4.23.0,src/transformers/models/bloom/configuration_bloom.py,244,86,132,5,9,7,12,14,19,40.1389654874176,3.33333333333333,241.132478396982,13.3962487998323,72.3397435190945,17,71.729277646712
transformers_4.23.0,src/transformers/models/vision_encoder_decoder/configuration_vision_encoder_decoder.py,222,84,94,2,5,3,6,7,9,13.6096404744368,1.2,30.3194331582221,1.68441295323456,25.2661942985184,15,73.7441929690962
transformers_4.23.0,src/transformers/models/vision_encoder_decoder/__init__.py,88,51,58,1,6,6,6,7,12,15.5097750043269,0.5,16.8441295323456,0.935784974019201,33.6882590646913,20,75.2675016620353
transformers_4.23.0,src/transformers/models/vision_encoder_decoder/modeling_tf_vision_encoder_decoder.py,744,234,457,11,81,72,136,92,208,551.581598038665,9.23456790123457,12530.3933749528,696.132965275154,1356.90088685986,91,41.6253103768739
transformers_4.23.0,src/transformers/models/vision_encoder_decoder/modeling_vision_encoder_decoder.py,562,167,347,11,69,60,113,80,173,459.541935322704,9.00724637681159,9851.16735939481,547.287075521934,1093.69356041551,67,48.5099309100924
transformers_4.23.0,src/transformers/models/vision_encoder_decoder/modeling_flax_vision_encoder_decoder.py,864,253,553,11,82,68,126,93,194,559.373012183693,8.45121951219512,10721.1901083291,595.62167268495,1268.59680935496,72,42.7583201377015
transformers_4.23.0,src/transformers/models/dpt/convert_dpt_to_pytorch.py,283,182,214,8,62,60,120,70,180,393.160171243986,7.74193548387097,8541.45246232331,474.525136795739,1103.27094305009,59,42.9545918344874
transformers_4.23.0,src/transformers/models/dpt/__init__.py,78,38,49,1,4,4,4,5,8,8,0.5,9.28771237954945,0.51598402108608,18.5754247590989,14,81.8505861253324
transformers_4.23.0,src/transformers/models/dpt/feature_extraction_dpt.py,245,89,113,11,47,32,63,58,95,299.119423833859,7.37234042553192,4102.76785972579,227.931547762544,556.508194537119,37,61.7697482017867
transformers_4.23.0,src/transformers/models/dpt/modeling_dpt.py,1130,510,684,15,106,99,175,121,274,771.762927117827,12.3820754716981,23473.5489783479,1304.08605435266,1895.76852701324,130,26.7532691481304
transformers_4.23.0,src/transformers/models/dpt/configuration_dpt.py,170,37,64,1,2,1,2,3,3,2,0.5,2.37744375108173,0.13208020839343,4.75488750216347,3,79.4406723539531
transformers_4.23.0,src/transformers/models/deberta_v2/tokenization_deberta_v2.py,530,269,300,16,148,91,183,164,274,1130.99909811308,9.89189189189189,19941.7498711114,1107.87499283952,2015.96924926536,105,38.4997672978829
transformers_4.23.0,src/transformers/models/deberta_v2/modeling_tf_deberta_v2.py,1574,661,1153,18,208,220,376,226,596,1676.75011139931,16.2692307692308,75828.064532945,4212.67025183027,4660.82666159945,176,9.36253170657106
transformers_4.23.0,src/transformers/models/deberta_v2/__init__.py,129,52,98,1,6,6,6,7,12,15.5097750043269,0.5,16.8441295323456,0.935784974019201,33.6882590646913,20,70.9010452241784
transformers_4.23.0,src/transformers/models/deberta_v2/tokenization_deberta_v2_fast.py,247,64,110,6,55,33,63,61,96,333.484559248183,3.43636363636364,1956.49633186802,108.694240659334,569.350784406037,16,66.143566971775
transformers_4.23.0,src/transformers/models/deberta_v2/modeling_deberta_v2.py,1679,836,1214,21,244,311,516,265,827,2027.3385762437,22.2049180327869,147823.129908375,8212.39610602082,6657.22475039562,228,0
transformers_4.23.0,src/transformers/models/deberta_v2/configuration_deberta_v2.py,185,59,99,4,12,6,12,16,18,51.0195500086539,2,144,8,72,12,75.7774013462065
transformers_4.23.0,src/transformers/models/yoso/modeling_yoso.py,1318,654,993,17,180,218,370,197,588,1418.0204256406,17.4722222222222,78306.419709155,4350.35665050861,4481.76646984035,161,9.38050836030232
transformers_4.23.0,src/transformers/models/yoso/__init__.py,70,23,42,1,2,2,2,3,4,2,0.5,3.16992500144231,0.176106944524573,6.33985000288463,8,91.9155709627847
transformers_4.23.0,src/transformers/models/yoso/convert_yoso_pytorch_to_pytorch.py,109,65,74,6,29,24,46,35,70,156.391223863027,4.75862068965517,1708.58186012719,94.9212144515103,359.049811186148,21,63.227193639309
transformers_4.23.0,src/transformers/models/yoso/configuration_yoso.py,145,30,55,0,0,0,0,0,0,0,0,0,0,0,2,100
transformers_4.23.0,src/transformers/models/poolformer/feature_extraction_poolformer.py,171,51,74,7,29,19,36,36,55,160.532933313103,4.3448275862069,1235.4338020688,68.6352112260445,284.345875079327,26,68.9941648123304
transformers_4.23.0,src/transformers/models/poolformer/configuration_poolformer.py,127,27,46,0,0,0,0,0,0,0,0,0,0,0,2,100
transformers_4.23.0,src/transformers/models/poolformer/__init__.py,76,37,46,1,4,4,4,5,8,8,0.5,9.28771237954945,0.51598402108608,18.5754247590989,14,82.8589537833708
transformers_4.23.0,src/transformers/models/poolformer/modeling_poolformer.py,458,236,309,13,72,66,118,85,184,492.340316439681,10.6527777777778,12563.1183893784,697.951021632131,1179.32793224934,69,40.7236707303008
transformers_4.23.0,src/transformers/models/poolformer/convert_poolformer_original_to_pytorch.py,214,145,146,7,45,41,70,52,111,266.784873789239,5.44444444444444,3444.96573632993,191.386985351663,632.748808713661,30,54.0339704136428
transformers_4.23.0,src/transformers/models/opt/modeling_opt.py,1230,479,793,16,138,164,285,154,449,1044.97637503539,16.5217391304348,53906.9182423202,2994.82879124001,3262.78715677201,149,22.8650327519078
transformers_4.23.0,src/transformers/models/opt/__init__.py,105,51,75,1,6,6,6,7,12,15.5097750043269,0.5,16.8441295323456,0.935784974019201,33.6882590646913,20,73.2690734500327
transformers_4.23.0,src/transformers/models/opt/modeling_flax_opt.py,804,359,590,13,88,75,132,101,207,616.535698775916,9.75,13437.9353250638,746.551962503545,1378.24977692962,80,30.9955826704569
transformers_4.23.0,src/transformers/models/opt/convert_opt_original_pytorch_checkpoint_to_pytorch.py,93,42,53,3,9,5,10,12,15,33.2842125151443,1.66666666666667,89.6240625180289,4.97911458433494,53.7744375108174,8,79.3486149321168
transformers_4.23.0,src/transformers/models/opt/modeling_tf_opt.py,1030,356,678,13,87,106,184,100,290,608.641800474674,13.7471264367816,26486.8400099019,1471.49111166122,1926.71829503467,104,32.5796906771373
transformers_4.23.0,src/transformers/models/opt/configuration_opt.py,141,27,57,1,2,1,2,3,3,2,0.5,2.37744375108173,0.13208020839343,4.75488750216347,3,86.1376467293454
transformers_4.23.0,src/transformers/models/wav2vec2_conformer/convert_wav2vec2_conformer_original_pytorch_checkpoint_to_pytorch.py,307,165,250,10,70,62,116,80,178,462.269092135021,8.28571428571429,9323.94080737388,517.996711520771,1125.30320088995,54,39.8621355696522
transformers_4.23.0,src/transformers/models/wav2vec2_conformer/configuration_wav2vec2_conformer.py,357,74,145,2,9,5,11,11,16,30.5293250129808,1.22222222222222,67.6511072089072,3.75839484493929,55.3509058981968,7,66.9464114991139
transformers_4.23.0,src/transformers/models/wav2vec2_conformer/modeling_wav2vec2_conformer.py,2142,990,1379,19,305,333,579,324,912,2597.77357965275,18.0344262295082,137168.821593674,7620.49008853745,7605.94320263078,226,2.87541609016606
transformers_4.23.0,src/transformers/models/wav2vec2_conformer/__init__.py,74,23,48,1,2,2,2,3,4,2,0.5,3.16992500144231,0.176106944524573,6.33985000288463,8,90.8165051883758
transformers_4.23.0,src/transformers/models/bigbird_pegasus/convert_bigbird_pegasus_tf_to_pytorch.py,171,78,133,7,24,19,37,31,56,129.690584471711,5.39583333333333,1496.9929851219,83.1662769512167,277.434993381665,32,56.5661720107043
transformers_4.23.0,src/transformers/models/bigbird_pegasus/__init__.py,75,23,48,1,2,2,2,3,4,2,0.5,3.16992500144231,0.176106944524573,6.33985000288463,8,90.8165051883758
transformers_4.23.0,src/transformers/models/bigbird_pegasus/configuration_bigbird_pegasus.py,423,155,283,8,32,19,35,40,54,184,4.375,1257.30551241714,69.8503062453966,287.384117123918,32,58.2768502048416
transformers_4.23.0,src/transformers/models/bigbird_pegasus/modeling_bigbird_pegasus.py,3102,1209,2091,20,443,589,1035,463,1624,3980.92372152762,23.3634311512415,335973.295108784,18665.1830615991,14380.3062544146,330,0
transformers_4.23.0,src/transformers/models/deit/feature_extraction_deit.py,160,44,65,5,25,14,28,30,42,127.706045218805,2.8,577.050334043562,32.058351891309,206.089405015558,24,69.9036865962272
transformers_4.23.0,src/transformers/models/deit/__init__.py,115,51,84,1,6,6,6,7,12,15.5097750043269,0.5,16.8441295323456,0.935784974019201,33.6882590646913,20,72.3484103684974
transformers_4.23.0,src/transformers/models/deit/modeling_tf_deit.py,1070,416,714,16,102,83,153,118,236,744.587384881092,12,19491.6451157927,1082.8691730996,1624.30375964939,104,31.0354472364132
transformers_4.23.0,src/transformers/models/deit/convert_deit_timm_to_pytorch.py,219,124,152,4,12,11,17,16,28,51.0195500086539,2.83333333333333,317.333333333333,17.6296296296296,112,17,62.6497930502229
transformers_4.23.0,src/transformers/models/deit/configuration_deit.py,146,38,61,0,0,0,0,0,0,0,0,0,0,0,4,100
transformers_4.23.0,src/transformers/models/deit/modeling_deit.py,890,389,569,16,114,102,183,130,285,842.949461614781,12.8421052631579,25701.8661956841,1427.88145531579,2001.37482671311,96,32.9358897533538
transformers_4.23.0,src/transformers/models/whisper/configuration_whisper.py,216,38,97,0,0,0,0,0,0,0,0,0,0,0,2,100
transformers_4.23.0,src/transformers/models/whisper/english_normalizer.py,602,352,477,17,168,170,337,185,507,1311.39619532809,17.0505952380952,65106.1701915478,3617.00945508599,3818.41040048177,125,23.8578639524402
transformers_4.23.0,src/transformers/models/whisper/__init__.py,92,40,64,1,4,4,4,5,8,8,0.5,9.28771237954945,0.51598402108608,18.5754247590989,14,79.4422295128452
transformers_4.23.0,src/transformers/models/whisper/processing_whisper.py,124,53,62,6,19,16,32,25,48,96.2203977597551,5.05263157894737,1126.25733276221,62.5698518201226,222.905097109187,20,72.1451139085537
transformers_4.23.0,src/transformers/models/whisper/feature_extraction_whisper.py,306,131,147,18,86,65,123,104,188,627.717418930342,12.8720930232558,16214.7524695425,900.819581641248,1259.68266701053,33,56.6281337082853
transformers_4.23.0,src/transformers/models/whisper/modeling_whisper.py,1230,461,788,15,143,159,283,158,442,1082.46496009344,14.8426573426573,47916.1216083819,2662.00675602122,3228.27109069428,151,23.4182332333924
transformers_4.23.0,src/transformers/models/whisper/tokenization_whisper.py,401,217,255,16,90,60,116,106,176,648.266778669671,10.3111111111111,12209.5310222544,678.307279014135,1184.11400000312,67,45.8612808914001
transformers_4.23.0,src/transformers/models/whisper/modeling_tf_whisper.py,1401,484,939,15,120,141,249,135,390,887.43023040715,15.5625,42951.8476643504,2386.21375913058,2759.95808284982,147,23.26484435477
transformers_4.23.0,src/transformers/models/splinter/__init__.py,83,38,54,1,4,4,4,5,8,8,0.5,9.28771237954945,0.51598402108608,18.5754247590989,14,81.1889942093981
transformers_4.23.0,src/transformers/models/splinter/modeling_splinter.py,1111,501,780,14,149,165,303,163,468,1128.95907845767,14.2348993288591,48956.7337602556,2719.81854223642,3439.20477618014,138,21.8103000629035
transformers_4.23.0,src/transformers/models/splinter/tokenization_splinter.py,531,251,300,17,161,102,208,178,310,1249.76448567771,10.9813664596273,25449.068191578,1413.83712175434,2317.47736359958,89,41.2639191443678
transformers_4.23.0,src/transformers/models/splinter/configuration_splinter.py,127,25,46,0,0,0,0,0,0,0,0,0,0,0,2,100
transformers_4.23.0,src/transformers/models/splinter/tokenization_splinter_fast.py,216,61,103,6,56,38,76,62,114,340.721650639553,4.07142857142857,2763.59768749242,153.53320486069,678.778379384104,12,67.6380332170768
transformers_4.23.0,src/transformers/models/nllb/tokenization_nllb.py,401,154,195,11,84,52,101,95,153,575.008411318426,6.61309523809524,6647.40336827928,369.300187126627,1005.18790807464,47,54.095944279878
transformers_4.23.0,src/transformers/models/nllb/__init__.py,68,35,41,1,4,4,4,5,8,8,0.5,9.28771237954945,0.51598402108608,18.5754247590989,14,83.6796997015283
transformers_4.23.0,src/transformers/models/nllb/tokenization_nllb_fast.py,336,108,168,8,57,40,77,65,117,356.47473080739,5.40350877192982,3807.40432474199,211.522462485666,704.617034124329,29,61.0294069034708
transformers_4.23.0,src/transformers/models/visual_bert/modeling_visual_bert.py,1605,590,1006,13,129,195,322,142,517,952.554032285434,16.2248062015504,59973.6861458973,3331.87145254985,3696.41926078392,145,21.6058299287894
transformers_4.23.0,src/transformers/models/visual_bert/__init__.py,69,23,42,1,2,2,2,3,4,2,0.5,3.16992500144231,0.176106944524573,6.33985000288463,8,91.6061716488424
transformers_4.23.0,src/transformers/models/visual_bert/configuration_visual_bert.py,151,26,61,0,0,0,0,0,0,0,0,0,0,0,2,100
transformers_4.23.0,src/transformers/models/visual_bert/convert_visual_bert_original_pytorch_checkpoint_to_pytorch.py,150,84,102,3,18,19,36,21,55,79.8135375281251,3,724.732374758496,40.2629097088053,241.577458252832,20,63.33234655745
transformers_4.23.0,src/transformers/models/distilbert/modeling_distilbert.py,1137,479,739,14,110,126,219,124,345,799.252537396519,13.9363636363636,33436.0919601724,1857.56066445402,2399.19772708347,125,28.7790339550664
transformers_4.23.0,src/transformers/models/distilbert/tokenization_distilbert.py,76,19,42,0,0,0,0,0,0,0,0,0,0,0,1,100
transformers_4.23.0,src/transformers/models/distilbert/modeling_flax_distilbert.py,903,397,704,12,75,73,124,87,197,510.180951795845,9.92,12591.0578973274,699.50321651819,1269.2598686822,76,27.7398258946154
transformers_4.23.0,src/transformers/models/distilbert/__init__.py,170,66,137,1,8,8,8,9,16,24,0.5,25.3594000115385,1.40885555619658,50.718800023077,26,63.8895548984596
transformers_4.23.0,src/transformers/models/distilbert/modeling_tf_distilbert.py,1086,437,801,11,73,86,149,84,235,489.910940603252,11.2260273972603,16863.6776722232,936.870981790175,1502.19459435301,108,28.7950843272908
transformers_4.23.0,src/transformers/models/distilbert/tokenization_distilbert_fast.py,94,21,60,0,0,0,0,0,0,0,0,0,0,0,1,100
transformers_4.23.0,src/transformers/models/distilbert/configuration_distilbert.py,154,39,75,1,2,1,2,3,3,2,0.5,2.37744375108173,0.13208020839343,4.75488750216347,4,87.8308781969521
transformers_4.23.0,src/transformers/models/xlnet/configuration_xlnet.py,242,59,100,5,10,10,19,15,29,44.8289214233104,4.75,538.174179545073,29.8985655302819,113.299827272647,8,70.3276281232757
transformers_4.23.0,src/transformers/models/xlnet/__init__.py,146,65,113,1,8,8,8,9,16,24,0.5,25.3594000115385,1.40885555619658,50.718800023077,26,65.5739506771058
transformers_4.23.0,src/transformers/models/xlnet/convert_xlnet_original_tf_checkpoint_to_pytorch.py,114,39,79,3,6,4,8,9,12,20.2646625064904,2,76.0782000346155,4.22656666858975,38.0391000173078,5,77.9856094274419
transformers_4.23.0,src/transformers/models/xlnet/tokenization_xlnet.py,351,131,163,10,69,46,84,79,130,454.707468466567,6.08695652173913,4988.20911377493,277.122728543051,819.491497263023,40,56.7344363495669
transformers_4.23.0,src/transformers/models/xlnet/modeling_tf_xlnet.py,1788,709,1215,16,169,192,349,185,541,1314.74862473169,16.5207100591716,67313.2592747278,3739.62551526265,4074.47737013932,192,11.9031253781972
transformers_4.23.0,src/transformers/models/xlnet/tokenization_xlnet_fast.py,246,64,109,5,33,23,43,38,66,178.074646413266,3.25757575757576,1128.30441539037,62.6835786327984,346.363215887277,14,68.4700484045409
transformers_4.23.0,src/transformers/models/xlnet/modeling_xlnet.py,2092,869,1356,18,247,292,514,265,806,2038.30535622738,18.7287449392713,121515.429587632,6750.85719931291,6488.17793085715,227,5.77636845053867
transformers_4.23.0,src/transformers/models/time_series_transformer/modeling_time_series_transformer.py,1954,733,1165,17,217,229,402,234,631,1753.74348574171,15.7465437788018,78200.4878882083,4344.47154934491,4966.20013805713,207,11.7353482174392
transformers_4.23.0,src/transformers/models/time_series_transformer/configuration_time_series_transformer.py,229,58,105,7,26,15,30,33,45,141.862917126072,4.03846153846154,916.72162361418,50.9289790896767,226.99773537113,11,69.3362497810579
transformers_4.23.0,src/transformers/models/time_series_transformer/__init__.py,67,23,40,1,2,2,2,3,4,2,0.5,3.16992500144231,0.176106944524573,6.33985000288463,8,92.1383550729973
transformers_4.23.0,src/transformers/models/deformable_detr/configuration_deformable_detr.py,227,56,98,2,6,3,6,8,9,17.5097750043269,1,27,1.5,27,6,74.2381369495588
transformers_4.23.0,src/transformers/models/deformable_detr/feature_extraction_deformable_detr.py,970,528,556,21,227,195,343,248,538,1868.86517249339,15.8656387665198,67894.7420721576,3771.93011511987,4279.35761498814,156,22.9738916499739
transformers_4.23.0,src/transformers/models/deformable_detr/__init__.py,77,37,48,1,4,4,4,5,8,8,0.5,9.28771237954945,0.51598402108608,18.5754247590989,14,82.2365154235863
transformers_4.23.0,src/transformers/models/deformable_detr/convert_deformable_detr_to_pytorch.py,237,141,167,6,74,69,89,80,158,475.009324060869,3.60810810810811,3604.01160285025,200.222866825014,998.864638992203,35,50.9322103480444
transformers_4.23.0,src/transformers/models/deformable_detr/modeling_deformable_detr.py,2469,1178,1496,22,434,408,710,456,1118,3900.62073049092,17.9953917050691,177707.570944425,9872.64283024585,9875.17103583618,268,0
transformers_4.23.0,src/transformers/models/deformable_detr/load_custom.py,51,9,29,0,0,0,0,0,0,0,0,0,0,0,2,100
transformers_4.23.0,src/transformers/models/groupvit/configuration_groupvit.py,399,123,196,5,18,11,24,23,35,86.6682905003984,3.33333333333333,527.748894873318,29.3193830485177,158.324668461995,25,64.4121508759443
transformers_4.23.0,src/transformers/models/groupvit/modeling_groupvit.py,1607,682,1032,17,216,209,370,233,579,1744.54256876857,14.5601851851852,66297.8198196247,3683.21221220137,4553.36377775483,167,15.9640937398785
transformers_4.23.0,src/transformers/models/groupvit/__init__.py,101,37,74,1,4,4,4,5,8,8,0.5,9.28771237954945,0.51598402108608,18.5754247590989,14,79.0346038006344
transformers_4.23.0,src/transformers/models/groupvit/convert_groupvit_nvlab_to_hf.py,217,143,161,7,66,57,113,73,170,418.581496332061,5.99242424242424,6305.64930630755,350.313850350419,1052.2701750096,46,48.7065620864064
transformers_4.23.0,src/transformers/models/groupvit/modeling_tf_groupvit.py,1993,737,1316,16,191,157,279,207,436,1511.28890615483,11.6858638743456,39198.598008714,2177.699889373,3354.36031346971,171,14.5322508464287
transformers_4.23.0,src/transformers/models/ernie/__init__.py,74,23,48,1,2,2,2,3,4,2,0.5,3.16992500144231,0.176106944524573,6.33985000288463,8,90.8165051883758
transformers_4.23.0,src/transformers/models/ernie/configuration_ernie.py,169,41,75,1,2,1,2,3,3,2,0.5,2.37744375108173,0.13208020839343,4.75488750216347,4,85.1817460038282
transformers_4.23.0,src/transformers/models/ernie/modeling_ernie.py,1822,748,1269,15,174,228,392,189,620,1353.67552721181,16.8965517241379,79221.0085682194,4401.16714267885,4688.59030301706,213,6.95537704171732
transformers_4.23.0,src/transformers/models/yolos/modeling_yolos.py,1318,644,765,18,223,178,322,241,500,1814.65932770819,12.9955156950673,51416.0387811534,2856.44659895297,3956.44466811498,152,21.3650494783088
transformers_4.23.0,src/transformers/models/yolos/__init__.py,75,37,46,1,4,4,4,5,8,8,0.5,9.28771237954945,0.51598402108608,18.5754247590989,14,82.5026769126246
transformers_4.23.0,src/transformers/models/yolos/feature_extraction_yolos.py,938,509,540,21,224,193,338,245,531,1841.08616841926,15.84375,66771.1830007642,3709.51016670912,4214.35474561037,151,23.9334670562979
transformers_4.23.0,src/transformers/models/yolos/configuration_yolos.py,180,49,77,0,0,0,0,0,0,0,0,0,0,0,5,100
transformers_4.23.0,src/transformers/models/yolos/convert_yolos_to_pytorch.py,266,177,204,5,82,82,115,87,197,532.92890485312,3.50609756097561,4450.14892983088,247.230496101716,1269.2598686822,37,43.9654412069495
transformers_4.23.0,src/transformers/models/xlm_prophetnet/__init__.py,80,37,52,1,4,4,4,5,8,8,0.5,9.28771237954945,0.51598402108608,18.5754247590989,14,81.7047600121114
transformers_4.23.0,src/transformers/models/xlm_prophetnet/modeling_xlm_prophetnet.py,179,22,25,0,0,0,0,0,0,0,0,0,0,0,1,100
transformers_4.23.0,src/transformers/models/xlm_prophetnet/tokenization_xlm_prophetnet.py,339,123,156,8,58,35,67,66,102,363.762897717399,4.62068965517241,2848.78547666867,158.265859814926,616.528200174562,35,58.8663594950995
transformers_4.23.0,src/transformers/models/xlm_prophetnet/configuration_xlm_prophetnet.py,184,41,83,1,2,1,2,3,3,2,0.5,2.37744375108173,0.13208020839343,4.75488750216347,4,85.0048974293054
transformers_4.23.0,src/transformers/models/wav2vec2_with_lm/__init__.py,31,9,8,0,0,0,0,0,0,0,0,0,0,0,2,100
transformers_4.23.0,src/transformers/models/wav2vec2_with_lm/processing_wav2vec2_with_lm.py,552,178,246,11,44,36,65,55,101,278.268739025051,8.125,4744.32831491117,263.573795272843,583.917331065991,53,51.5668636410048
transformers_4.23.0,src/transformers/models/funnel/convert_funnel_original_tf_checkpoint_to_pytorch.py,65,21,34,1,2,1,2,3,3,2,0.5,2.37744375108173,0.13208020839343,4.75488750216347,3,95.1938074543363
transformers_4.23.0,src/transformers/models/funnel/tokenization_funnel.py,143,31,88,3,20,12,24,23,36,91.1934493999107,1.8,293.126814752494,16.2848230418052,162.848230418052,6,79.5366453739235
transformers_4.23.0,src/transformers/models/funnel/__init__.py,138,52,107,1,6,6,6,7,12,15.5097750043269,0.5,16.8441295323456,0.935784974019201,33.6882590646913,20,70.1826899778745
transformers_4.23.0,src/transformers/models/funnel/tokenization_funnel_fast.py,171,33,116,3,20,12,24,23,36,91.1934493999107,1.8,293.126814752494,16.2848230418052,162.848230418052,6,77.321664793263
transformers_4.23.0,src/transformers/models/funnel/modeling_tf_funnel.py,1712,772,1242,15,213,211,378,228,589,1706.09650804223,13.3098591549296,61405.9964272418,3411.44424595788,4613.57221834303,193,7.32283416296295
transformers_4.23.0,src/transformers/models/funnel/configuration_funnel.py,188,50,99,4,10,5,10,14,15,41.2192809488736,2,114.220647661728,6.34559153676267,57.1103238308641,10,77.8240023147002
transformers_4.23.0,src/transformers/models/funnel/modeling_funnel.py,1612,815,1187,20,274,279,504,294,783,2305.29935262893,18.3941605839416,118096.828349907,6560.93490832819,6420.34344600687,222,1.87119149932476
transformers_4.23.0,src/transformers/models/flava/configuration_flava.py,646,165,268,5,28,20,44,33,64,146.21557829205,3.92857142857143,1268.30480715298,70.4613781751657,322.841223638941,32,54.8981249855463
transformers_4.23.0,src/transformers/models/flava/modeling_flava.py,2095,927,1487,17,250,256,461,267,717,2060.93293946678,15.674,90588.1805398551,5032.67669665862,5779.51898301998,233,0
transformers_4.23.0,src/transformers/models/flava/__init__.py,99,39,72,1,4,4,4,5,8,8,0.5,9.28771237954945,0.51598402108608,18.5754247590989,14,78.7555039254676
transformers_4.23.0,src/transformers/models/flava/convert_dalle_to_flava_codebook.py,102,59,58,4,9,5,10,13,15,36.5293250129808,2.22222222222222,123.347990604703,6.85266614470573,55.5065957721164,15,73.8796550334777
transformers_4.23.0,src/transformers/models/flava/processing_flava.py,124,34,73,3,7,9,18,10,27,24.4063719565667,3.85714285714286,345.955083024698,19.2197268347055,89.6920585619588,12,80.4609086403139
transformers_4.23.0,src/transformers/models/flava/convert_flava_original_pytorch_to_hf.py,99,59,58,6,13,7,14,19,21,63.6154913401611,3.23076923076923,288.205543604403,16.0114190891335,89.2064777823153,11,72.9748893216327
transformers_4.23.0,src/transformers/models/flava/feature_extraction_flava.py,351,134,197,15,65,48,95,80,143,450.057266780977,10.9615384615385,9909.62228873594,550.534571596441,904.035717568893,51,55.2310365781255
transformers_4.23.0,src/transformers/models/bart/configuration_bart.py,405,155,274,10,36,21,39,46,60,219.336581000797,5.41666666666667,1795.15763571853,99.7309797621405,331.413717363421,34,57.3274036403836
transformers_4.23.0,src/transformers/models/bart/tokenization_bart_fast.py,304,86,150,7,41,26,50,48,76,239.311116643745,4.26829268292683,1811.70734779491,100.650408210828,424.457150054808,25,65.0331986017644
transformers_4.23.0,src/transformers/models/bart/__init__.py,140,66,109,1,8,8,8,9,16,24,0.5,25.3594000115385,1.40885555619658,50.718800023077,26,65.7220303882475
transformers_4.23.0,src/transformers/models/bart/convert_bart_original_pytorch_checkpoint_to_pytorch.py,150,87,104,4,13,8,15,17,23,56.1057163358342,2.30769230769231,216.949950804826,12.0527750447125,94.0116453487578,13,65.9619092932222
transformers_4.23.0,src/transformers/models/bart/modeling_tf_bart.py,1466,492,1022,14,131,150,264,145,414,974.681382110212,14.1068702290076,41932.42295661,2329.579053145,2972.48236326618,143,22.0220598452099
transformers_4.23.0,src/transformers/models/bart/modeling_flax_bart.py,2000,804,1528,14,177,186,330,191,516,1375.0691512735,13.0508474576271,51028.2037619519,2834.90020899733,3909.95327526645,181,5.39208290418152
transformers_4.23.0,src/transformers/models/bart/tokenization_bart.py,417,175,223,15,104,68,133,119,201,755.449089620801,9.59134615384615,13292.2473509503,738.458186163907,1385.8583704249,56,50.7771250178582
transformers_4.23.0,src/transformers/models/bart/modeling_bart.py,1906,695,1286,17,196,242,431,213,673,1561.96999774784,18.6913265306122,97296.9446472363,5405.38581373535,5205.45957441199,225,6.81652038077268
transformers_4.23.0,src/transformers/models/gptj/modeling_flax_gptj.py,722,349,538,15,104,77,134,119,211,755.449089620801,9.66346153846154,14058.4671230603,781.025951281125,1454.80654805798,61,31.2962791173061
transformers_4.23.0,src/transformers/models/gptj/__init__.py,116,51,86,1,6,6,6,7,12,15.5097750043269,0.5,16.8441295323456,0.935784974019201,33.6882590646913,20,72.1559285160581
transformers_4.23.0,src/transformers/models/gptj/configuration_gptj.py,223,78,125,3,6,4,6,9,10,20.2646625064904,1.5,47.5488750216347,2.64160416786859,31.6992500144231,14,75.566314648821
transformers_4.23.0,src/transformers/models/gptj/modeling_gptj.py,1121,536,835,17,173,187,316,190,503,1355.67755168241,15.5260115606936,59117.4218409271,3284.30121338484,3807.63737099047,139,17.2400734192129
transformers_4.23.0,src/transformers/models/gptj/modeling_tf_gptj.py,1075,441,825,14,130,133,216,144,349,966.210784602506,11.6307692307692,29103.7183397007,1616.87324109448,2502.30382550337,106,23.0021708677244
transformers_4.23.0,src/transformers/models/longt5/modeling_flax_longt5.py,2448,1022,1762,19,322,324,588,341,912,2763.26585750833,17.3478260869565,133113.836514641,7395.21313970229,7673.22867127005,194,3.25469570001573
transformers_4.23.0,src/transformers/models/longt5/convert_longt5x_checkpoint_to_flax.py,214,112,128,3,22,19,38,25,57,102.862383112184,2.59090909090909,685.813125480822,38.100729193379,264.699802817159,20,62.4317587169564
transformers_4.23.0,src/transformers/models/longt5/__init__.py,88,37,58,1,4,4,4,5,8,8,0.5,9.28771237954945,0.51598402108608,18.5754247590989,14,80.9249967887991
transformers_4.23.0,src/transformers/models/longt5/configuration_longt5.py,178,62,93,7,15,9,17,22,26,78.254843388531,3.96666666666667,459.916047602127,25.5508915334515,115.94522208457,11,73.8266629924866
transformers_4.23.0,src/transformers/models/longt5/modeling_longt5.py,2214,1015,1531,19,373,390,702,392,1092,3267.26149171063,17.8793565683646,168195.812187243,9344.21178818015,9407.26314977381,246,0
transformers_4.23.0,src/transformers/models/prophetnet/convert_prophetnet_original_pytorch_checkpoint_to_pytorch.py,160,99,117,8,36,31,57,44,88,210.117300051923,6.33333333333333,3042.72322212052,169.040179006696,480.429982440082,26,56.2894471244228
transformers_4.23.0,src/transformers/models/prophetnet/__init__.py,69,24,42,1,2,2,2,3,4,2,0.5,3.16992500144231,0.176106944524573,6.33985000288463,8,91.2029753017169
transformers_4.23.0,src/transformers/models/prophetnet/configuration_prophetnet.py,182,41,83,1,2,1,2,3,3,2,0.5,2.37744375108173,0.13208020839343,4.75488750216347,4,85.1817460038282
transformers_4.23.0,src/transformers/models/prophetnet/modeling_prophetnet.py,2354,884,1472,15,292,343,609,307,952,2450.03213012709,15.6421232876712,123033.344288799,6835.18579382217,7865.51429279241,238,3.62814009453879
transformers_4.23.0,src/transformers/models/prophetnet/tokenization_prophetnet.py,511,235,280,17,126,78,160,143,238,948.624138662245,10.7936507936508,18392.913922924,1021.82855127356,1704.04937815326,85,43.456468431233
transformers_4.23.0,src/transformers/models/regnet/__init__.py,86,37,56,1,4,4,4,5,8,8,0.5,9.28771237954945,0.51598402108608,18.5754247590989,14,81.6115974707885
transformers_4.23.0,src/transformers/models/regnet/convert_regnet_seer_10b_to_pytorch.py,304,168,205,7,22,18,36,29,54,117.758980064424,5.72727272727273,1502.44103140218,83.4689461890101,262.330973736889,27,55.8549981165134
transformers_4.23.0,src/transformers/models/regnet/convert_regnet_to_pytorch.py,459,193,354,12,46,30,59,58,89,297.103399987276,7.69565217391304,4012.20759201064,222.900421778369,521.360308566354,39,45.0137589673159
transformers_4.23.0,src/transformers/models/regnet/configuration_regnet.py,94,22,31,1,2,1,2,3,3,2,0.5,2.37744375108173,0.13208020839343,4.75488750216347,3,79.1740404999655
transformers_4.23.0,src/transformers/models/regnet/modeling_tf_regnet.py,523,215,370,13,43,40,76,56,116,281.435100788024,11.4883720930233,7739.17828961835,429.954349423242,673.653170958682,65,43.6161081405721
transformers_4.23.0,src/transformers/models/regnet/modeling_regnet.py,455,206,324,14,51,46,86,65,132,342.596661349353,11.8039215686275,9383.55756655869,521.308753697705,794.952551319756,61,43.1991678113699
transformers_4.23.0,src/transformers/models/wav2vec2_phoneme/tokenization_wav2vec2_phoneme.py,631,231,322,12,67,39,76,79,115,449.447525769325,6.80597014925373,4933.88451394638,274.104695219243,724.934786040367,77,47.2647578558423
transformers_4.23.0,src/transformers/models/wav2vec2_phoneme/__init__.py,31,9,8,0,0,0,0,0,0,0,0,0,0,0,2,100
transformers_4.23.0,src/transformers/models/rembert/modeling_rembert.py,1532,679,1111,16,166,197,339,182,536,1288.25654560359,16.3373493975904,65744.4008338633,3652.46671299241,4024.1779271465,197,8.71687002373985
transformers_4.23.0,src/transformers/models/rembert/tokenization_rembert_fast.py,241,65,105,7,54,34,66,61,100,330.415409571231,4.27777777777778,2537.03763884635,140.946535491464,593.073733756289,18,65.3039488311525
transformers_4.23.0,src/transformers/models/rembert/tokenization_rembert.py,269,88,118,7,53,33,65,60,98,323.231268546253,4.29245283018868,2484.794826964,138.044157053556,578.875278369635,24,63.043503505675
transformers_4.23.0,src/transformers/models/rembert/configuration_rembert.py,138,28,51,0,0,0,0,0,0,0,0,0,0,0,2,100
transformers_4.23.0,src/transformers/models/rembert/__init__.py,152,65,117,1,8,8,8,9,16,24,0.5,25.3594000115385,1.40885555619658,50.718800023077,26,65.2925564513968
transformers_4.23.0,src/transformers/models/rembert/modeling_tf_rembert.py,1639,618,1210,12,119,149,255,131,404,863.502863842299,12.8571428571429,36533.6086194145,2029.64492330081,2841.50289262113,180,12.0388770103868
transformers_4.23.0,src/transformers/models/rembert/convert_rembert_tf_checkpoint_to_pytorch.py,63,20,32,1,2,1,2,3,3,2,0.5,2.37744375108173,0.13208020839343,4.75488750216347,2,95.8446982931609
transformers_4.23.0,src/transformers/models/roformer/tokenization_utils.py,68,29,34,2,4,2,4,6,6,10,1,15.5097750043269,0.861654166907052,15.5097750043269,9,87.3699243116885
transformers_4.23.0,src/transformers/models/roformer/convert_roformer_original_tf_checkpoint_to_pytorch.py,63,20,32,1,2,1,2,3,3,2,0.5,2.37744375108173,0.13208020839343,4.75488750216347,2,95.8446982931609
transformers_4.23.0,src/transformers/models/roformer/modeling_tf_roformer.py,1410,559,1043,11,96,120,203,107,323,670.210147874241,11.6302083333333,25324.7069642953,1406.92816468307,2177.49383660757,144,16.6117308397582
transformers_4.23.0,src/transformers/models/roformer/__init__.py,174,66,139,1,8,8,8,9,16,24,0.5,25.3594000115385,1.40885555619658,50.718800023077,26,63.7757499963944
transformers_4.23.0,src/transformers/models/roformer/tokenization_roformer.py,335,117,186,7,64,38,75,71,113,403.651484454403,4.1015625,2850.26365519231,158.347980844017,694.921424504029,34,59.6238965144661
transformers_4.23.0,src/transformers/models/roformer/modeling_flax_roformer.py,1098,463,851,13,83,81,133,96,214,577.233989137629,10.4156626506024,14677.5640665171,815.420225917615,1409.18197515433,87,22.9227446389611
transformers_4.23.0,src/transformers/models/roformer/modeling_roformer.py,1581,725,1148,17,193,222,381,210,603,1534.831076494,16.779792746114,78054.394910383,4336.35527279906,4651.69004715267,204,6.69607773972282
transformers_4.23.0,src/transformers/models/roformer/configuration_roformer.py,162,41,76,2,4,2,4,6,6,10,1,15.5097750043269,0.861654166907052,15.5097750043269,5,83.0203697334454
transformers_4.23.0,src/transformers/models/roformer/tokenization_roformer_fast.py,213,61,121,5,29,17,34,34,51,152.491089333136,2.93103448275862,760.487979890352,42.2493322161307,259.460604903767,12,71.3983632152913
transformers_4.23.0,src/transformers/models/canine/convert_canine_original_tf_checkpoint_to_pytorch.py,67,22,33,1,2,1,2,3,3,2,0.5,2.37744375108173,0.13208020839343,4.75488750216347,2,94.9458236569989
transformers_4.23.0,src/transformers/models/canine/modeling_canine.py,1624,735,1132,19,212,214,374,231,588,1719.02975912283,16.7594339622642,77375.4312941554,4298.63507189752,4616.82843635264,189,10.2830247842318
transformers_4.23.0,src/transformers/models/canine/__init__.py,73,24,46,1,2,2,2,3,4,2,0.5,3.16992500144231,0.176106944524573,6.33985000288463,8,90.6794703302887
transformers_4.23.0,src/transformers/models/canine/tokenization_canine.py,243,85,118,4,36,20,40,40,60,194.117300051923,2.22222222222222,709.590412651648,39.4216895917582,319.315685693242,27,65.5261306470346
transformers_4.23.0,src/transformers/models/canine/configuration_canine.py,139,28,52,0,0,0,0,0,0,0,0,0,0,0,2,100
transformers_4.23.0,src/transformers/models/hubert/__init__.py,87,37,58,1,4,4,4,5,8,8,0.5,9.28771237954945,0.51598402108608,18.5754247590989,14,80.9249967887991
transformers_4.23.0,src/transformers/models/hubert/modeling_tf_hubert.py,1694,699,1210,20,213,189,337,233,526,1733.93171100585,15.8215962441315,65447.0124119111,3635.94513399506,4136.56191208815,184,9.23547046527866
transformers_4.23.0,src/transformers/models/hubert/convert_hubert_original_pytorch_checkpoint_to_pytorch.py,249,134,196,9,61,53,98,70,151,390.304302604317,7.22950819672131,6691.06697346528,371.725942970293,925.52173555869,45,44.3583112419699
transformers_4.23.0,src/transformers/models/hubert/modeling_hubert.py,1343,613,908,19,162,190,331,181,521,1269.76632322274,19.4104938271605,75844.9461061553,4213.60811700863,3907.41970717035,169,14.7115740133561
transformers_4.23.0,src/transformers/models/hubert/convert_distilhubert_original_s3prl_checkpoint_to_pytorch.py,223,134,171,8,47,42,81,55,123,285.065676028849,6.8936170212766,4902.10100645499,272.338944803055,711.107244763533,39,46.1574368693691
transformers_4.23.0,src/transformers/models/hubert/configuration_hubert.py,257,54,104,2,7,4,9,9,13,21.6514844544032,1.28571428571429,52.9830321669644,2.94350178705358,41.2090250187501,6,71.0362989401765
transformers_4.23.0,src/transformers/models/hubert/convert_hubert_original_s3prl_checkpoint_to_pytorch.py,69,33,35,2,4,2,4,6,6,10,1,15.5097750043269,0.861654166907052,15.5097750043269,4,87.0059392706859
transformers_4.23.0,src/transformers/models/lxmert/modeling_lxmert.py,1443,707,981,16,146,152,273,162,425,1113.71438559648,14.958904109589,46663.3477580651,2592.4082087814,3119.43625122597,183,13.588880856375
transformers_4.23.0,src/transformers/models/lxmert/convert_lxmert_original_tf_checkpoint_to_pytorch.py,60,20,29,1,2,1,2,3,3,2,0.5,2.37744375108173,0.13208020839343,4.75488750216347,2,95.7932142485501
transformers_4.23.0,src/transformers/models/lxmert/__init__.py,121,52,90,1,6,6,6,7,12,15.5097750043269,0.5,16.8441295323456,0.935784974019201,33.6882590646913,20,71.599433744356
transformers_4.23.0,src/transformers/models/lxmert/modeling_tf_lxmert.py,1438,623,1038,13,101,112,197,114,309,720.585076093766,12.6782178217822,26768.320197125,1487.12889984028,2111.36301437691,158,16.5869133826826
transformers_4.23.0,src/transformers/models/lxmert/tokenization_lxmert_fast.py,55,17,25,0,0,0,0,0,0,0,0,0,0,0,1,100
transformers_4.23.0,src/transformers/models/lxmert/configuration_lxmert.py,177,41,69,0,0,0,0,0,0,0,0,0,0,0,2,100
transformers_4.23.0,src/transformers/models/lxmert/tokenization_lxmert.py,49,15,18,0,0,0,0,0,0,0,0,0,0,0,1,100
transformers_4.23.0,src/transformers/models/blenderbot_small/__init__.py,142,66,111,1,8,8,8,9,16,24,0.5,25.3594000115385,1.40885555619658,50.718800023077,26,65.5742131178831
transformers_4.23.0,src/transformers/models/blenderbot_small/modeling_flax_blenderbot_small.py,1518,592,1145,14,138,137,246,152,383,1034.27934394419,12.4782608695652,34639.1060958797,1924.39478310443,2775.95623764889,138,16.2324936441823
transformers_4.23.0,src/transformers/models/blenderbot_small/tokenization_blenderbot_small.py,238,139,154,10,40,31,56,50,87,246.096404744368,7,3437.10841957281,190.950467754045,491.015488510401,33,55.2277077377934
transformers_4.23.0,src/transformers/models/blenderbot_small/modeling_blenderbot_small.py,1586,564,1006,16,156,185,331,172,516,1200.52274614251,16.974358974359,65044.9392330308,3613.60773516837,3831.95261342628,185,16.9373755375745
transformers_4.23.0,src/transformers/models/blenderbot_small/configuration_blenderbot_small.py,395,152,266,8,32,19,35,40,54,184,4.375,1257.30551241714,69.8503062453966,287.384117123918,32,58.2643700498221
transformers_4.23.0,src/transformers/models/blenderbot_small/modeling_tf_blenderbot_small.py,1448,485,1000,14,123,141,247,137,388,907.232253065533,14.0569105691057,38713.2440562458,2150.73578090255,2754.03644818868,140,23.4013527047832
transformers_4.23.0,src/transformers/models/blenderbot_small/tokenization_blenderbot_small_fast.py,119,34,69,3,25,16,32,28,48,120.851292246532,1.92,443.045829616829,24.6136572009349,230.753036258765,6,77.9958051986385
transformers_4.23.0,src/transformers/models/gpt_neox/configuration_gpt_neox.py,122,25,44,0,0,0,0,0,0,0,0,0,0,0,2,100
transformers_4.23.0,src/transformers/models/gpt_neox/modeling_gpt_neox.py,683,322,446,13,113,104,179,126,283,818.785939088751,10.2964601769912,20331.0836199184,1129.50464555102,1974.57021835048,73,38.4184230044354
transformers_4.23.0,src/transformers/models/gpt_neox/__init__.py,78,38,49,1,4,4,4,5,8,8,0.5,9.28771237954945,0.51598402108608,18.5754247590989,14,81.8505861253324
transformers_4.23.0,src/transformers/models/gpt_neox/tokenization_gpt_neox_fast.py,142,41,59,4,6,4,7,10,11,23.5097750043269,2.33333333333333,85.262821102109,4.73682339456161,36.541209043761,8,79.3804058768473
transformers_4.23.0,src/transformers/models/electra/convert_electra_original_tf_checkpoint_to_pytorch.py,80,26,48,1,5,3,6,6,9,11.6096404744368,0.6,13.9587975038942,0.775488750216347,23.2646625064904,4,86.9434207461231
transformers_4.23.0,src/transformers/models/electra/modeling_electra.py,1675,739,1223,16,186,223,387,202,610,1466.28353886609,16.6451612903226,77758.0208487405,4319.89004715225,4671.5090044786,208,5.48605273929419
transformers_4.23.0,src/transformers/models/electra/configuration_electra.py,198,44,82,1,2,1,2,3,3,2,0.5,2.37744375108173,0.13208020839343,4.75488750216347,4,83.0029233475135
transformers_4.23.0,src/transformers/models/electra/tokenization_electra_fast.py,96,17,65,0,0,0,0,0,0,0,0,0,0,0,1,100
transformers_4.23.0,src/transformers/models/electra/__init__.py,172,66,139,1,8,8,8,9,16,24,0.5,25.3594000115385,1.40885555619658,50.718800023077,26,63.7757499963944
transformers_4.23.0,src/transformers/models/electra/modeling_flax_electra.py,1612,675,1224,14,128,124,213,142,337,949.302968908807,11.6484375,28066.4998898137,1559.24999387854,2409.46477927308,144,14.0310363447784
transformers_4.23.0,src/transformers/models/electra/modeling_tf_electra.py,1663,632,1210,13,120,140,242,133,382,876.932587808857,13.1083333333333,35328.5036794881,1962.69464886045,2695.11789036145,174,13.0515670629943
transformers_4.23.0,src/transformers/models/electra/tokenization_electra.py,532,237,303,17,137,84,172,154,256,1041.91726366685,10.6715328467153,19852.2243223282,1102.90135124046,1860.2973544179,86,42.8610046414445
transformers_4.23.0,src/transformers/models/auto/configuration_auto.py,820,176,637,11,63,37,72,74,109,414.622382985505,6.28571428571429,4254.36262022235,236.353478901242,676.830416853556,59,45.6617694422712
transformers_4.23.0,src/transformers/models/auto/auto_factory.py,655,185,524,11,76,43,80,87,123,512.896238826723,5.78947368421053,4588.05397362281,254.891887423489,792.482049989394,69,36.8045827281062
transformers_4.23.0,src/transformers/models/auto/processing_auto.py,287,93,150,7,23,18,34,30,52,123.693409443715,5.17391304347826,1320.16691328807,73.3426062937815,255.158310971643,28,65.5913725101613
transformers_4.23.0,src/transformers/models/auto/__init__.py,333,55,302,1,6,6,6,7,12,15.5097750043269,0.5,16.8441295323456,0.935784974019201,33.6882590646913,20,62.0731684115074
transformers_4.23.0,src/transformers/models/auto/modeling_flax_auto.py,346,71,258,0,0,0,0,0,0,0,0,0,0,0,1,100
transformers_4.23.0,src/transformers/models/auto/feature_extraction_auto.py,354,80,164,7,22,16,30,29,46,117.758980064424,4.77272727272727,1066.54764574846,59.2526469860257,223.467125775868,23,66.4731992224026
transformers_4.23.0,src/transformers/models/auto/tokenization_auto.py,684,151,464,9,52,47,93,61,140,324.952190356318,8.04807692307692,6682.34424245788,371.241346803215,830.303227258804,154,38.457574312143
transformers_4.23.0,src/transformers/models/auto/modeling_tf_auto.py,607,106,490,0,0,0,0,0,0,0,0,0,0,0,3,100
transformers_4.23.0,src/transformers/models/auto/modeling_auto.py,1118,159,950,0,0,0,0,0,0,0,0,0,0,0,3,100
transformers_4.23.0,src/transformers/models/van/modeling_van.py,550,264,382,13,69,60,108,82,168,469.593903853528,10.1739130434783,10866.4384524151,603.691025134169,1068.06873677584,66,41.1425410065531
transformers_4.23.0,src/transformers/models/van/__init__.py,59,23,32,1,2,2,2,3,4,2,0.5,3.16992500144231,0.176106944524573,6.33985000288463,8,92.7893572469268
transformers_4.23.0,src/transformers/models/van/convert_van_to_pytorch.py,291,143,222,8,23,14,27,31,41,128.041924989311,4.69565217391304,953.790489669265,52.9883605371814,203.122048725862,23,52.4635109412399
transformers_4.23.0,src/transformers/models/van/configuration_van.py,112,24,41,0,0,0,0,0,0,0,0,0,0,0,2,100
transformers_4.23.0,src/transformers/models/fsmt/tokenization_fsmt.py,543,269,316,13,86,59,114,99,173,600.764485240215,8.61627906976744,9881.8268976496,548.990383202755,1146.87869527377,64,45.5550682773037
transformers_4.23.0,src/transformers/models/fsmt/__init__.py,53,24,26,1,2,2,2,3,4,2,0.5,3.16992500144231,0.176106944524573,6.33985000288463,8,92.3960021243429
transformers_4.23.0,src/transformers/models/fsmt/configuration_fsmt.py,224,49,91,1,2,1,2,3,3,2,0.5,2.37744375108173,0.13208020839343,4.75488750216347,5,79.7434971709223
transformers_4.23.0,src/transformers/models/fsmt/modeling_fsmt.py,1328,518,860,19,164,157,286,183,443,1287.34915151279,16.5670731707317,55159.3250734979,3064.40694852766,3329.45502835983,151,22.6600044080745
transformers_4.23.0,src/transformers/models/fsmt/convert_fsmt_original_pytorch_checkpoint_to_pytorch.py,281,122,189,5,16,9,16,21,25,75.6096404744368,2.5,274.519838923673,15.2511021624263,109.807935569469,18,64.0690166456413
transformers_4.23.0,src/transformers/models/bert/convert_bert_pytorch_checkpoint_to_original_tf.py,113,48,61,4,7,4,7,11,11,27.6514844544032,2,76.1074956100206,4.2281942005567,38.0537478050103,6,80.2857168365976
transformers_4.23.0,src/transformers/models/bert/tokenization_bert_fast.py,304,49,195,5,32,18,37,37,55,171.609640474437,2.890625,828.221687426165,46.0123159681203,286.519935109592,10,72.896859417182
transformers_4.23.0,src/transformers/models/bert/__init__.py,201,80,168,1,10,10,10,11,20,33.2192809488736,0.5,34.594316186373,1.9219064547985,69.188632372746,32,58.7471481743484
transformers_4.23.0,src/transformers/models/bert/convert_bert_token_dropping_original_tf2_checkpoint_to_pytorch.py,187,90,117,2,10,5,10,12,15,35.2192809488736,1,53.7744375108174,2.98746875060096,53.7744375108174,3,69.6671183359326
transformers_4.23.0,src/transformers/models/bert/modeling_tf_bert.py,2033,749,1471,12,157,183,320,169,503,1188.27500758464,12.2292993630573,45525.3077986235,2529.18376659019,3722.64235644994,209,6.36061739721066
transformers_4.23.0,src/transformers/models/bert/convert_bert_original_tf_checkpoint_to_pytorch.py,63,20,32,1,2,1,2,3,3,2,0.5,2.37744375108173,0.13208020839343,4.75488750216347,2,95.8446982931609
transformers_4.23.0,src/transformers/models/bert/tokenization_bert_tf.py,222,101,137,11,30,29,54,41,83,185.260465673266,9.9,4402.30048219468,244.572249010816,444.676816383301,37,61.8194631498379
transformers_4.23.0,src/transformers/models/bert/modeling_bert.py,1889,816,1355,16,199,241,417,215,658,1583.68829948819,16.7638190954774,85467.1615367821,4748.17564093234,5098.31089502987,229,2.28037202120005
transformers_4.23.0,src/transformers/models/bert/convert_bert_original_tf2_checkpoint_to_pytorch.py,245,157,175,11,43,40,79,54,119,271.3831322572,10.1046511627907,6919.98455216542,384.443586231412,684.831612757453,40,53.3024578363243
transformers_4.23.0,src/transformers/models/bert/modeling_flax_bert.py,1719,690,1330,14,123,126,214,137,340,907.232253065533,12.1788617886179,29391.6235812476,1632.86797673598,2413.33090820658,143,11.6307869880174
transformers_4.23.0,src/transformers/models/bert/tokenization_bert.py,574,238,349,17,137,84,172,154,256,1041.91726366685,10.6715328467153,19852.2243223282,1102.90135124046,1860.2973544179,86,42.2794535469431
transformers_4.23.0,src/transformers/models/bert/configuration_bert.py,191,39,101,1,2,1,2,3,3,2,0.5,2.37744375108173,0.13208020839343,4.75488750216347,4,88.7873835052775
transformers_4.23.0,src/transformers/models/xlm/modeling_tf_xlm.py,1309,505,950,18,123,133,240,141,373,928.987934182688,17.5609756097561,46765.8027122005,2598.10015067781,2663.05265444475,137,21.5131110470186
transformers_4.23.0,src/transformers/models/xlm/configuration_xlm.py,250,60,111,2,4,2,4,6,6,10,1,15.5097750043269,0.861654166907052,15.5097750043269,5,77.5790936944873
transformers_4.23.0,src/transformers/models/xlm/__init__.py,109,38,80,1,4,4,4,5,8,8,0.5,9.28771237954945,0.51598402108608,18.5754247590989,14,78.1511852960578
transformers_4.23.0,src/transformers/models/xlm/convert_xlm_original_pytorch_checkpoint_to_pytorch.py,78,38,41,7,26,17,32,33,49,141.862917126072,4.30769230769231,1064.75518950151,59.1530660834171,247.175311848564,9,76.241564220622
transformers_4.23.0,src/transformers/models/xlm/modeling_xlm.py,1279,542,910,19,172,195,346,191,541,1358.02816056419,19.1104651162791,78341.2304054921,4352.2905780829,4099.38899596734,152,19.2262464101397
transformers_4.23.0,src/transformers/models/xlm/tokenization_xlm.py,999,322,754,13,112,76,148,125,224,810.529467606286,8.58928571428571,13402.1689636899,744.564942427214,1560.33567976431,75,36.5029536036439
transformers_4.23.0,src/transformers/models/vilt/processing_vilt.py,108,24,55,0,0,0,0,0,0,0,0,0,0,0,5,100
transformers_4.23.0,src/transformers/models/vilt/__init__.py,88,39,58,1,4,4,4,5,8,8,0.5,9.28771237954945,0.51598402108608,18.5754247590989,14,80.8660629831483
transformers_4.23.0,src/transformers/models/vilt/feature_extraction_vilt.py,292,105,134,11,38,28,54,49,82,237.474993315867,7.81578947368421,3598.43798798899,199.913221554944,460.406207217447,35,60.5057499831076
transformers_4.23.0,src/transformers/models/vilt/convert_vilt_original_to_pytorch.py,300,163,231,5,27,25,39,32,64,139.991603032851,3.61111111111111,1155.55555555556,64.1975308641975,320,34,51.6234439168956
transformers_4.23.0,src/transformers/models/vilt/modeling_vilt.py,1489,604,966,16,142,168,298,158,466,1079.26409096966,16.7887323943662,57141.4887288934,3174.52715160519,3403.56182865053,163,18.1331979005829
transformers_4.23.0,src/transformers/models/vilt/configuration_vilt.py,148,30,53,0,0,0,0,0,0,0,0,0,0,0,2,100
transformers_4.23.0,src/transformers/models/bartpho/tokenization_bartpho.py,329,118,150,8,75,46,88,83,134,491.161401787191,4.69333333333333,4009.30479863696,222.739155479831,854.255283800488,39,57.6185678021348
transformers_4.23.0,src/transformers/models/bartpho/__init__.py,46,21,21,1,2,2,2,3,4,2,0.5,3.16992500144231,0.176106944524573,6.33985000288463,8,92.8814536032276
transformers_4.23.0,src/transformers/models/layoutxlm/__init__.py,71,37,43,1,4,4,4,5,8,8,0.5,9.28771237954945,0.51598402108608,18.5754247590989,14,82.8971939290087
transformers_4.23.0,src/transformers/models/layoutxlm/tokenization_layoutxlm_fast.py,802,228,546,15,158,117,227,173,344,1212.60071714611,10.7753164556962,27558.0023278337,1531.00012932409,2557.51211030703,96,38.2617827233763
transformers_4.23.0,src/transformers/models/layoutxlm/tokenization_layoutxlm.py,1176,378,787,18,253,195,363,271,558,2094.75602442362,12.9130434782609,58235.7492185831,3235.3194010324,4509.83916507546,131,27.5718490511829
transformers_4.23.0,src/transformers/models/layoutxlm/processing_layoutxlm.py,160,41,86,4,18,15,31,22,46,83.0586500259616,3.44444444444444,706.572165352976,39.2540091862765,205.133854457316,21,74.9363533286251
transformers_4.23.0,src/transformers/models/markuplm/configuration_markuplm.py,162,32,66,0,0,0,0,0,0,0,0,0,0,0,2,100
transformers_4.23.0,src/transformers/models/markuplm/tokenization_markuplm_fast.py,924,304,651,17,191,139,272,208,411,1516.77577445608,12.1047120418848,38309.9698128201,2128.33165626779,3164.88072415599,106,33.3831429676959
transformers_4.23.0,src/transformers/models/markuplm/__init__.py,88,40,58,1,4,4,4,5,8,8,0.5,9.28771237954945,0.51598402108608,18.5754247590989,14,80.6262100654024
transformers_4.23.0,src/transformers/models/markuplm/feature_extraction_markuplm.py,183,80,81,7,26,15,27,33,42,141.862917126072,3.63461538461538,770.046163835912,42.7803424353284,211.864553013055,29,66.8800542570222
transformers_4.23.0,src/transformers/models/markuplm/modeling_markuplm.py,1300,567,887,14,179,188,330,193,518,1392.90599303911,12.9050279329609,50754.0907354986,2819.6717075277,3932.89274530487,159,17.0982917290571
transformers_4.23.0,src/transformers/models/markuplm/processing_markuplm.py,140,36,75,4,13,13,27,17,40,56.1057163358342,4.15384615384615,679.147672084672,37.7304262269262,163.498513650014,17,77.2910758081487
transformers_4.23.0,src/transformers/models/markuplm/tokenization_markuplm.py,1461,519,1077,19,337,255,484,356,739,2910.36643401371,13.6439169139466,85459.5878077632,4747.75487820907,6263.56700548417,175,15.5939582008742
transformers_4.23.0,src/transformers/models/layoutlmv2/tokenization_layoutlmv2_fast.py,819,235,577,15,152,110,216,167,326,1160.28834097755,10.6578947368421,25654.4862561934,1425.24923645519,2407.08759934654,93,38.5116224893504
transformers_4.23.0,src/transformers/models/layoutlmv2/tokenization_layoutlmv2.py,1554,534,1131,19,333,239,466,352,705,2871.04361899016,13.2942942942943,79285.8323179389,4404.76846210772,5963.89929113929,199,11.890900627029
transformers_4.23.0,src/transformers/models/layoutlmv2/__init__.py,107,53,78,1,6,6,6,7,12,15.5097750043269,0.5,16.8441295323456,0.935784974019201,33.6882590646913,20,72.5875669870635
transformers_4.23.0,src/transformers/models/layoutlmv2/processing_layoutlmv2.py,160,41,86,4,18,15,31,22,46,83.0586500259616,3.44444444444444,706.572165352976,39.2540091862765,205.133854457316,21,74.9363533286251
transformers_4.23.0,src/transformers/models/layoutlmv2/configuration_layoutlmv2.py,223,40,114,2,3,3,4,5,7,6.75488750216347,1.33333333333333,21.6713288856154,1.20396271586752,16.2534966642115,8,83.5946739141859
transformers_4.23.0,src/transformers/models/layoutlmv2/feature_extraction_layoutlmv2.py,238,77,96,10,38,27,51,48,78,232.64052645973,6.71052631578947,2923.28695103536,162.404830613076,435.62707505625,37,61.3335650366557
transformers_4.23.0,src/transformers/models/layoutlmv2/modeling_layoutlmv2.py,1426,640,1000,17,217,207,361,234,568,1753.74348574171,14.1405529953917,63213.4637450676,3511.8590969482,4470.36716072337,151,16.3376570714472
transformers_4.23.0,src/transformers/models/camembert/__init__.py,146,65,113,1,8,8,8,9,16,24,0.5,25.3594000115385,1.40885555619658,50.718800023077,26,65.5739506771058
transformers_4.23.0,src/transformers/models/camembert/modeling_camembert.py,1583,671,1114,15,173,211,365,188,576,1344.79404231528,15.8236994219653,68855.9289093948,3825.32938385527,4351.44317856632,193,10.433608876661
transformers_4.23.0,src/transformers/models/camembert/tokenization_camembert.py,298,102,128,9,72,43,83,81,126,472.763925116827,5.1875,4143.88445813546,230.215803229748,798.821100363463,31,59.1582041288645
transformers_4.23.0,src/transformers/models/camembert/configuration_camembert.py,61,22,30,1,2,1,2,3,3,2,0.5,2.37744375108173,0.13208020839343,4.75488750216347,3,94.5973913310286
transformers_4.23.0,src/transformers/models/camembert/tokenization_camembert_fast.py,211,55,91,5,35,24,45,40,69,191.134546067511,3.21428571428571,1180.3276239018,65.5737568834336,367.213038547228,14,69.5602751183308
transformers_4.23.0,src/transformers/models/camembert/modeling_tf_camembert.py,1736,654,1247,12,133,160,277,145,437,981.372113930312,12.4962406015038,39208.457839273,2178.24765773739,3137.62027233653,184,12.1042294950996
transformers_4.23.0,src/transformers/models/perceiver/convert_perceiver_haiku_to_pytorch.py,468,287,363,11,97,99,185,108,284,678.245293497162,10.4896907216495,20123.2973350534,1117.96096305852,1918.38805061443,74,35.3993637229935
transformers_4.23.0,src/transformers/models/perceiver/configuration_perceiver.py,241,72,122,3,10,5,10,13,15,37.9741684510371,1.5,83.2598936581746,4.62554964767637,55.5065957721164,9,74.1091628421535
transformers_4.23.0,src/transformers/models/perceiver/__init__.py,98,38,70,1,4,4,4,5,8,8,0.5,9.28771237954945,0.51598402108608,18.5754247590989,14,79.2260068991627
transformers_4.23.0,src/transformers/models/perceiver/modeling_perceiver.py,3423,1237,2087,18,330,374,679,348,1053,2835.94498072708,18.5181818181818,164634.404761811,9146.3558201006,8890.41950112871,361,0
transformers_4.23.0,src/transformers/models/perceiver/tokenization_perceiver.py,215,88,110,7,56,32,64,63,96,344.863360089629,4,2295.27549062397,127.515305034665,573.818872655992,33,63.0501896489161
transformers_4.23.0,src/transformers/models/perceiver/feature_extraction_perceiver.py,189,57,79,11,42,25,49,53,74,264.531079561718,6.41666666666667,2719.80756250843,151.100420139357,423.866113637677,26,66.3255637500882
transformers_4.23.0,src/transformers/models/videomae/__init__.py,77,37,50,1,4,4,4,5,8,8,0.5,9.28771237954945,0.51598402108608,18.5754247590989,14,81.9700739406769
transformers_4.23.0,src/transformers/models/videomae/modeling_videomae.py,1036,448,616,17,144,138,252,161,390,1101.95606850895,14.875,42528.4815391624,2362.69341884236,2859.0575824647,107,31.1292943863678
transformers_4.23.0,src/transformers/models/videomae/convert_videomae_to_pytorch.py,288,205,228,7,75,72,135,82,207,486.812886241594,6.3,8290.88356922244,460.60464273458,1316.01326495594,65,37.5125656463838
transformers_4.23.0,src/transformers/models/videomae/feature_extraction_videomae.py,169,57,70,6,23,15,26,29,41,119.551699993638,3.39130434782609,675.470574887738,37.5261430493188,199.17722080023,29,68.1371647801706
transformers_4.23.0,src/transformers/models/videomae/configuration_videomae.py,148,32,55,0,0,0,0,0,0,0,0,0,0,0,2,100
transformers_4.23.0,src/transformers/models/layoutlmv3/tokenization_layoutlmv3.py,1478,461,1049,19,296,222,426,315,648,2510.7088189816,13.6722972972973,73528.0671049589,4084.89261694216,5377.88679591496,167,19.3036870567882
transformers_4.23.0,src/transformers/models/layoutlmv3/modeling_layoutlmv3.py,1397,589,983,16,185,189,336,201,525,1457.30557019552,14.5297297297297,58363.0494410363,3242.39163561312,4016.80213786894,146,17.269526176133
transformers_4.23.0,src/transformers/models/layoutlmv3/configuration_layoutlmv3.py,294,61,142,2,7,4,8,9,12,21.6514844544032,1.14285714285714,43.4732571626374,2.41518095347986,38.0391000173078,8,76.68711129794
transformers_4.23.0,src/transformers/models/layoutlmv3/__init__.py,146,67,113,1,8,8,8,9,16,24,0.5,25.3594000115385,1.40885555619658,50.718800023077,26,65.2868473660974
transformers_4.23.0,src/transformers/models/layoutlmv3/feature_extraction_layoutlmv3.py,247,79,102,9,40,28,54,49,82,241.406448808475,6.075,2796.96770884599,155.387094935888,460.406207217447,39,60.7737885845327
transformers_4.23.0,src/transformers/models/layoutlmv3/modeling_tf_layoutlmv3.py,1634,609,1177,17,162,160,294,179,454,1258.54256876857,15.4259259259259,52411.9336718028,2911.77409287793,3397.65236287797,154,16.7568887394131
transformers_4.23.0,src/transformers/models/layoutlmv3/tokenization_layoutlmv3_fast.py,853,250,594,15,156,114,224,171,338,1195.12610507664,10.7692307692308,27000.9831541847,1500.05461967693,2507.23415003143,98,37.2849905194919
transformers_4.23.0,src/transformers/models/layoutlmv3/processing_layoutlmv3.py,158,39,84,4,14,12,25,18,37,61.3029689088065,3.57142857142857,551.02580376202,30.6125446534455,154.287225053366,19,76.4401082088454
transformers_4.23.0,src/transformers/models/wav2vec2/convert_wav2vec2_original_pytorch_checkpoint_to_pytorch.py,270,143,215,10,58,51,94,68,145,372.982178666273,8.10344827586207,7152.76883846915,397.376046581619,882.682111981299,43,44.2126291623201
transformers_4.23.0,src/transformers/models/wav2vec2/tokenization_wav2vec2.py,927,316,481,14,85,57,107,99,164,598.101198480511,8.81176470588235,9580.2782327541,532.23767959745,1087.21448569306,115,37.9798907112528
transformers_4.23.0,src/transformers/models/wav2vec2/modeling_tf_wav2vec2.py,1732,714,1235,20,213,189,337,233,526,1733.93171100585,15.8215962441315,65447.0124119111,3635.94513399506,4136.56191208815,184,8.95319516202021
transformers_4.23.0,src/transformers/models/wav2vec2/__init__.py,136,54,104,1,6,6,6,7,12,15.5097750043269,0.5,16.8441295323456,0.935784974019201,33.6882590646913,20,70.0572117457013
transformers_4.23.0,src/transformers/models/wav2vec2/convert_wav2vec2_original_s3prl_checkpoint_to_pytorch.py,110,59,70,1,2,1,2,3,3,2,0.5,2.37744375108173,0.13208020839343,4.75488750216347,7,80.6205714250733
transformers_4.23.0,src/transformers/models/wav2vec2/feature_extraction_wav2vec2.py,237,59,100,11,37,23,43,48,66,230.803522333281,6.39189189189189,2356.09945064207,130.894413924559,368.607525047596,26,65.9722241962226
transformers_4.23.0,src/transformers/models/wav2vec2/modeling_flax_wav2vec2.py,1428,608,994,18,136,146,260,154,406,1038.95359643601,17.2058823529412,50762.778567072,2820.15436483733,2950.31533552213,134,17.3506592962981
transformers_4.23.0,src/transformers/models/wav2vec2/modeling_wav2vec2.py,2167,984,1442,19,260,312,536,279,848,2166.52625414283,19.5846153846154,134923.406963152,7495.7448312862,6889.25487243115,248,0
transformers_4.23.0,src/transformers/models/wav2vec2/processing_wav2vec2.py,163,86,88,5,14,14,28,19,42,64.9126093832433,5,892.064777823153,49.5591543235085,178.412955564631,24,68.0080186255648
transformers_4.23.0,src/transformers/models/wav2vec2/configuration_wav2vec2.py,338,70,136,2,9,5,11,11,16,30.5293250129808,1.22222222222222,67.6511072089072,3.75839484493929,55.3509058981968,7,66.9811696585913
transformers_4.23.0,src/transformers/models/tapas/convert_tapas_original_tf_checkpoint_to_pytorch.py,138,58,92,3,12,9,17,15,26,47.7744375108174,2.125,215.855705407371,11.9919836337428,101.579155485821,8,73.0111319921164
transformers_4.23.0,src/transformers/models/tapas/__init__.py,99,38,70,1,4,4,4,5,8,8,0.5,9.28771237954945,0.51598402108608,18.5754247590989,14,79.2260068991627
transformers_4.23.0,src/transformers/models/tapas/tokenization_tapas.py,2828,1210,1863,21,579,396,771,600,1167,5405.96457837412,13.9818652849741,150585.128314849,8365.84046193603,10770.0314118087,439,0
transformers_4.23.0,src/transformers/models/tapas/modeling_tapas.py,2437,911,1382,21,326,286,519,347,805,2813.92404415768,16.7162576687117,113557.34031136,6308.74112840888,6793.2274413255,221,7.99155626946832
transformers_4.23.0,src/transformers/models/tapas/modeling_tf_tapas.py,2329,794,1362,16,242,218,392,258,610,1980.36490342045,12.9586776859504,63327.096241878,3518.17201343766,4886.84862580818,177,15.7553969762841
transformers_4.23.0,src/transformers/models/tapas/configuration_tapas.py,244,48,97,0,0,0,0,0,0,0,0,0,0,0,4,100
transformers_4.23.0,src/transformers/models/mpnet/configuration_mpnet.py,116,23,40,0,0,0,0,0,0,0,0,0,0,0,2,100
transformers_4.23.0,src/transformers/models/mpnet/__init__.py,134,52,103,1,6,6,6,7,12,15.5097750043269,0.5,16.8441295323456,0.935784974019201,33.6882590646913,20,70.493707269414
transformers_4.23.0,src/transformers/models/mpnet/modeling_mpnet.py,1074,501,801,16,128,153,266,144,419,960,16.625,49944.801319422,2774.71118441233,3004.19857560433,123,18.5728038529256
transformers_4.23.0,src/transformers/models/mpnet/tokenization_mpnet_fast.py,216,62,98,5,33,20,40,38,60,178.074646413266,3.03030303030303,954.168638807925,53.0093688226625,314.875650806615,14,69.3448456943972
transformers_4.23.0,src/transformers/models/mpnet/tokenization_mpnet.py,532,246,290,17,137,85,174,154,259,1041.91726366685,10.7956204379562,20318.4125479207,1128.8006971067,1882.09771403998,93,41.6314487412744
transformers_4.23.0,src/transformers/models/mpnet/modeling_tf_mpnet.py,1265,514,930,13,95,112,197,108,309,672.241999127274,13.4789473684211,28134.0708944714,1563.00393858174,2087.26023816851,123,20.6822926768545
transformers_4.23.0,src/transformers/models/led/modeling_tf_led.py,2555,842,1689,16,262,292,521,278,813,2168.75682640281,15.9083969465649,105006.541282342,5833.69673790791,6600.69909212421,177,11.9185046871024
transformers_4.23.0,src/transformers/models/led/__init__.py,105,52,74,1,6,6,6,7,12,15.5097750043269,0.5,16.8441295323456,0.935784974019201,33.6882590646913,20,73.1931478604875
transformers_4.23.0,src/transformers/models/led/tokenization_led_fast.py,335,103,163,10,65,41,78,75,119,424.673188795723,6,4447.37654501406,247.076474723003,741.22942416901,32,60.6497797911897
transformers_4.23.0,src/transformers/models/led/tokenization_led.py,464,193,245,15,128,83,161,143,244,954.603358934128,9.43359375,16480.5694683986,915.587192688809,1747.00860617393,63,48.2018096824062
transformers_4.23.0,src/transformers/models/led/modeling_led.py,2771,1002,1743,18,326,388,690,344,1078,2796.74402830529,19.0490797546012,173032.571314671,9612.92062859281,9083.51340556886,256,0
transformers_4.23.0,src/transformers/models/led/configuration_led.py,166,35,74,0,0,0,0,0,0,0,0,0,0,0,2,100
transformers_4.23.0,src/transformers/models/megatron_gpt2/checkpoint_reshaping_and_interoperability.py,900,400,626,17,140,112,220,157,332,1067.58649067355,13.3571428571429,32348.5167552991,1797.13981973884,2421.81408863202,102,31.2461659363166
transformers_4.23.0,src/transformers/models/megatron_gpt2/__init__.py,17,0,0,0,0,0,0,0,0,0,0,0,0,0,1,100
transformers_4.23.0,src/transformers/models/megatron_gpt2/convert_megatron_gpt2_checkpoint.py,364,156,196,13,72,52,103,85,155,492.340316439681,9.29861111111111,9237.75723500486,513.208735278048,993.455595101344,35,55.5850554631313
transformers_4.23.0,src/transformers/models/dialogpt/__init__.py,0,0,0,0,0,0,0,0,0,0,0,0,0,0,1,100
transformers_4.23.0,src/transformers/models/dialogpt/convert_dialogpt_original_pytorch_checkpoint_to_pytorch.py,46,20,23,1,2,1,2,3,3,2,0.5,2.37744375108173,0.13208020839343,4.75488750216347,3,95.7118246627005
transformers_4.23.0,src/transformers/models/bert_generation/configuration_bert_generation.py,117,20,37,0,0,0,0,0,0,0,0,0,0,0,2,100
transformers_4.23.0,src/transformers/models/bert_generation/__init__.py,75,37,46,1,4,4,4,5,8,8,0.5,9.28771237954945,0.51598402108608,18.5754247590989,14,82.5026769126246
transformers_4.23.0,src/transformers/models/bert_generation/tokenization_bert_generation.py,172,72,87,5,13,8,13,18,21,59.715356810271,2.5,218.921062575721,12.1622812542067,87.5684250302886,19,72.5080321631986
transformers_4.23.0,src/transformers/models/bert_generation/modeling_bert_generation.py,992,476,693,14,141,141,251,155,392,1059.97970959704,12.4609929078014,35541.751967278,1974.54177595989,2852.2407668675,143,21.9104618924893
transformers_4.23.0,src/transformers/models/bertweet/__init__.py,33,9,8,0,0,0,0,0,0,0,0,0,0,0,2,100
transformers_4.23.0,src/transformers/models/bertweet/tokenization_bertweet.py,771,276,411,17,109,73,137,126,210,807.218959701941,10.6834862385321,15653.7515494705,869.652863859474,1465.22878393498,64,45.2179583856523
transformers_4.23.0,src/transformers/models/swinv2/configuration_swinv2.py,147,34,58,3,6,3,6,9,9,20.2646625064904,1.5,42.7939875194712,2.37744375108173,28.5293250129808,2,77.7682721665533
transformers_4.23.0,src/transformers/models/swinv2/__init__.py,65,23,36,1,2,2,2,3,4,2,0.5,3.16992500144231,0.176106944524573,6.33985000288463,8,92.5279837529009
transformers_4.23.0,src/transformers/models/swinv2/modeling_swinv2.py,1300,620,842,19,265,241,437,284,678,2213.92048835983,15.6660377358491,86563.1387281919,4809.06326267733,5525.52854702418,135,20.9556563405225
transformers_4.23.0,src/transformers/models/swinv2/convert_swinv2_timm_to_pytorch.py,219,159,168,7,40,37,70,47,107,232.528608249898,6.125,3640.33866866823,202.241037148235,594.341007129507,35,44.816509397374
transformers_4.23.0,src/transformers/models/swin/modeling_tf_swin.py,1491,688,1000,20,249,236,427,269,663,2068.4790429827,17.14859437751,91768.6372008893,5098.25762227163,5351.37954637504,147,17.3178321477771
transformers_4.23.0,src/transformers/models/swin/__init__.py,89,37,60,1,4,4,4,5,8,8,0.5,9.28771237954945,0.51598402108608,18.5754247590989,14,81.1208193000924
transformers_4.23.0,src/transformers/models/swin/modeling_swin.py,1217,597,774,18,235,219,398,253,617,1926.04013246874,15.2425531914894,75077.3029849806,4170.96127694337,4925.50703558639,127,22.6293690633905
transformers_4.23.0,src/transformers/models/swin/configuration_swin.py,170,46,74,3,6,3,6,9,9,20.2646625064904,1.5,42.7939875194712,2.37744375108173,28.5293250129808,4,78.8378466924435
transformers_4.23.0,src/transformers/models/swin/convert_swin_timm_to_pytorch.py,173,129,140,5,30,27,51,35,78,158.816358342692,4.25,1700.35732011726,94.4642955620698,400.084075321707,25,37.4712129739398
transformers_4.23.0,src/transformers/models/codegen/tokenization_codegen.py,387,194,230,15,71,49,94,86,143,495.23540441896,9.92957746478873,9124.84339782101,506.93574432339,918.9558599224,61,49.10494635334
transformers_4.23.0,src/transformers/models/codegen/configuration_codegen.py,236,79,137,3,6,4,6,9,10,20.2646625064904,1.5,47.5488750216347,2.64160416786859,31.6992500144231,14,75.3047021709593
transformers_4.23.0,src/transformers/models/codegen/tokenization_codegen_fast.py,254,77,128,7,22,14,24,29,38,117.758980064424,3.81818181818182,704.848878929419,39.1582710516344,184.603277814848,23,69.1226937581492
transformers_4.23.0,src/transformers/models/codegen/__init__.py,77,38,50,1,4,4,4,5,8,8,0.5,9.28771237954945,0.51598402108608,18.5754247590989,14,81.7174273893722
transformers_4.23.0,src/transformers/models/codegen/modeling_codegen.py,746,364,533,14,133,137,224,147,361,991.655532830465,11.7894736842105,30641.8054996236,1702.32252775686,2599.08171648593,87,30.3309763113237
transformers_4.23.0,src/transformers/models/encoder_decoder/configuration_encoder_decoder.py,119,33,34,2,5,3,6,7,9,13.6096404744368,1.2,30.3194331582221,1.68441295323456,25.2661942985184,5,67.4715667454349
transformers_4.23.0,src/transformers/models/encoder_decoder/modeling_tf_encoder_decoder.py,712,223,450,11,79,70,132,90,202,536.052426911001,9.18987341772152,12051.1802567461,669.510014263671,1311.35432545859,89,41.6813462313836
transformers_4.23.0,src/transformers/models/encoder_decoder/__init__.py,86,51,56,1,6,6,6,7,12,15.5097750043269,0.5,16.8441295323456,0.935784974019201,33.6882590646913,20,75.5240248376099
transformers_4.23.0,src/transformers/models/encoder_decoder/modeling_encoder_decoder.py,583,169,369,11,68,59,111,79,170,452.001221010033,8.97794117647059,9621.1453669053,534.508075939184,1071.64272719011,68,47.6256636251434
transformers_4.23.0,src/transformers/models/encoder_decoder/modeling_flax_encoder_decoder.py,903,262,608,11,87,73,136,98,209,598.58983194385,8.59770114942529,11886.1013718416,660.338965102311,1382.47435742008,77,39.8504349036298
transformers_4.23.0,src/transformers/models/byt5/tokenization_byt5.py,250,103,124,12,76,46,91,88,137,517.862041030366,7.18421052631579,6357.61057812246,353.20058767347,884.94213175331,39,59.261352934484
transformers_4.23.0,src/transformers/models/byt5/__init__.py,32,9,8,0,0,0,0,0,0,0,0,0,0,0,2,100
transformers_4.23.0,src/transformers/models/byt5/convert_byt5_original_tf_checkpoint_to_pytorch.py,60,19,30,1,2,1,2,3,3,2,0.5,2.37744375108173,0.13208020839343,4.75488750216347,2,96.3176030216455
transformers_4.23.0,src/transformers/models/bert_japanese/tokenization_bert_japanese.py,532,218,336,8,56,45,88,64,133,349.211875635226,6.28571428571429,5016,278.666666666667,798,78,44.9002244844004
transformers_4.23.0,src/transformers/models/bert_japanese/__init__.py,33,9,8,0,0,0,0,0,0,0,0,0,0,0,2,100
transformers_4.23.0,src/transformers/models/sew_d/configuration_sew_d.py,288,61,118,2,7,4,9,9,13,21.6514844544032,1.28571428571429,52.9830321669644,2.94350178705358,41.2090250187501,6,70.1818261834333
transformers_4.23.0,src/transformers/models/sew_d/__init__.py,60,23,34,1,2,2,2,3,4,2,0.5,3.16992500144231,0.176106944524573,6.33985000288463,8,92.5173434722518
transformers_4.23.0,src/transformers/models/sew_d/convert_sew_d_original_pytorch_checkpoint_to_pytorch.py,317,189,254,10,66,55,103,76,158,432.149292826532,7.8030303030303,7702.93729952886,427.940961084937,987.172547124087,52,39.4535058664043
transformers_4.23.0,src/transformers/models/sew_d/modeling_sew_d.py,1754,868,1210,21,292,324,552,313,876,2483.66743707132,19.8493150684932,144146.847710464,8008.15820613691,7262.05650991297,234,0.531882605444799
transformers_4.23.0,src/transformers/models/speech_to_text_2/modeling_speech_to_text_2.py,965,367,539,16,132,134,239,148,373,993.860023755316,14.4848484848485,38951.5841930742,2163.97689961523,2689.1261053796,116,33.380156007441
transformers_4.23.0,src/transformers/models/speech_to_text_2/tokenization_speech_to_text_2.py,270,143,175,11,47,34,64,58,98,299.119423833859,7.48936170212766,4299.50877463661,238.861598590923,574.082137522502,38,53.5778675747896
transformers_4.23.0,src/transformers/models/speech_to_text_2/configuration_speech_to_text_2.py,145,31,61,0,0,0,0,0,0,0,0,0,0,0,2,100
transformers_4.23.0,src/transformers/models/speech_to_text_2/__init__.py,69,25,42,1,2,2,2,3,4,2,0.5,3.16992500144231,0.176106944524573,6.33985000288463,8,90.8162406167882
transformers_4.23.0,src/transformers/models/speech_to_text_2/processing_speech_to_text_2.py,113,54,51,5,9,9,18,14,27,40.1389654874176,5,513.992914477776,28.555161915432,102.798582895555,15,72.5661259055867
transformers_4.23.0,src/transformers/models/glpn/__init__.py,78,37,48,1,4,4,4,5,8,8,0.5,9.28771237954945,0.51598402108608,18.5754247590989,14,82.6117773080451
transformers_4.23.0,src/transformers/models/glpn/feature_extraction_glpn.py,139,45,51,7,23,14,26,30,40,123.693409443715,3.95652173913043,776.568772522392,43.1427095845773,196.275623824341,20,69.3168300757675
transformers_4.23.0,src/transformers/models/glpn/configuration_glpn.py,137,29,51,0,0,0,0,0,0,0,0,0,0,0,2,100
transformers_4.23.0,src/transformers/models/glpn/modeling_glpn.py,782,362,500,13,97,79,143,110,222,688.297262027986,9.58247422680412,14426.0494384134,801.447191022967,1505.46185640247,86,35.70700005388
transformers_4.23.0,src/transformers/models/glpn/convert_glpn_to_pytorch.py,219,126,151,6,46,36,72,52,108,269.593624982949,4.69565217391304,2890.86647271294,160.603692928497,615.647489559238,36,54.3758055078745
transformers_4.23.0,src/transformers/models/cpm/__init__.py,63,35,35,1,4,4,4,5,8,8,0.5,9.28771237954945,0.51598402108608,18.5754247590989,14,84.368768912279
transformers_4.23.0,src/transformers/models/cpm/tokenization_cpm.py,115,27,29,0,0,0,0,0,0,0,0,0,0,0,6,100
transformers_4.23.0,src/transformers/models/cpm/tokenization_cpm_fast.py,120,26,34,0,0,0,0,0,0,0,0,0,0,0,7,100
transformers_4.23.0,src/transformers/models/owlvit/__init__.py,102,38,74,1,4,4,4,5,8,8,0.5,9.28771237954945,0.51598402108608,18.5754247590989,14,78.7819572493297
transformers_4.23.0,src/transformers/models/owlvit/convert_owlvit_original_flax_to_hf.py,407,214,268,9,75,48,98,84,146,495.690726800172,5.88,5487.67666110711,304.870925617062,933.278343725699,43,44.5341219938714
transformers_4.23.0,src/transformers/models/owlvit/modeling_owlvit.py,1410,557,880,15,177,175,302,192,477,1380.36954129882,12.7966101694915,46298.4825457155,2572.13791920642,3618.02711284399,118,26.6904237345923
transformers_4.23.0,src/transformers/models/owlvit/configuration_owlvit.py,390,121,189,5,20,13,29,25,42,98.0482023721841,3.625,707.027104893202,39.2792836051779,195.041959970538,28,63.5632020963689
transformers_4.23.0,src/transformers/models/owlvit/processing_owlvit.py,161,67,61,10,32,24,47,42,71,193.219280948874,7.34375,2811.58800622074,156.19933367893,382.854537017292,36,60.2525243365158
transformers_4.23.0,src/transformers/models/owlvit/feature_extraction_owlvit.py,219,72,91,10,41,28,52,51,80,252.878913138215,6.34146341463415,2877.71822226847,159.87323457047,453.79402735772,29,62.9375574719876
transformers_4.23.0,src/transformers/models/m2m_100/__init__.py,64,24,36,1,2,2,2,3,4,2,0.5,3.16992500144231,0.176106944524573,6.33985000288463,8,91.9167547932775
transformers_4.23.0,src/transformers/models/m2m_100/configuration_m2m_100.py,283,94,166,7,17,10,18,24,28,89.138352755659,3.70588235294118,475.757285368948,26.4309602982749,128.378950020192,15,69.3603662307726
transformers_4.23.0,src/transformers/models/m2m_100/tokenization_m2m_100.py,387,166,218,11,66,41,79,77,120,436.983759682668,6.58333333333333,4950.76136714897,275.042298174943,752.014384883388,46,53.7955327611315
transformers_4.23.0,src/transformers/models/m2m_100/convert_m2m100_original_checkpoint_to_pytorch.py,85,32,57,2,4,2,4,6,6,10,1,15.5097750043269,0.861654166907052,15.5097750043269,4,83.312669325401
transformers_4.23.0,src/transformers/models/m2m_100/modeling_m2m_100.py,1387,520,915,17,179,196,350,196,546,1409.08989243156,16.6201117318436,69100.3013144611,3838.90562858117,4157.6315748869,168,18.3736890987157
transformers_4.23.0,src/transformers/models/unispeech/modeling_unispeech.py,1593,723,1068,19,194,238,404,213,642,1555.09371413973,19.7835051546392,98238.6266257628,5457.70147920905,4965.68357618499,181,11.7929183150074
transformers_4.23.0,src/transformers/models/unispeech/configuration_unispeech.py,300,63,124,2,7,4,9,9,13,21.6514844544032,1.28571428571429,52.9830321669644,2.94350178705358,41.2090250187501,6,70.2587347101892
transformers_4.23.0,src/transformers/models/unispeech/convert_unispeech_original_pytorch_checkpoint_to_pytorch.py,274,143,215,9,60,52,97,69,149,382.942760749492,7.275,6621.48779803612,367.860433224229,910.170144059947,45,44.5450275219546
transformers_4.23.0,src/transformers/models/unispeech/__init__.py,67,23,42,1,2,2,2,3,4,2,0.5,3.16992500144231,0.176106944524573,6.33985000288463,8,91.6061716488424
transformers_4.23.0,src/transformers/models/ctrl/configuration_ctrl.py,129,31,52,0,0,0,0,0,0,0,0,0,0,0,2,100
transformers_4.23.0,src/transformers/models/ctrl/modeling_tf_ctrl.py,865,362,647,11,96,108,177,107,285,670.210147874241,10.140625,19483.3662678076,1082.40923710042,1921.31809112433,92,26.5532768664098
transformers_4.23.0,src/transformers/models/ctrl/__init__.py,93,38,64,1,4,4,4,5,8,8,0.5,9.28771237954945,0.51598402108608,18.5754247590989,14,79.9281659859904
transformers_4.23.0,src/transformers/models/ctrl/modeling_ctrl.py,823,327,512,15,110,124,211,125,335,804.55292742184,14.3863636363636,33571.1224200913,1865.06235667174,2333.5377353618,86,36.5668748110327
transformers_4.23.0,src/transformers/models/ctrl/tokenization_ctrl.py,260,128,181,10,38,29,53,48,82,232.64052645973,6.97368421052632,3193.71671422818,177.42870634601,457.966925059135,31,54.5682196376813
transformers_4.23.0,src/transformers/models/speech_to_text/configuration_speech_to_text.py,194,42,88,1,2,1,2,3,3,2,0.5,2.37744375108173,0.13208020839343,4.75488750216347,3,84.7519626372366
transformers_4.23.0,src/transformers/models/speech_to_text/modeling_speech_to_text.py,1420,532,908,17,184,194,348,201,542,1453.82226821575,16.0760869565217,66665.4429845595,3703.63572136441,4146.87001661898,171,18.8778843056607
transformers_4.23.0,src/transformers/models/speech_to_text/feature_extraction_speech_to_text.py,258,75,126,10,27,18,32,37,50,161.601243507287,5.92592592592593,1543.54173796413,85.7523187757852,260.472668281447,31,66.6138752612344
transformers_4.23.0,src/transformers/models/speech_to_text/__init__.py,131,69,97,1,8,8,8,9,16,24,0.5,25.3594000115385,1.40885555619658,50.718800023077,28,65.9851461328265
transformers_4.23.0,src/transformers/models/speech_to_text/convert_s2t_fairseq_to_tfms.py,123,46,89,6,12,7,13,18,20,58.5293250129808,3.25,271.04512509375,15.0580625052084,83.3985000288462,10,70.3464041166548
transformers_4.23.0,src/transformers/models/speech_to_text/processing_speech_to_text.py,114,54,51,5,9,9,18,14,27,40.1389654874176,5,513.992914477776,28.555161915432,102.798582895555,15,72.3012788928104
transformers_4.23.0,src/transformers/models/speech_to_text/tokenization_speech_to_text.py,290,126,161,8,46,29,56,54,85,278.083849978623,4.8695652173913,2382.02300089549,132.33461116086,489.165437683895,33,59.420560967057
transformers_4.23.0,src/transformers/models/speech_to_text/modeling_tf_speech_to_text.py,1501,523,1020,16,162,174,304,178,478,1253.05570046731,15.0123456790123,53645.1247565723,2980.28470869846,3573.40058000194,151,20.6373575018755
transformers_4.23.0,src/transformers/models/mobilebert/modeling_mobilebert.py,1627,742,1178,15,160,191,329,175,520,1230.11185411611,15.421875,59754.0561099504,3319.66978388613,3874.62977815281,198,7.79097915452248
transformers_4.23.0,src/transformers/models/mobilebert/tokenization_mobilebert_fast.py,54,19,19,0,0,0,0,0,0,0,0,0,0,0,1,100
transformers_4.23.0,src/transformers/models/mobilebert/tokenization_mobilebert.py,49,17,14,0,0,0,0,0,0,0,0,0,0,0,1,100
transformers_4.23.0,src/transformers/models/mobilebert/__init__.py,149,52,118,1,6,6,6,7,12,15.5097750043269,0.5,16.8441295323456,0.935784974019201,33.6882590646913,20,69.3891000509103
transformers_4.23.0,src/transformers/models/mobilebert/configuration_mobilebert.py,187,51,80,1,2,1,2,3,3,2,0.5,2.37744375108173,0.13208020839343,4.75488750216347,5,82.227326998986
transformers_4.23.0,src/transformers/models/mobilebert/convert_mobilebert_original_tf_checkpoint_to_pytorch.py,58,19,32,1,2,1,2,3,3,2,0.5,2.37744375108173,0.13208020839343,4.75488750216347,2,96.2811944471052
transformers_4.23.0,src/transformers/models/mobilebert/modeling_tf_mobilebert.py,1746,694,1284,14,130,145,255,144,400,966.210784602506,13.7307692307692,39379.4342386909,2187.74634659394,2867.97000057692,181,10.3793726848179
transformers_4.23.0,src/transformers/models/decision_transformer/__init__.py,70,23,42,1,2,2,2,3,4,2,0.5,3.16992500144231,0.176106944524573,6.33985000288463,8,91.9155709627847
transformers_4.23.0,src/transformers/models/decision_transformer/modeling_decision_transformer.py,952,486,630,17,168,162,285,185,447,1311.39619532809,14.4196428571429,48544.1244040538,2696.89580022521,3366.52751285079,129,25.3402536594033
transformers_4.23.0,src/transformers/models/decision_transformer/configuration_decision_transformer.py,176,42,78,0,0,0,0,0,0,0,0,0,0,0,2,100
transformers_4.23.0,src/transformers/models/convnext/configuration_convnext.py,126,35,53,1,3,2,4,4,6,4.75488750216347,0.666666666666667,8,0.444444444444444,12,6,83.3183841323111
transformers_4.23.0,src/transformers/models/convnext/convert_convnext_to_pytorch.py,243,171,180,7,96,89,154,103,243,651.807884523634,5.61458333333333,9122.68520363413,506.81584464634,1624.81962810552,57,43.5584890285265
transformers_4.23.0,src/transformers/models/convnext/modeling_convnext.py,467,222,313,14,83,67,124,97,191,582.431241710601,10.4578313253012,13182.9680756689,732.38711531494,1260.58335285774,66,43.0570497973338
transformers_4.23.0,src/transformers/models/convnext/__init__.py,103,51,72,1,6,6,6,7,12,15.5097750043269,0.5,16.8441295323456,0.935784974019201,33.6882590646913,20,74.0776854364209
transformers_4.23.0,src/transformers/models/convnext/feature_extraction_convnext.py,167,48,71,8,24,15,29,32,44,134.039100017308,4.83333333333333,1063.33333333333,59.0740740740741,220,24,70.1246365759281
transformers_4.23.0,src/transformers/models/convnext/modeling_tf_convnext.py,614,203,401,11,53,43,82,64,125,341.63353189686,8.50943396226415,6382.07547169811,354.559748427673,750,65,46.783488976698
transformers_4.23.0,src/transformers/models/mmbt/__init__.py,49,23,22,1,2,2,2,3,4,2,0.5,3.16992500144231,0.176106944524573,6.33985000288463,8,92.2814655295801
transformers_4.23.0,src/transformers/models/mmbt/modeling_mmbt.py,408,128,289,7,29,36,63,36,99,160.532933313103,7.60344827586207,3891.61647651672,216.20091536204,511.822575142789,30,53.2238155039058
transformers_4.23.0,src/transformers/models/mmbt/configuration_mmbt.py,42,10,8,0,0,0,0,0,0,0,0,0,0,0,3,100
transformers_4.23.0,src/transformers/models/unispeech_sat/convert_unispeech_sat_original_pytorch_checkpoint_to_pytorch.py,225,119,175,10,58,52,97,68,149,372.982178666273,8.36206896551724,7584.66383143027,421.370212857237,907.031963346301,41,46.9484587167599
transformers_4.23.0,src/transformers/models/unispeech_sat/__init__.py,73,23,48,1,2,2,2,3,4,2,0.5,3.16992500144231,0.176106944524573,6.33985000288463,8,90.8165051883758
transformers_4.23.0,src/transformers/models/unispeech_sat/modeling_unispeech_sat.py,1917,881,1293,19,207,266,453,226,719,1673.26242295779,20.7898550724638,116895.298446657,6494.18324703649,5622.70867397652,218,4.53922292175293
transformers_4.23.0,src/transformers/models/unispeech_sat/configuration_unispeech_sat.py,318,66,130,2,7,4,9,9,13,21.6514844544032,1.28571428571429,52.9830321669644,2.94350178705358,41.2090250187501,6,69.3144879754363
transformers_4.23.0,src/transformers/models/unispeech_sat/convert_unispeech_original_s3prl_checkpoint_to_pytorch.py,110,59,70,1,2,1,2,3,3,2,0.5,2.37744375108173,0.13208020839343,4.75488750216347,7,80.6205714250733
transformers_4.23.0,src/transformers/models/mctct/feature_extraction_mctct.py,364,147,205,17,88,62,117,105,179,637.916850741338,11.3011363636364,13582.2701471602,754.57056373112,1201.84994766224,45,54.0656615661383
transformers_4.23.0,src/transformers/models/mctct/__init__.py,75,38,45,1,4,4,4,5,8,8,0.5,9.28771237954945,0.51598402108608,18.5754247590989,14,82.3824487234529
transformers_4.23.0,src/transformers/models/mctct/processing_mctct.py,140,75,70,5,14,14,28,19,42,64.9126093832433,5,892.064777823153,49.5591543235085,178.412955564631,22,68.9397689133428
transformers_4.23.0,src/transformers/models/mctct/modeling_mctct.py,823,393,566,17,119,112,203,136,315,889.970182134901,14.5,32371.9865274109,1798.44369596727,2232.55079499386,103,27.9632321758834
transformers_4.23.0,src/transformers/models/mctct/configuration_mctct.py,185,39,73,1,2,1,2,3,3,2,0.5,2.37744375108173,0.13208020839343,4.75488750216347,3,80.6659788211909
transformers_4.23.0,src/transformers/models/resnet/modeling_tf_resnet.py,501,215,357,11,41,36,69,52,105,257.713379994352,9.25609756097561,5540.2017480153,307.78898600085,598.546170404815,60,43.697420982616
transformers_4.23.0,src/transformers/models/resnet/modeling_resnet.py,418,197,297,12,49,43,80,61,123,318.140332370299,9.79591836734694,7145.93331448394,396.996295249108,729.480692520235,60,43.8023775535024
transformers_4.23.0,src/transformers/models/resnet/__init__.py,88,37,58,1,4,4,4,5,8,8,0.5,9.28771237954945,0.51598402108608,18.5754247590989,14,81.3647930898523
transformers_4.23.0,src/transformers/models/resnet/configuration_resnet.py,114,34,46,1,2,1,2,3,3,2,0.5,2.37744375108173,0.13208020839343,4.75488750216347,5,85.8304231258495
transformers_4.23.0,src/transformers/models/resnet/convert_resnet_to_pytorch.py,200,112,144,6,19,10,21,25,31,96.2203977597551,3.31578947368421,477.339533612107,26.5188629784504,143.959541883016,19,58.4279040268427
transformers_4.23.0,src/transformers/models/marian/configuration_marian.py,398,154,266,9,33,19,35,42,54,194.99433095181,4.77272727272727,1389.74726305253,77.2081812806959,291.185140830053,33,58.2271147812018
transformers_4.23.0,src/transformers/models/marian/__init__.py,117,65,86,1,8,8,8,9,16,24,0.5,25.3594000115385,1.40885555619658,50.718800023077,26,67.8067680912418
transformers_4.23.0,src/transformers/models/marian/tokenization_marian.py,399,176,223,7,41,27,51,48,78,239.311116643745,4.35365853658537,1896.57153408636,105.36508522702,435.62707505625,57,53.815283310203
transformers_4.23.0,src/transformers/models/marian/modeling_flax_marian.py,1501,603,1128,16,146,145,261,162,406,1113.71438559648,14.3013698630137,42617.7833098998,2367.65462832777,2979.97910117116,141,15.5007350799419
transformers_4.23.0,src/transformers/models/marian/modeling_tf_marian.py,1509,521,1041,16,149,162,289,165,451,1139.65610954886,15.5167785234899,51550.0172393334,2863.88984662964,3322.21131862486,153,20.2812984342742
transformers_4.23.0,src/transformers/models/marian/modeling_marian.py,1737,659,1102,18,185,205,370,203,575,1468.36422022148,18,79336.2267428666,4407.56815238148,4407.56815238148,223,9.73847808933663
transformers_4.23.0,src/transformers/models/marian/convert_marian_to_pytorch.py,708,411,543,13,134,90,160,147,250,994.961667857176,7.76119402985075,13969.5135049064,776.08408360591,1799.91808620909,91,25.4391470338939
transformers_4.23.0,src/transformers/models/marian/convert_marian_tatoeba_to_pytorch.py,1324,228,1238,11,115,81,150,126,231,825.285103663614,7.17391304347826,11562.5662732261,642.364792957003,1611.75166232848,71,27.1973364267182
transformers_4.23.0,src/transformers/models/xlm_roberta/tokenization_xlm_roberta_fast.py,239,54,119,5,35,24,45,40,69,191.134546067511,3.21428571428571,1180.3276239018,65.5737568834336,367.213038547228,14,71.4402494925059
transformers_4.23.0,src/transformers/models/xlm_roberta/modeling_tf_xlm_roberta.py,181,35,100,0,0,0,0,0,0,0,0,0,0,0,1,100
transformers_4.23.0,src/transformers/models/xlm_roberta/__init__.py,178,79,144,1,10,10,10,11,20,33.2192809488736,0.5,34.594316186373,1.9219064547985,69.188632372746,32,60.0450089597118
transformers_4.23.0,src/transformers/models/xlm_roberta/configuration_xlm_roberta.py,68,22,37,1,2,1,2,3,3,2,0.5,2.37744375108173,0.13208020839343,4.75488750216347,3,94.8099617382993
transformers_4.23.0,src/transformers/models/xlm_roberta/tokenization_xlm_roberta.py,328,103,145,8,72,43,83,80,126,468.234600103846,4.61111111111111,3673.04022312956,204.057790173864,796.562939955808,31,59.7529536621182
transformers_4.23.0,src/transformers/models/xlm_roberta/modeling_flax_xlm_roberta.py,151,31,84,0,0,0,0,0,0,0,0,0,0,0,1,100
transformers_4.23.0,src/transformers/models/xlm_roberta/modeling_xlm_roberta.py,161,35,87,0,0,0,0,0,0,0,0,0,0,0,1,100
transformers_4.23.0,src/transformers/models/detr/modeling_detr.py,2338,1009,1289,21,320,301,542,341,843,2755.25565624231,17.784375,126139.029270802,7007.72384837787,7092.68834416738,245,3.64543663428921
transformers_4.23.0,src/transformers/models/detr/configuration_detr.py,237,69,112,0,0,0,0,0,0,0,0,0,0,0,7,100
transformers_4.23.0,src/transformers/models/detr/__init__.py,77,37,48,1,4,4,4,5,8,8,0.5,9.28771237954945,0.51598402108608,18.5754247590989,14,82.2365154235863
transformers_4.23.0,src/transformers/models/detr/convert_detr_original_pytorch_checkpoint_to_pytorch.py,278,177,206,7,30,26,43,37,69,166.858202322659,5.01666666666667,1803.25228251246,100.180682361803,359.452282228398,33,51.970656651581
transformers_4.23.0,src/transformers/models/detr/feature_extraction_detr.py,1368,692,754,22,290,251,438,312,689,2470.28113171435,16.6137931034483,94842.1992294468,5269.0110683026,5708.64212879609,195,14.672567755731
transformers_4.23.0,src/transformers/models/vit_mae/modeling_vit_mae.py,1028,468,595,15,143,113,205,158,318,1082.46496009344,10.7517482517483,24972.0349811363,1387.33527672979,2322.60227792032,98,33.432441738827
transformers_4.23.0,src/transformers/models/vit_mae/convert_vit_mae_to_pytorch.py,178,133,132,6,66,71,111,72,182,414.439786881985,5.04545454545455,5665.67385814262,314.759658785701,1122.9263502625,36,47.2634584527661
transformers_4.23.0,src/transformers/models/vit_mae/__init__.py,86,37,58,1,4,4,4,5,8,8,0.5,9.28771237954945,0.51598402108608,18.5754247590989,14,80.9249967887991
transformers_4.23.0,src/transformers/models/vit_mae/configuration_vit_mae.py,142,30,53,0,0,0,0,0,0,0,0,0,0,0,2,100
transformers_4.23.0,src/transformers/models/vit_mae/modeling_tf_vit_mae.py,1184,452,731,13,116,92,169,129,261,843.631511770633,9.4698275862069,17329.1245651855,962.729142510306,1829.93031366547,88,34.9220278863772
transformers_4.23.0,src/transformers/models/beit/modeling_flax_beit.py,952,446,708,15,137,110,203,152,313,1031.03375429972,11.1131386861314,25211.2810005488,1400.62672225271,2268.60131170784,90,25.0667084513147
transformers_4.23.0,src/transformers/models/beit/configuration_beit.py,203,52,89,0,0,0,0,0,0,0,0,0,0,0,4,100
transformers_4.23.0,src/transformers/models/beit/__init__.py,112,51,80,1,6,6,6,7,12,15.5097750043269,0.5,16.8441295323456,0.935784974019201,33.6882590646913,20,72.7463367205987
transformers_4.23.0,src/transformers/models/beit/convert_beit_unilm_to_pytorch.py,370,222,286,6,78,93,109,84,202,505.771148075582,4.19230769230769,5413.30942364395,300.739412424664,1291.24811940131,51,41.4068310533378
transformers_4.23.0,src/transformers/models/beit/modeling_beit.py,1290,611,855,16,194,180,329,210,509,1538.3830913843,13.5670103092784,53271.5574694386,2959.53097052437,3926.55096849206,159,17.8408148326498
transformers_4.23.0,src/transformers/models/beit/feature_extraction_beit.py,268,95,134,7,42,31,60,49,91,246.128816211111,5,2554.69297907242,141.927387726246,510.938595814484,51,59.9625203203428
transformers_4.23.0,src/transformers/models/transfo_xl/modeling_transfo_xl.py,1298,708,898,20,252,241,442,272,683,2096.71310261973,17.5396825396825,96884.5955275278,5382.4775293071,5523.73712057398,208,7.85851182438833
transformers_4.23.0,src/transformers/models/transfo_xl/tokenization_transfo_xl.py,805,473,519,19,150,114,225,169,339,1165.03342632981,14.25,35751.7983368202,1986.21101871223,2508.89812889966,151,23.6327177373399
transformers_4.23.0,src/transformers/models/transfo_xl/modeling_transfo_xl_utilities.py,248,167,151,15,59,63,113,74,176,405.679298846476,14.364406779661,15698.3400680884,872.130003782688,1092.8637923507,35,52.7007862679462
transformers_4.23.0,src/transformers/models/transfo_xl/__init__.py,101,38,72,1,4,4,4,5,8,8,0.5,9.28771237954945,0.51598402108608,18.5754247590989,14,79.0015874808669
transformers_4.23.0,src/transformers/models/transfo_xl/modeling_tf_transfo_xl.py,1174,512,837,18,138,133,236,156,369,1056.03502506135,15.3913043478261,41376.6500104826,2298.70277836015,2688.31341876017,119,23.5268913554541
transformers_4.23.0,src/transformers/models/transfo_xl/modeling_tf_transfo_xl_utilities.py,178,111,136,12,43,38,73,55,111,276.348934460844,10.1860465116279,6536.70108260795,363.150060144886,641.730928201237,24,54.1419115615541
transformers_4.23.0,src/transformers/models/transfo_xl/convert_transfo_xl_original_tf_checkpoint_to_pytorch.py,121,54,84,2,10,6,12,12,18,35.2192809488736,1.2,77.435190015577,4.30195500086539,64.5293250129808,5,74.0228423597346
transformers_4.23.0,src/transformers/models/transfo_xl/configuration_transfo_xl.py,188,50,84,3,9,5,9,12,14,33.2842125151443,1.5,75.2842125151443,4.18245625084135,50.1894750100962,5,75.6485691060952
transformers_4.23.0,src/transformers/models/mt5/modeling_mt5.py,116,25,36,0,0,0,0,0,0,0,0,0,0,0,1,100
transformers_4.23.0,src/transformers/models/mt5/modeling_tf_mt5.py,95,19,15,0,0,0,0,0,0,0,0,0,0,0,1,100
transformers_4.23.0,src/transformers/models/mt5/__init__.py,109,62,74,1,6,6,6,7,12,15.5097750043269,0.5,16.8441295323456,0.935784974019201,33.6882590646913,22,71.2578093828785
transformers_4.23.0,src/transformers/models/mt5/modeling_flax_mt5.py,119,29,22,2,4,3,4,6,7,10,1,18.0947375050481,1.00526319472489,18.0947375050481,1,48.7267313762144
transformers_4.23.0,src/transformers/models/mt5/configuration_mt5.py,178,67,100,7,15,9,17,22,26,78.254843388531,3.96666666666667,459.916047602127,25.5508915334515,115.94522208457,15,72.9335976710853
transformers_4.23.0,src/transformers/sagemaker/training_args_sm.py,136,75,84,6,16,11,18,22,29,79.5097750043269,3.375,436.466869674126,24.2481594263403,129.323516940482,22,68.9907778486426
transformers_4.23.0,src/transformers/sagemaker/__init__.py,20,2,2,0,0,0,0,0,0,0,0,0,0,0,1,100
transformers_4.23.0,src/transformers/sagemaker/trainer_sm.py,30,8,12,0,0,0,0,0,0,0,0,0,0,0,2,100
transformers_4.23.0,src/transformers/utils/dummy_detectron2_objects.py,14,8,8,0,0,0,0,0,0,0,0,0,0,0,3,100
transformers_4.23.0,src/transformers/utils/logging.py,348,173,157,6,16,9,17,22,26,79.5097750043269,3.1875,369.575395394566,20.5319664108092,115.94522208457,25,62.4798043610327
transformers_4.23.0,src/transformers/utils/hp_naming.py,162,110,113,9,40,22,44,49,66,241.406448808475,4.95,1834.32570607244,101.906983670691,370.570849711604,34,53.9592253299035
transformers_4.23.0,src/transformers/utils/hub.py,1126,490,695,17,181,137,249,198,386,1426.95897386332,11.6933701657459,34436.1759588388,1913.12088660215,2944.93165535073,154,24.619335687082
transformers_4.23.0,src/transformers/utils/sentencepiece_model_pb2.py,1512,50,1468,1,1,1,1,2,2,0,0.5,1,0.0555555555555556,2,1,68.352905440374
transformers_4.23.0,src/transformers/utils/dummy_sentencepiece_and_tokenizers_objects.py,10,4,4,0,0,0,0,0,0,0,0,0,0,0,1,100
transformers_4.23.0,src/transformers/utils/fx.py,1160,660,852,16,315,224,418,331,642,2678.25052579199,10.615873015873,57049.5032315215,3169.41684619564,5373.98131517023,198,6.05317196280431
transformers_4.23.0,src/transformers/utils/dummy_timm_and_vision_objects.py,89,48,48,0,0,0,0,0,0,0,0,0,0,0,12,100
transformers_4.23.0,src/transformers/utils/dummy_tokenizers_objects.py,395,225,225,0,0,0,0,0,0,0,0,0,0,0,57,100
transformers_4.23.0,src/transformers/utils/constants.py,4,4,4,0,0,0,0,0,0,0,0,0,0,0,1,100
transformers_4.23.0,src/transformers/utils/generic.py,337,204,193,8,56,35,65,64,100,349.211875635226,4.64285714285714,2785.71428571429,154.761904761905,600,77,47.6183297355147
transformers_4.23.0,src/transformers/utils/__init__.py,193,32,165,4,9,5,10,13,15,36.5293250129808,2.22222222222222,123.347990604703,6.85266614470573,55.5065957721164,3,73.8604042613442
transformers_4.23.0,src/transformers/utils/versions.py,123,54,69,7,16,11,19,23,30,83.6514844544032,4.15625,564.031631395859,31.3350906331033,135.70685868171,17,73.9530747435117
transformers_4.23.0,src/transformers/utils/dummy_sentencepiece_objects.py,192,109,109,0,0,0,0,0,0,0,0,0,0,0,28,100
transformers_4.23.0,src/transformers/utils/dummy_vision_objects.py,199,113,113,0,0,0,0,0,0,0,0,0,0,0,29,100
transformers_4.23.0,src/transformers/utils/doc.py,1158,180,853,12,90,69,136,102,205,627.286328678325,9.06666666666667,12401.8145689444,688.989698274686,1367.84719510416,15,38.5814648629267
transformers_4.23.0,src/transformers/utils/notebook.py,359,213,222,18,109,77,152,127,229,812.790741426647,12.5504587155963,20085.8644880228,1115.88136044571,1600.40879327083,73,45.2198696246973
transformers_4.23.0,src/transformers/utils/dummy_tensorflow_text_objects.py,10,5,5,0,0,0,0,0,0,0,0,0,0,0,2,100
transformers_4.23.0,src/transformers/utils/bitsandbytes.py,163,77,83,12,40,28,52,52,80,255.896673804148,7.8,3557.07438412004,197.615243562225,456.035177451287,27,65.6903448639122
transformers_4.23.0,src/transformers/utils/dummy_speech_objects.py,17,9,9,0,0,0,0,0,0,0,0,0,0,0,3,100
transformers_4.23.0,src/transformers/utils/dummy_flax_objects.py,1131,637,637,0,0,0,0,0,0,0,0,0,0,0,157,100
transformers_4.23.0,src/transformers/utils/dummy_sentencepiece_and_speech_objects.py,10,5,5,0,0,0,0,0,0,0,0,0,0,0,2,100
transformers_4.23.0,src/transformers/utils/import_utils.py,1075,533,715,11,194,122,234,205,356,1512.43683918931,6.6340206185567,18136.7152378897,1007.59529099387,2733.89491542394,111,21.3981643318535
transformers_4.23.0,src/transformers/utils/dummy_pt_objects.py,5969,3297,3297,0,0,0,0,0,0,0,0,0,0,0,773,100
transformers_4.23.0,src/transformers/utils/dummy_scatter_objects.py,45,24,24,0,0,0,0,0,0,0,0,0,0,0,6,100
transformers_4.23.0,src/transformers/utils/dummy_tf_objects.py,2637,1461,1461,0,0,0,0,0,0,0,0,0,0,0,349,100
transformers_4.23.0,src/transformers/utils/model_parallel_utils.py,58,23,32,6,22,13,26,28,39,113.617270614347,3.54545454545455,664.726076040874,36.9292264467152,187.486841960247,14,81.5737439400401
transformers_4.23.0,src/transformers/pipelines/zero_shot_image_classification.py,131,60,69,4,12,7,13,16,20,51.0195500086539,2.16666666666667,173.333333333333,9.62962962962963,80,19,74.2929613578039
transformers_4.23.0,src/transformers/pipelines/text2text_generation.py,345,138,161,10,46,36,73,56,109,287.303130927496,7.93478260869565,5022.73077334917,279.040598519398,633.001686504279,55,54.8068899267622
transformers_4.23.0,src/transformers/pipelines/audio_utils.py,216,114,152,13,46,32,64,59,96,302.189566314457,9.04347826086956,5107.15723520249,283.730957511249,564.733732738737,26,58.4516410527427
transformers_4.23.0,src/transformers/pipelines/text_classification.py,206,97,119,12,50,35,68,62,103,325.21235949739,8.16,5004.38291495396,278.021273052998,613.282219969848,41,59.7074262994068
transformers_4.23.0,src/transformers/pipelines/zero_shot_classification.py,237,108,147,11,44,29,52,55,81,278.268739025051,6.5,3043.88588917073,169.104771620596,468.290136795497,42,59.0965881460515
transformers_4.23.0,src/transformers/pipelines/fill_mask.py,230,125,148,7,36,29,54,43,83,205.768784506326,5.25,2364.49486686144,131.360825936747,450.379974640274,39,56.5412991994448
transformers_4.23.0,src/transformers/pipelines/token_classification.py,468,241,335,14,87,61,113,101,174,613.839053047646,9.09195402298851,10533.2905657133,585.182809206297,1158.52879799881,83,38.922621302469
transformers_4.23.0,src/transformers/pipelines/feature_extraction.py,79,29,26,3,7,4,8,10,12,24.4063719565667,1.71428571428571,68.3368065233972,3.79648925129984,39.8631371386484,10,72.1492497236698
transformers_4.23.0,src/transformers/pipelines/__init__.py,856,228,590,11,81,69,139,92,208,551.581598038665,9.43827160493827,12806.799111165,711.488839509165,1356.90088685986,121,37.3090733795317
transformers_4.23.0,src/transformers/pipelines/base.py,1186,607,722,14,207,145,277,221,422,1645.85476911117,9.36714975845411,30785.0897219445,1710.28276233025,3286.49488006318,229,11.9031228320371
transformers_4.23.0,src/transformers/pipelines/document_question_answering.py,442,211,279,11,84,65,127,95,192,575.008411318426,8.31547619047619,10489.243754101,582.73576411672,1261.41227679954,80,44.8142406200356
transformers_4.23.0,src/transformers/pipelines/text_generation.py,274,140,176,13,64,51,98,77,149,432.105716335834,9.953125,9293.74235839024,516.319019910569,933.75119456354,46,53.5551797754413
transformers_4.23.0,src/transformers/pipelines/image_classification.py,115,51,59,4,10,7,12,14,19,41.2192809488736,2.4,173.615384445827,9.64529913587926,72.3397435190945,16,76.6924246220258
transformers_4.23.0,src/transformers/pipelines/conversational.py,306,146,158,11,44,31,57,55,88,278.268739025051,7.125,3624.91254037996,201.384030021109,508.75965479017,50,56.3098024345133
transformers_4.23.0,src/transformers/pipelines/object_detection.py,135,62,65,4,8,4,8,12,12,32,2,86.0391000173078,4.77995000096154,43.0195500086539,16,76.5375282805419
transformers_4.23.0,src/transformers/pipelines/table_question_answering.py,419,237,255,12,101,70,141,113,211,715.498909766585,8.37623762376238,12053.8897610385,669.660542279915,1439.0577610696,84,42.6670604547422
transformers_4.23.0,src/transformers/pipelines/image_to_text.py,95,38,49,1,2,1,2,3,3,2,0.5,2.37744375108173,0.13208020839343,4.75488750216347,12,88.2105117505666
transformers_4.23.0,src/transformers/pipelines/zero_shot_object_detection.py,278,138,146,12,54,36,69,66,105,353.783475125481,7.66666666666667,4865.73726608356,270.318737004642,634.661382532638,61,54.6484186289541
transformers_4.23.0,src/transformers/pipelines/question_answering.py,647,295,403,18,134,101,190,152,291,1021.9146015473,12.7611940298507,26915.232910184,1495.29071723245,2109.14690641208,111,35.9722546770182
transformers_4.23.0,src/transformers/pipelines/image_segmentation.py,180,91,106,5,31,20,40,36,60,165.18972609643,3.2258064516129,1000.63064544045,55.5905914133582,310.195500086539,24,64.0920623212926
transformers_4.23.0,src/transformers/pipelines/audio_classification.py,158,66,82,6,11,7,12,17,19,53.5635228093372,3.27272727272727,254.165871219567,14.1203261788648,77.6617939837565,18,73.8867986684282
transformers_4.23.0,src/transformers/pipelines/automatic_speech_recognition.py,417,220,234,17,111,79,156,128,235,823.667029466118,11.9459459459459,19651.0810810811,1091.72672672673,1645,68,46.4078010410627
transformers_4.23.0,src/transformers/pipelines/pt_utils.py,292,142,137,8,19,20,37,27,57,104.710622755428,7.78947368421053,2111.17005096058,117.287225053366,271.028587623318,47,57.3768067117872
transformers_4.23.0,src/transformers/pipelines/visual_question_answering.py,115,55,52,4,10,6,12,14,18,41.2192809488736,2.4,164.477732632889,9.13765181293825,68.5323885970369,17,75.2499291410661
transformers_4.23.0,src/transformers/benchmark/benchmark_utils.py,914,483,564,17,150,109,210,167,319,1153.80967187564,11.9,28029.2798646607,1557.18221470338,2355.40166929922,95,32.0295031354697
transformers_4.23.0,src/transformers/benchmark/benchmark_args_tf.py,137,80,96,4,7,4,7,11,11,27.6514844544032,2,76.1074956100206,4.2281942005567,38.0537478050103,18,69.4752039833814
transformers_4.23.0,src/transformers/benchmark/__init__.py,0,0,0,0,0,0,0,0,0,0,0,0,0,0,1,100
transformers_4.23.0,src/transformers/benchmark/benchmark.py,272,153,195,5,24,14,25,29,39,121.648740491745,2.60416666666667,493.388694817644,27.4104830454247,189.461258809975,45,51.5764306186052
transformers_4.23.0,src/transformers/benchmark/benchmark_args.py,115,62,76,4,8,5,8,12,13,32,2,93.2090250187501,5.17827916770834,46.604512509375,16,72.6160145419933
transformers_4.23.0,src/transformers/benchmark/benchmark_tf.py,299,173,223,10,44,23,45,54,68,273.434272168915,5.11363636363636,2001.13133597957,111.173963109976,391.332350147116,49,46.8442538777837
transformers_4.23.0,src/transformers/benchmark/benchmark_args_utils.py,165,80,125,2,3,2,3,5,5,6.75488750216347,1,11.6096404744368,0.644980026357601,11.6096404744368,8,72.653878976738
transformers_4.23.0,src/transformers/commands/download.py,46,20,24,0,0,0,0,0,0,0,0,0,0,0,4,100
transformers_4.23.0,src/transformers/commands/add_new_model_like.py,1570,760,1012,17,389,280,548,406,828,3416.29751650088,11.974293059126,85914.3329909044,4773.01849949469,7174.89813942933,239,5.00439097357108
transformers_4.23.0,src/transformers/commands/user.py,197,114,147,6,15,11,21,21,32,74.1131339384547,4.2,590.327461621465,32.7959700900814,140.55415752892,26,57.6023827310763
transformers_4.23.0,src/transformers/commands/__init__.py,27,10,10,0,0,0,0,0,0,0,0,0,0,0,3,100
transformers_4.23.0,src/transformers/commands/train.py,158,68,108,3,10,7,12,13,19,37.9741684510371,1.8,126.555038360425,7.03083546446807,70.3083546446807,14,69.4410055181739
transformers_4.23.0,src/transformers/commands/transformers_cli.py,59,32,32,2,3,2,3,5,5,6.75488750216347,1,11.6096404744368,0.644980026357601,11.6096404744368,3,88.4935589625809
transformers_4.23.0,src/transformers/commands/env.py,92,49,60,1,2,1,2,3,3,2,0.5,2.37744375108173,0.13208020839343,4.75488750216347,9,82.3359275917977
transformers_4.23.0,src/transformers/commands/add_new_model.py,259,140,194,10,58,45,80,68,125,372.982178666273,6.89655172413793,5247.81279418133,291.545155232296,760.932855156293,20,49.1061722853714
transformers_4.23.0,src/transformers/commands/run.py,110,48,80,4,6,4,6,10,10,23.5097750043269,2,66.4385618977473,3.69103121654151,33.2192809488736,14,73.6436061411411
transformers_4.23.0,src/transformers/commands/pt_to_tf.py,378,193,294,14,88,62,121,102,183,621.732951348889,9.625,11752.643186715,652.924621484169,1221.05383758078,64,41.640754123389
transformers_4.23.0,src/transformers/commands/serving.py,229,98,140,3,4,3,4,7,7,12.7548875021635,1.5,29.4772266816048,1.6376237045336,19.6514844544032,16,72.8724864174978
transformers_4.23.0,src/transformers/commands/lfs.py,226,111,135,11,30,20,38,41,58,185.260465673266,6.96666666666667,2164.80817999935,120.267121111075,310.738016267849,22,61.5640406715388
transformers_4.23.0,src/transformers/commands/convert.py,184,89,138,2,14,12,24,16,36,55.3029689088065,1.71428571428571,246.857142857143,13.7142857142857,144,23,60.7937750292934
transformers_4.23.0,src/transformers/data/test_generation_utils.py,100,40,69,2,3,2,3,5,5,6.75488750216347,1,11.6096404744368,0.644980026357601,11.6096404744368,9,80.955852417045
transformers_4.23.0,src/transformers/data/__init__.py,48,3,30,0,0,0,0,0,0,0,0,0,0,0,1,100
transformers_4.23.0,src/transformers/data/data_collator.py,1543,818,908,23,416,325,596,439,921,3723.42484773601,16.4759615384615,133201.707535611,7400.09486308952,8084.60903630207,286,0
transformers_4.23.0,src/transformers/data/processors/utils.py,349,199,216,12,63,46,90,75,136,419.588185189149,8.57142857142857,7261.0229306352,403.390162813067,847.11934190744,67,47.1771848627045
transformers_4.23.0,src/transformers/data/processors/__init__.py,22,4,4,0,0,0,0,0,0,0,0,0,0,0,1,100
transformers_4.23.0,src/transformers/data/processors/glue.py,643,388,422,5,23,33,61,28,94,115.651565463748,6.6304347826087,2996.23620903025,166.457567168347,451.891362673415,118,25.0757336362453
transformers_4.23.0,src/transformers/data/processors/squad.py,846,376,582,16,176,135,254,192,389,1376.85996488016,11.5454545454545,34065.4456748297,1892.52475971276,2950.55041278053,97,31.2272069075699
transformers_4.23.0,src/transformers/data/processors/xnli.py,97,61,59,4,15,11,16,19,27,66.6033589341278,2.13333333333333,244.68062477435,13.5933680430195,114.694042862977,18,71.2018574738518
transformers_4.23.0,src/transformers/data/datasets/__init__.py,27,3,9,0,0,0,0,0,0,0,0,0,0,0,1,100
transformers_4.23.0,src/transformers/data/datasets/glue.py,163,81,114,7,22,13,25,29,38,117.758980064424,3.97727272727273,734.217582218145,40.7898656787858,184.603277814848,16,64.7861738109864
transformers_4.23.0,src/transformers/data/datasets/language_modeling.py,532,286,346,15,122,95,173,137,268,904.1533141168,10.6352459016393,20231.1368541628,1123.95204745349,1902.27259823342,90,38.1298273469292
transformers_4.23.0,src/transformers/data/datasets/squad.py,230,117,175,10,26,16,31,36,47,155.430713620542,5.96153846153846,1448.57321675028,80.4762898194599,242.986475067789,20,56.439188295484
transformers_4.23.0,src/transformers/data/metrics/__init__.py,102,69,70,3,28,19,38,31,57,139.360825319776,2.03571428571429,574.863707587391,31.936872643744,282.389189692052,16,64.5138069170747
transformers_4.23.0,src/transformers/data/metrics/squad_metrics.py,776,471,529,18,165,132,243,183,375,1290.50181537652,13.2545454545455,37356.4444234709,2075.35802352616,2818.38743935652,128,23.7898803983716
transformers_4.23.0,src/transformers/onnx/utils.py,109,43,41,6,12,10,20,18,30,58.5293250129808,5,625.488750216347,34.7493750120193,125.097750043269,12,71.3861086078303
transformers_4.23.0,src/transformers/onnx/features.py,714,129,589,8,32,19,34,40,53,184,4.25,1198.76430337338,66.5980168540766,282.06218902903,39,51.9772575685541
transformers_4.23.0,src/transformers/onnx/__init__.py,50,12,28,0,0,0,0,0,0,0,0,0,0,0,2,100
transformers_4.23.0,src/transformers/onnx/__main__.py,180,65,135,5,15,12,23,20,35,70.2129994085646,3.83333333333333,579.858686064055,32.214371448003,151.267483321058,16,63.1105884501139
transformers_4.23.0,src/transformers/onnx/config.py,673,321,410,13,76,48,91,89,139,522.948207357547,7.78289473684211,7005.59327755146,389.199626530636,900.126946904329,96,39.886940900768
transformers_4.23.0,src/transformers/onnx/convert.py,484,194,308,10,64,43,80,74,123,417.219280948874,6.25,4773.51727482726,265.19540415707,763.762763972361,65,48.5202438654875
transformers_4.23.0,docs/source/_config.py,14,5,12,0,0,0,0,0,0,0,0,0,0,0,1,100
transformers_4.23.0,docs/source/it/_config.py,15,5,13,0,0,0,0,0,0,0,0,0,0,0,1,100
transformers_4.23.0,docs/source/en/_config.py,14,5,12,0,0,0,0,0,0,0,0,0,0,0,1,100
transformers_4.23.0,docs/source/de/_config.py,14,5,12,0,0,0,0,0,0,0,0,0,0,0,1,100
transformers_4.23.0,docs/source/pt/_config.py,14,5,12,0,0,0,0,0,0,0,0,0,0,0,1,100
transformers_4.23.0,docs/source/es/_config.py,14,5,12,0,0,0,0,0,0,0,0,0,0,0,1,100
transformers_4.23.0,tests/test_modeling_flax_common.py,1223,780,838,16,123,90,162,139,252,917.929284156726,10.5365853658537,18902.3512424627,1050.13062458126,1793.97315032632,175,12.2610047193353
transformers_4.23.0,tests/test_configuration_common.py,414,229,301,7,26,17,32,33,49,141.862917126072,4.30769230769231,1064.75518950151,59.1530660834171,247.175311848564,54,45.857979945144
transformers_4.23.0,tests/test_feature_extraction_common.py,275,149,174,4,16,13,18,20,31,72,2.25,301.454484618394,16.7474713676885,133.979770941508,40,56.412348049201
transformers_4.23.0,tests/__init__.py,0,0,0,0,0,0,0,0,0,0,0,0,0,0,1,100
transformers_4.23.0,tests/test_sequence_feature_extraction_common.py,425,249,302,11,102,77,146,113,223,718.641132686103,7.87254901960784,11973.3590845169,665.186615806495,1520.89990861859,29,39.8079846506617
transformers_4.23.0,tests/test_modeling_tf_common.py,2309,1386,1738,21,369,261,471,390,732,3238.87768111464,13.4024390243902,84442.9488151405,4691.27493417447,6300.56578966472,370,0
transformers_4.23.0,tests/test_tokenization_common.py,4093,2227,2990,20,438,363,671,458,1034,3929.79529400306,15.3196347031963,140017.42778618,7778.74598812112,9139.73671689224,462,0
transformers_4.23.0,tests/test_modeling_common.py,3132,1885,2195,21,351,304,525,372,829,3060.05852020525,15.7051282051282,111176.016046801,6176.44533593339,7078.96265440856,431,0
transformers_4.23.0,tests/models/__init__.py,0,0,0,0,0,0,0,0,0,0,0,0,0,0,1,100
transformers_4.23.0,tests/models/fnet/test_tokenization_fnet.py,450,201,340,5,25,16,29,30,45,127.706045218805,2.9,640.349222726912,35.5749568181618,220.810076802383,26,46.9723061015014
transformers_4.23.0,tests/models/fnet/test_modeling_fnet.py,566,282,401,5,24,25,29,29,54,121.648740491745,3.02083333333333,792.458149830186,44.0254527683436,262.330973736889,45,45.8290155757504
transformers_4.23.0,tests/models/fnet/__init__.py,0,0,0,0,0,0,0,0,0,0,0,0,0,0,1,100
transformers_4.23.0,tests/models/gpt_neo/test_modeling_flax_gpt_neo.py,331,200,249,4,28,41,59,32,100,142.605937817613,4.21428571428571,2107.14285714286,117.063492063492,500,31,44.2767079531036
transformers_4.23.0,tests/models/gpt_neo/__init__.py,0,0,0,0,0,0,0,0,0,0,0,0,0,0,1,100
transformers_4.23.0,tests/models/gpt_neo/test_modeling_gpt_neo.py,557,296,413,7,49,54,71,56,125,294.772266816048,5.07142857142857,3681.44820951866,204.524900528814,725.919365257201,44,38.7878721784088
transformers_4.23.0,tests/models/mbart50/__init__.py,0,0,0,0,0,0,0,0,0,0,0,0,0,0,1,100
transformers_4.23.0,tests/models/mbart50/test_tokenization_mbart50.py,318,169,223,7,29,34,63,36,97,160.532933313103,7.60344827586207,3812.99796183962,211.833220102201,501.482725139904,37,50.2104470229225
transformers_4.23.0,tests/models/roberta/test_modeling_flax_roberta.py,160,64,124,0,0,0,0,0,0,0,0,0,0,0,12,100
transformers_4.23.0,tests/models/roberta/__init__.py,0,0,0,0,0,0,0,0,0,0,0,0,0,0,1,100
transformers_4.23.0,tests/models/roberta/test_modeling_roberta.py,562,262,435,4,31,34,51,35,85,161.580085621993,3.29032258064516,1434.54463731977,79.6969242955428,435.989056440322,43,41.2267765054709
transformers_4.23.0,tests/models/roberta/test_modeling_tf_roberta.py,687,329,499,5,29,35,48,34,83,152.491089333136,4.13793103448276,1747.28034133977,97.0711300744318,422.259415823778,43,40.8068577933801
transformers_4.23.0,tests/models/roberta/test_tokenization_roberta.py,303,151,221,3,48,34,68,51,102,272.833087536779,2.125,1229.49819287232,68.3054551595734,578.587384881093,18,51.9377492390436
transformers_4.23.0,tests/models/esm/__init__.py,0,0,0,0,0,0,0,0,0,0,0,0,0,0,1,100
transformers_4.23.0,tests/models/esm/test_tokenization_esm.py,91,55,53,1,2,1,2,3,3,2,0.5,2.37744375108173,0.13208020839343,4.75488750216347,11,82.7775043138574
transformers_4.23.0,tests/models/esm/test_modeling_esm.py,293,164,216,2,23,21,35,25,56,106.041924989311,1.52173913043478,395.73731008515,21.9854061158417,260.055946627385,27,50.9895097526973
transformers_4.23.0,tests/models/gpt_neox_japanese/__init__.py,0,0,0,0,0,0,0,0,0,0,0,0,0,0,1,100
transformers_4.23.0,tests/models/gpt_neox_japanese/test_tokenization_gpt_neox_japanese.py,137,69,92,2,9,5,10,11,15,30.5293250129808,1.11111111111111,57.657193643955,3.20317742466416,51.8914742795595,15,71.0184187161619
transformers_4.23.0,tests/models/gpt_neox_japanese/test_modeling_gpt_neox_japanese.py,255,141,187,3,6,6,8,9,14,20.2646625064904,2,88.7579000403848,4.93099444668804,44.3789500201924,24,56.687488632225
transformers_4.23.0,tests/models/albert/test_modeling_flax_albert.py,161,70,126,1,6,6,6,7,12,15.5097750043269,0.5,16.8441295323456,0.935784974019201,33.6882590646913,12,65.4973759716119
transformers_4.23.0,tests/models/albert/__init__.py,0,0,0,0,0,0,0,0,0,0,0,0,0,0,1,100
transformers_4.23.0,tests/models/albert/test_tokenization_albert.py,135,75,84,4,17,10,18,21,28,77.4868683012558,2.11764705882353,260.43858600947,14.4688103338594,122.984887837805,13,66.6550856208215
transformers_4.23.0,tests/models/albert/test_modeling_tf_albert.py,337,182,270,3,10,7,11,13,18,37.9741684510371,1.65,109.90305962879,6.1057255349328,66.6079149265397,40,47.8254127868492
transformers_4.23.0,tests/models/albert/test_modeling_albert.py,309,172,252,2,9,13,14,11,27,30.5293250129808,1.55555555555556,145.296127982767,8.0720071101537,93.404653703207,33,47.1592360181884
transformers_4.23.0,tests/models/vit/test_modeling_tf_vit.py,244,140,166,6,20,12,22,26,34,101.948336902074,3.3,527.389336375431,29.2994075764128,159.814950416797,26,55.6370813474549
transformers_4.23.0,tests/models/vit/test_feature_extraction_vit.py,191,71,137,0,0,0,0,0,0,0,0,0,0,0,16,100
transformers_4.23.0,tests/models/vit/__init__.py,0,0,0,0,0,0,0,0,0,0,0,0,0,0,1,100
transformers_4.23.0,tests/models/vit/test_modeling_vit.py,302,168,212,6,15,10,15,21,25,74.1131339384547,3,329.423806708407,18.3013225949115,109.807935569469,29,54.08700248237
transformers_4.23.0,tests/models/vit/test_modeling_flax_vit.py,188,102,134,4,14,7,14,18,21,61.3029689088065,2,175.136850060577,9.7298250033654,87.5684250302886,19,60.5973741380883
transformers_4.23.0,tests/models/trocr/__init__.py,0,0,0,0,0,0,0,0,0,0,0,0,0,0,1,100
transformers_4.23.0,tests/models/trocr/test_modeling_trocr.py,192,98,132,4,12,11,19,16,30,51.0195500086539,3.16666666666667,380,21.1111111111111,120,18,62.1859429156597
transformers_4.23.0,tests/models/qdqbert/test_modeling_qdqbert.py,562,246,465,2,8,14,15,10,29,26,1.875,180.6298401595,10.0349911199722,96.3359147517335,43,42.8585366689365
transformers_4.23.0,tests/models/qdqbert/__init__.py,0,0,0,0,0,0,0,0,0,0,0,0,0,0,1,100
transformers_4.23.0,tests/models/phobert/test_tokenization_phobert.py,67,38,37,1,2,1,2,3,3,2,0.5,2.37744375108173,0.13208020839343,4.75488750216347,6,87.9566623776468
transformers_4.23.0,tests/models/phobert/__init__.py,0,0,0,0,0,0,0,0,0,0,0,0,0,0,1,100
transformers_4.23.0,tests/models/bort/test_modeling_bort.py,51,21,28,1,6,6,6,7,12,15.5097750043269,0.5,16.8441295323456,0.935784974019201,33.6882590646913,3,89.2976983630154
transformers_4.23.0,tests/models/bort/__init__.py,0,0,0,0,0,0,0,0,0,0,0,0,0,0,1,100
transformers_4.23.0,tests/models/bort/test_modeling_tf_bort.py,51,21,26,1,6,6,6,7,12,15.5097750043269,0.5,16.8441295323456,0.935784974019201,33.6882590646913,3,89.254293555947
transformers_4.23.0,tests/models/plbart/__init__.py,0,0,0,0,0,0,0,0,0,0,0,0,0,0,1,100
transformers_4.23.0,tests/models/plbart/test_tokenization_plbart.py,360,127,301,4,35,49,92,39,141,187.524905593074,5.25714285714286,3917.84214760463,217.657897089146,745.241712859577,22,45.5805228021941
transformers_4.23.0,tests/models/plbart/test_modeling_plbart.py,633,358,492,11,51,44,72,62,116,327.347440245557,7.76470588235294,5362.97964144964,297.943313413869,690.686772004878,60,32.4456421557203
transformers_4.23.0,tests/models/dit/__init__.py,0,0,0,0,0,0,0,0,0,0,0,0,0,0,1,100
transformers_4.23.0,tests/models/dit/test_modeling_dit.py,61,28,31,1,3,3,3,4,6,4.75488750216347,0.5,6,0.333333333333333,12,4,89.3324454776354
transformers_4.23.0,tests/models/donut/__init__.py,0,0,0,0,0,0,0,0,0,0,0,0,0,0,1,100
transformers_4.23.0,tests/models/donut/test_modeling_donut_swin.py,365,202,280,12,53,31,58,65,89,346.599334100503,6.56603773584906,3519.33539443618,195.518633024232,535.990735359532,38,41.5344856173896
transformers_4.23.0,tests/models/donut/test_feature_extraction_donut.py,203,77,149,0,0,0,0,0,0,0,0,0,0,0,16,100
transformers_4.23.0,tests/models/tapex/__init__.py,0,0,0,0,0,0,0,0,0,0,0,0,0,0,1,100
transformers_4.23.0,tests/models/tapex/test_tokenization_tapex.py,906,536,683,13,84,70,133,97,203,585.06037984925,10.2916666666667,13788.592909171,766.032939398391,1339.78230696399,90,24.3602908932297
transformers_4.23.0,tests/models/xlm_roberta_xl/__init__.py,0,0,0,0,0,0,0,0,0,0,0,0,0,0,1,100
transformers_4.23.0,tests/models/xlm_roberta_xl/test_modeling_xlm_roberta_xl.py,509,226,404,4,28,31,48,32,79,142.605937817613,3.42857142857143,1354.28571428571,75.2380952380952,395,37,42.8454052096672
transformers_4.23.0,tests/models/mvp/__init__.py,0,0,0,0,0,0,0,0,0,0,0,0,0,0,1,100
transformers_4.23.0,tests/models/mvp/test_tokenization_mvp.py,182,107,137,5,15,10,18,20,28,70.2129994085646,3,363.041959970538,20.168997776141,121.013986656846,20,58.8465237300371
transformers_4.23.0,tests/models/mvp/test_modeling_mvp.py,787,416,631,11,51,46,74,62,120,327.347440245557,7.98039215686275,5702.0185842999,316.778810238883,714.503557246425,67,28.607503898601
transformers_4.23.0,tests/models/segformer/__init__.py,0,0,0,0,0,0,0,0,0,0,0,0,0,0,1,100
transformers_4.23.0,tests/models/segformer/test_modeling_segformer.py,424,238,319,7,86,89,114,93,203,572.310253358784,4.63953488372093,6158.74704910834,342.152613839352,1327.44923865493,33,38.1571349093854
transformers_4.23.0,tests/models/segformer/test_feature_extraction_segformer.py,335,129,255,3,18,13,25,21,38,79.8135375281251,2.08333333333333,347.725129303319,19.3180627390733,166.908062065593,19,55.9143702466775
transformers_4.23.0,tests/models/segformer/test_modeling_tf_segformer.py,504,291,370,9,99,99,134,108,233,684.835630400862,6.09090909090909,9586.41352693399,532.578529274111,1573.88878800409,42,36.4382249457595
transformers_4.23.0,tests/models/realm/test_tokenization_realm.py,322,160,239,3,19,11,20,22,31,85.4655102575916,1.57894736842105,218.277442385931,12.1265245769962,138.242380177756,36,47.0244622792415
transformers_4.23.0,tests/models/realm/__init__.py,0,0,0,0,0,0,0,0,0,0,0,0,0,0,1,100
transformers_4.23.0,tests/models/realm/test_modeling_realm.py,556,267,454,3,10,9,10,13,19,37.9741684510371,1.5,105.462531967021,5.8590295537234,70.3083546446807,33,43.8512243147345
transformers_4.23.0,tests/models/realm/test_retrieval_realm.py,187,78,145,2,3,11,12,5,23,6.75488750216347,4,213.617384729637,11.8676324849799,53.4043461824093,12,64.0635379712604
transformers_4.23.0,tests/models/conditional_detr/test_modeling_conditional_detr.py,542,322,413,8,69,60,81,77,141,445.488187517694,4.69565217391304,4149.15762790009,230.50875710556,883.616902237981,57,32.942400334732
transformers_4.23.0,tests/models/conditional_detr/test_feature_extraction_conditional_detr.py,342,180,229,5,6,7,13,11,20,27.1194154787637,5.41666666666667,374.771758685707,20.8206532603171,69.188632372746,26,59.4091217631776
transformers_4.23.0,tests/models/conditional_detr/__init__.py,0,0,0,0,0,0,0,0,0,0,0,0,0,0,1,100
transformers_4.23.0,tests/models/ibert/__init__.py,0,0,0,0,0,0,0,0,0,0,0,0,0,0,1,100
transformers_4.23.0,tests/models/ibert/test_modeling_ibert.py,703,433,526,13,133,124,197,146,321,986.458280257492,9.62781954887218,22220.3690345438,1234.46494636354,2307.93368340049,78,27.9114149502381
transformers_4.23.0,tests/models/reformer/test_modeling_reformer.py,1260,616,1085,10,170,159,236,180,395,1292.81574009228,6.94117647058824,20540.8984011721,1141.16102228734,2959.28197305022,100,13.7364113862242
transformers_4.23.0,tests/models/reformer/test_tokenization_reformer.py,373,111,294,4,14,21,40,18,61,61.3029689088065,5.71428571428571,1453.51671478846,80.7509285993591,254.365425087981,17,54.2250774625722
transformers_4.23.0,tests/models/reformer/__init__.py,0,0,0,0,0,0,0,0,0,0,0,0,0,0,1,100
transformers_4.23.0,tests/models/mobilevit/test_modeling_mobilevit.py,366,201,264,3,28,32,42,31,74,139.360825319776,2.25,824.873685679415,45.8263158710786,366.610526968629,32,45.7670507330694
transformers_4.23.0,tests/models/mobilevit/__init__.py,0,0,0,0,0,0,0,0,0,0,0,0,0,0,1,100
transformers_4.23.0,tests/models/mobilevit/test_feature_extraction_mobilevit.py,191,71,137,0,0,0,0,0,0,0,0,0,0,0,16,100
transformers_4.23.0,tests/models/mobilevit/test_modeling_tf_mobilevit.py,420,240,289,11,67,51,78,78,129,444.481723565681,6.40298507462687,5191.6484208068,288.424912267045,810.81688623323,51,41.9980518953302
transformers_4.23.0,tests/models/imagegpt/test_modeling_imagegpt.py,552,295,412,10,38,36,69,48,105,232.64052645973,9.07894736842105,5324.08596285852,295.78255349214,586.421062575722,67,35.6925200963515
transformers_4.23.0,tests/models/imagegpt/__init__.py,0,0,0,0,0,0,0,0,0,0,0,0,0,0,1,100
transformers_4.23.0,tests/models/imagegpt/test_feature_extraction_imagegpt.py,177,102,121,2,9,6,9,11,15,30.5293250129808,1,51.8914742795595,2.88285968219775,51.8914742795595,20,61.9797313860128
transformers_4.23.0,tests/models/flaubert/__init__.py,0,0,0,0,0,0,0,0,0,0,0,0,0,0,1,100
transformers_4.23.0,tests/models/flaubert/test_modeling_tf_flaubert.py,363,157,301,3,10,8,10,13,18,37.9741684510371,1.5,99.9118723898095,5.55065957721164,66.6079149265397,27,49.8889405511798
transformers_4.23.0,tests/models/flaubert/test_modeling_flaubert.py,448,201,373,5,19,20,26,24,46,92.3202632298649,3.42105263157895,721.528309324014,40.0849060735563,210.908275033173,35,41.2940079927657
transformers_4.23.0,tests/models/speech_encoder_decoder/test_modeling_speech_encoder_decoder.py,621,271,517,6,31,24,39,37,63,169.08986062632,3.7741935483871,1238.67357284035,68.8151984911308,328.195562034624,44,36.2580060612956
transformers_4.23.0,tests/models/speech_encoder_decoder/__init__.py,0,0,0,0,0,0,0,0,0,0,0,0,0,0,1,100
transformers_4.23.0,tests/models/speech_encoder_decoder/test_modeling_flax_speech_encoder_decoder.py,926,475,715,13,46,42,69,59,111,302.189566314457,9.75,6366.49044017185,353.693913342881,652.973378479164,62,28.929476193447
transformers_4.23.0,tests/models/deberta/test_modeling_deberta.py,290,153,235,1,6,6,6,7,12,15.5097750043269,0.5,16.8441295323456,0.935784974019201,33.6882590646913,28,52.4991326873977
transformers_4.23.0,tests/models/deberta/__init__.py,0,0,0,0,0,0,0,0,0,0,0,0,0,0,1,100
transformers_4.23.0,tests/models/deberta/test_tokenization_deberta.py,168,72,123,2,8,4,8,10,12,26,1,39.8631371386484,2.21461872992491,39.8631371386484,14,66.7557594490828
transformers_4.23.0,tests/models/deberta/test_modeling_tf_deberta.py,282,135,226,1,7,7,7,8,14,19.6514844544032,0.5,21,1.16666666666667,42,24,53.3548769972308
transformers_4.23.0,tests/models/cvt/__init__.py,0,0,0,0,0,0,0,0,0,0,0,0,0,0,1,100
transformers_4.23.0,tests/models/cvt/test_modeling_cvt.py,282,166,201,6,22,15,27,28,42,113.617270614347,3.68181818181818,743.391883856362,41.2995491031312,201.908906726419,29,51.0451204299587
transformers_4.23.0,tests/models/longformer/__init__.py,0,0,0,0,0,0,0,0,0,0,0,0,0,0,1,100
transformers_4.23.0,tests/models/longformer/test_modeling_longformer.py,709,358,571,8,103,105,138,111,243,712.709554299871,5.35922330097087,8848.30841406542,491.572689670301,1651.04305552308,42,31.181284216763
transformers_4.23.0,tests/models/longformer/test_tokenization_longformer.py,305,151,221,3,48,34,68,51,102,272.833087536779,2.125,1229.49819287232,68.3054551595734,578.587384881093,18,52.1747759470447
transformers_4.23.0,tests/models/longformer/test_modeling_tf_longformer.py,700,360,544,8,117,107,144,125,251,827.832672191258,4.92307692307692,8607.56605760091,478.198114311162,1748.41185545018,42,31.2855643745635
transformers_4.23.0,tests/models/trajectory_transformer/__init__.py,0,0,0,0,0,0,0,0,0,0,0,0,0,0,1,100
transformers_4.23.0,tests/models/trajectory_transformer/test_modeling_trajectory_transformer.py,275,147,200,5,21,16,23,26,39,103.848306352791,2.73809523809524,501.939812758638,27.8855451532577,183.317149007503,31,50.1360034459988
transformers_4.23.0,tests/models/mluke/__init__.py,0,0,0,0,0,0,0,0,0,0,0,0,0,0,1,100
transformers_4.23.0,tests/models/mluke/test_tokenization_mluke.py,676,315,511,3,15,600,604,18,1204,63.3582464362913,60.4,303243.617984887,16846.8676658271,5020.58970173654,29,33.0344661699017
transformers_4.23.0,tests/models/retribert/test_tokenization_retribert.py,384,194,273,7,27,15,28,34,43,148.033447012817,3.62962962962963,794.021052334405,44.1122806852447,218.760902173765,42,45.5094796483696
transformers_4.23.0,tests/models/retribert/__init__.py,0,0,0,0,0,0,0,0,0,0,0,0,0,0,1,100
transformers_4.23.0,tests/models/vit_msn/test_modeling_vit_msn.py,239,140,166,6,13,8,13,19,21,63.6154913401611,3,267.619433346946,14.8677462970525,89.2064777823153,26,56.7574650660091
transformers_4.23.0,tests/models/vit_msn/__init__.py,0,0,0,0,0,0,0,0,0,0,0,0,0,0,1,100
transformers_4.23.0,tests/models/levit/test_feature_extraction_levit.py,195,73,141,0,0,0,0,0,0,0,0,0,0,0,16,100
transformers_4.23.0,tests/models/levit/__init__.py,0,0,0,0,0,0,0,0,0,0,0,0,0,0,1,100
transformers_4.23.0,tests/models/levit/test_modeling_levit.py,427,238,319,12,67,46,85,79,131,449.447525769325,7.61194029850746,6285.90435501063,349.216908611702,825.795278011201,51,38.715033268151
transformers_4.23.0,tests/models/barthez/test_tokenization_barthez.py,118,64,75,2,2,2,2,4,4,4,1,8,0.444444444444444,8,9,78.325742048599
transformers_4.23.0,tests/models/barthez/__init__.py,0,0,0,0,0,0,0,0,0,0,0,0,0,0,1,100
transformers_4.23.0,tests/models/t5/test_modeling_flax_t5.py,1099,488,845,7,78,58,98,85,156,509.912857525659,4.3974358974359,4396.84218219046,244.269010121692,999.864986037482,82,27.3597386014891
transformers_4.23.0,tests/models/t5/__init__.py,0,0,0,0,0,0,0,0,0,0,0,0,0,0,1,100
transformers_4.23.0,tests/models/t5/test_modeling_tf_t5.py,1054,438,796,8,52,43,69,60,112,320.422865343337,5.30769230769231,3511.41927098943,195.078848388302,661.571746708154,61,32.6533749873581
transformers_4.23.0,tests/models/t5/test_tokenization_t5.py,381,192,282,6,26,29,56,32,85,137.721207675995,6.46153846153846,2746.15384615385,152.564102564103,425,33,45.640502796954
transformers_4.23.0,tests/models/t5/test_modeling_t5.py,1254,490,1009,7,93,78,124,100,202,627.79325388745,4.66666666666667,6262.94176822764,347.94120934598,1342.05895033449,89,24.2414439645823
transformers_4.23.0,tests/models/maskformer/test_modeling_maskformer.py,426,239,312,10,81,66,94,91,160,546.747131182528,5.80246913580247,6041.80440670299,335.655800372388,1041.24714243179,43,39.2154843508712
transformers_4.23.0,tests/models/maskformer/test_feature_extraction_maskformer.py,416,220,311,11,28,21,39,39,60,172.659685622623,7.66071428571429,2429.39737702704,134.966520945947,317.124133131735,45,45.1193904392726
transformers_4.23.0,tests/models/maskformer/__init__.py,0,0,0,0,0,0,0,0,0,0,0,0,0,0,1,100
transformers_4.23.0,tests/models/blenderbot/test_modeling_flax_blenderbot.py,417,195,336,7,41,41,66,48,107,239.311116643745,5.63414634146341,3366.91507634939,187.050837574966,597.590987577164,33,40.3263691662469
transformers_4.23.0,tests/models/blenderbot/test_modeling_blenderbot.py,550,288,417,10,50,42,70,60,112,315.41209043761,7,4631.00222695708,257.277901497616,661.571746708154,50,37.1893389884916
transformers_4.23.0,tests/models/blenderbot/test_tokenization_blenderbot.py,52,29,28,1,8,4,8,9,12,24,0.5,19.0195500086539,1.05664166714744,38.0391000173078,13,84.482816193915
transformers_4.23.0,tests/models/blenderbot/__init__.py,0,0,0,0,0,0,0,0,0,0,0,0,0,0,1,100
transformers_4.23.0,tests/models/blenderbot/test_modeling_tf_blenderbot.py,327,190,246,10,45,35,65,55,100,280.352670283709,7.22222222222222,4175.42645976781,231.968136653767,578.135971352466,50,42.1666345986823
transformers_4.23.0,tests/models/pegasus_x/test_modeling_pegasus_x.py,860,474,660,14,84,73,119,98,192,590.257632422222,9.91666666666667,12594.4075431954,699.689307955298,1270.02429007012,75,25.8735972033315
transformers_4.23.0,tests/models/pegasus_x/__init__.py,0,0,0,0,0,0,0,0,0,0,0,0,0,0,1,100
transformers_4.23.0,tests/models/nezha/__init__.py,0,0,0,0,0,0,0,0,0,0,0,0,0,0,1,100
transformers_4.23.0,tests/models/nezha/test_modeling_nezha.py,479,231,402,3,14,17,19,17,36,58.0578564109699,2.03571428571429,299.552633937346,16.6418129965192,147.148662285012,42,40.650415049652
transformers_4.23.0,tests/models/dpr/test_tokenization_dpr.py,88,50,57,2,26,13,26,28,39,124.211432671668,1,187.486841960247,10.4159356644581,187.486841960247,3,71.6404531367886
transformers_4.23.0,tests/models/dpr/test_modeling_tf_dpr.py,257,122,206,2,7,5,7,9,12,21.6514844544032,1,38.0391000173078,2.11328333429488,38.0391000173078,25,56.8713236503098
transformers_4.23.0,tests/models/dpr/__init__.py,0,0,0,0,0,0,0,0,0,0,0,0,0,0,1,100
transformers_4.23.0,tests/models/dpr/test_modeling_dpr.py,311,153,249,2,27,25,27,29,52,130.381962558414,1,252.615011746634,14.0341673192574,252.615011746634,28,47.592310608828
transformers_4.23.0,tests/models/nystromformer/__init__.py,0,0,0,0,0,0,0,0,0,0,0,0,0,0,1,100
transformers_4.23.0,tests/models/nystromformer/test_modeling_nystromformer.py,313,166,250,1,7,12,12,8,24,19.6514844544032,0.857142857142857,61.7142857142857,3.42857142857143,72,30,48.3003348188531
transformers_4.23.0,tests/models/wavlm/test_modeling_wavlm.py,585,331,422,13,107,87,126,120,213,769.442683880757,7.65420560747664,11260.6200348796,625.590001937757,1471.16769686461,71,32.5904808318219
transformers_4.23.0,tests/models/wavlm/__init__.py,0,0,0,0,0,0,0,0,0,0,0,0,0,0,1,100
transformers_4.23.0,tests/models/x_clip/test_modeling_x_clip.py,672,408,517,13,42,26,48,55,74,274.583048092542,7.42857142857143,3178.09602537756,176.560890298753,427.820618800825,86,28.6351725309925
transformers_4.23.0,tests/models/x_clip/__init__.py,0,0,0,0,0,0,0,0,0,0,0,0,0,0,1,100
transformers_4.23.0,tests/models/sew/test_modeling_sew.py,561,316,405,12,115,92,134,127,226,830.250905867257,6.99130434782609,11042.3648897848,613.464716099155,1579.44273921051,70,31.7556566313754
transformers_4.23.0,tests/models/sew/__init__.py,0,0,0,0,0,0,0,0,0,0,0,0,0,0,1,100
transformers_4.23.0,tests/models/clip/test_modeling_flax_clip.py,587,370,428,7,27,16,29,34,45,148.033447012817,3.75925925925926,860.629130644849,47.8127294802694,228.935827856265,70,34.9671123653605
transformers_4.23.0,tests/models/clip/test_modeling_tf_clip.py,660,380,485,9,65,42,76,74,118,419.98323285983,5.26153846153846,3855.21076958957,214.178376088309,732.715497144216,77,31.5092108429632
transformers_4.23.0,tests/models/clip/__init__.py,0,0,0,0,0,0,0,0,0,0,0,0,0,0,1,100
transformers_4.23.0,tests/models/clip/test_feature_extraction_clip.py,294,125,216,3,6,6,8,9,14,20.2646625064904,2,88.7579000403848,4.93099444668804,44.3789500201924,33,59.7060857891423
transformers_4.23.0,tests/models/clip/test_modeling_clip.py,674,399,490,13,42,23,43,55,66,274.583048092542,6.65476190476191,2539.25577703308,141.069765390727,381.569741092628,91,30.9177682970876
transformers_4.23.0,tests/models/clip/test_processor_clip.py,189,112,119,2,3,2,3,5,5,6.75488750216347,1,11.6096404744368,0.644980026357601,11.6096404744368,17,67.0926546520455
transformers_4.23.0,tests/models/clip/test_tokenization_clip.py,186,93,124,1,20,13,26,21,39,86.4385618977473,0.65,111.345246667442,6.18584703708009,171.300379488372,15,66.8622498597729
transformers_4.23.0,tests/models/squeezebert/__init__.py,0,0,0,0,0,0,0,0,0,0,0,0,0,0,1,100
transformers_4.23.0,tests/models/squeezebert/test_modeling_squeezebert.py,286,150,234,1,3,6,6,4,12,4.75488750216347,1,24,1.33333333333333,24,26,53.5627128134099
transformers_4.23.0,tests/models/squeezebert/test_tokenization_squeezebert.py,46,19,21,2,15,8,16,17,24,60.6033589341278,1.06666666666667,104.639048736009,5.81328048533382,98.0991081900082,5,86.5129404771989
transformers_4.23.0,tests/models/herbert/__init__.py,0,0,0,0,0,0,0,0,0,0,0,0,0,0,1,100
transformers_4.23.0,tests/models/herbert/test_tokenization_herbert.py,128,63,88,3,18,10,19,21,29,79.8135375281251,1.58333333333333,201.680574995925,11.2044763886625,127.377205260584,9,66.8715537044767
transformers_4.23.0,tests/models/big_bird/test_modeling_flax_big_bird.py,223,102,168,0,0,0,0,0,0,0,0,0,0,0,22,100
transformers_4.23.0,tests/models/big_bird/__init__.py,0,0,0,0,0,0,0,0,0,0,0,0,0,0,1,100
transformers_4.23.0,tests/models/big_bird/test_modeling_big_bird.py,936,397,769,8,341,344,359,349,703,2893.04712379724,4.21114369501466,25007.0325323298,1389.27958512943,5938.29950802539,64,22.6105298044338
transformers_4.23.0,tests/models/big_bird/test_tokenization_big_bird.py,237,99,160,5,19,24,46,24,70,92.3202632298649,6.05263157894737,1942.57621741081,107.920900967267,320.947375050481,15,60.7715396091439
transformers_4.23.0,tests/models/openai/test_modeling_tf_openai.py,285,146,226,3,7,5,10,10,15,24.4063719565667,2.14285714285714,106.776260192808,5.932014455156,49.8289214233104,32,54.5479954877805
transformers_4.23.0,tests/models/openai/test_modeling_openai.py,267,130,211,2,4,2,4,6,6,10,1,15.5097750043269,0.861654166907052,15.5097750043269,25,60.9978704466741
transformers_4.23.0,tests/models/openai/__init__.py,0,0,0,0,0,0,0,0,0,0,0,0,0,0,1,100
transformers_4.23.0,tests/models/openai/test_tokenization_openai.py,144,58,93,1,2,1,2,3,3,2,0.5,2.37744375108173,0.13208020839343,4.75488750216347,7,80.92383581295
transformers_4.23.0,tests/models/mbart/test_modeling_mbart.py,668,361,523,11,51,44,72,62,116,327.347440245557,7.76470588235294,5362.97964144964,297.943313413869,690.686772004878,62,32.0187544427629
transformers_4.23.0,tests/models/mbart/test_modeling_tf_mbart.py,345,205,266,9,41,30,59,50,89,248.188957202322,6.47560975609756,3252.719508202,180.706639344555,502.303200889951,52,41.3097771483669
transformers_4.23.0,tests/models/mbart/__init__.py,0,0,0,0,0,0,0,0,0,0,0,0,0,0,1,100
transformers_4.23.0,tests/models/mbart/test_tokenization_mbart.py,327,149,240,7,29,35,63,36,98,160.532933313103,7.60344827586207,3852.30721917817,214.017067732121,506.652650141347,32,50.1487379967439
transformers_4.23.0,tests/models/mbart/test_modeling_flax_mbart.py,464,221,378,6,39,40,64,45,104,221.640461539955,4.92307692307692,2811.82878532079,156.2127102956,571.152722018286,38,37.8602482914131
transformers_4.23.0,tests/models/xglm/test_modeling_flax_xglm.py,347,206,260,4,26,38,53,30,91,130.211432671668,4.07692307692308,1820.45641097076,101.136467276153,446.527044200375,32,44.7724535126665
transformers_4.23.0,tests/models/xglm/__init__.py,0,0,0,0,0,0,0,0,0,0,0,0,0,0,1,100
transformers_4.23.0,tests/models/xglm/test_tokenization_xglm.py,205,84,151,2,13,21,41,15,62,50.1057163358342,3.15384615384615,763.947376464373,42.4415209146874,242.227216927728,15,59.3305852332707
transformers_4.23.0,tests/models/xglm/test_modeling_tf_xglm.py,284,146,214,4,10,8,14,14,22,41.2192809488736,2.8,234.533063198748,13.0296146221527,83.7618082852673,28,53.2300703758581
transformers_4.23.0,tests/models/xglm/test_modeling_xglm.py,489,279,357,9,38,35,58,47,93,227.950570523837,6.86842105263158,3548.06671570451,197.114817539139,516.57676320602,42,40.0954600318332
transformers_4.23.0,tests/models/pegasus/test_modeling_tf_pegasus.py,374,216,281,10,45,35,65,55,100,280.352670283709,7.22222222222222,4175.42645976781,231.968136653767,578.135971352466,53,41.1801499650285
transformers_4.23.0,tests/models/pegasus/__init__.py,0,0,0,0,0,0,0,0,0,0,0,0,0,0,1,100
transformers_4.23.0,tests/models/pegasus/test_tokenization_pegasus.py,215,120,137,4,32,21,40,36,61,168,2.5,788.413562719953,43.8007534844418,315.365425087981,36,57.4070274249909
transformers_4.23.0,tests/models/pegasus/test_modeling_pegasus.py,562,287,433,10,54,44,74,64,118,343.983206065701,6.85185185185185,4851.11111111111,269.506172839506,708,53,36.3328607547327
transformers_4.23.0,tests/models/pegasus/test_modeling_flax_pegasus.py,338,160,264,6,32,34,52,38,86,175.509775004327,4.875,2200.19361001122,122.232978333957,451.321766156148,26,44.5114195588863
transformers_4.23.0,tests/models/layoutlm/test_tokenization_layoutlm.py,74,32,45,1,2,1,2,3,3,2,0.5,2.37744375108173,0.13208020839343,4.75488750216347,7,88.2410911079749
transformers_4.23.0,tests/models/layoutlm/__init__.py,0,0,0,0,0,0,0,0,0,0,0,0,0,0,1,100
transformers_4.23.0,tests/models/layoutlm/test_modeling_layoutlm.py,375,182,279,2,13,27,29,15,56,50.1057163358342,2.23076923076923,488.060794405249,27.1144885780694,218.785873354077,32,50.8692421392384
transformers_4.23.0,tests/models/layoutlm/test_modeling_tf_layoutlm.py,358,176,261,2,13,27,29,15,56,50.1057163358342,2.23076923076923,488.060794405249,27.1144885780694,218.785873354077,32,51.3226793843691
transformers_4.23.0,tests/models/convbert/__init__.py,0,0,0,0,0,0,0,0,0,0,0,0,0,0,1,100
transformers_4.23.0,tests/models/convbert/test_modeling_tf_convbert.py,410,228,335,4,21,17,23,25,40,100.238665878354,2.19047619047619,406.890256627881,22.6050142571045,185.754247590989,33,41.0313453915977
transformers_4.23.0,tests/models/convbert/test_modeling_convbert.py,457,253,375,8,31,37,54,39,91,177.580085621993,6.96774193548387,3351.28600045021,186.182555580567,480.971601916465,46,37.2461259414346
transformers_4.23.0,tests/models/gpt2/test_modeling_gpt2.py,765,400,594,10,59,62,98,69,160,380.295220861222,8.30508474576271,8117.09012561709,450.949451423172,977.363913084507,61,29.884278194604
transformers_4.23.0,tests/models/gpt2/test_tokenization_gpt2.py,331,168,223,6,31,25,44,37,69,169.08986062632,4.25806451612903,1530.57100819834,85.0317226776854,359.452282228398,25,54.340852631287
transformers_4.23.0,tests/models/gpt2/test_modeling_tf_gpt2.py,665,358,496,8,28,31,48,36,79,158.605937817613,6.85714285714286,2800.62222935275,155.590123852931,408.424075113943,50,37.3110960531279
transformers_4.23.0,tests/models/gpt2/__init__.py,0,0,0,0,0,0,0,0,0,0,0,0,0,0,1,100
transformers_4.23.0,tests/models/gpt2/test_modeling_flax_gpt2.py,337,203,252,4,28,41,59,32,100,142.605937817613,4.21428571428571,2107.14285714286,117.063492063492,500,32,43.9111731510461
transformers_4.23.0,tests/models/vision_text_dual_encoder/test_modeling_flax_vision_text_dual_encoder.py,395,216,278,5,15,11,18,20,29,70.2129994085646,3,376.007744255201,20.8893191252889,125.335914751734,33,46.6691979457257
transformers_4.23.0,tests/models/vision_text_dual_encoder/__init__.py,0,0,0,0,0,0,0,0,0,0,0,0,0,0,1,100
transformers_4.23.0,tests/models/vision_text_dual_encoder/test_modeling_vision_text_dual_encoder.py,527,285,391,5,22,19,30,27,49,109.717136084457,3.40909090909091,794.282344111398,44.1267968950777,232.98948760601,40,38.8537603032722
transformers_4.23.0,tests/models/vision_text_dual_encoder/test_processor_vision_text_dual_encoder.py,170,94,102,2,3,2,3,5,5,6.75488750216347,1,11.6096404744368,0.644980026357601,11.6096404744368,17,70.0161471298386
transformers_4.23.0,tests/models/rag/__init__.py,0,0,0,0,0,0,0,0,0,0,0,0,0,0,1,100
transformers_4.23.0,tests/models/rag/test_retrieval_rag.py,380,213,329,5,32,23,36,37,59,171.609640474437,2.8125,864.443667859054,48.0246482143919,307.357748572108,25,44.512875631491
transformers_4.23.0,tests/models/rag/test_modeling_rag.py,1190,479,945,6,47,27,56,53,83,276.575451033176,3.57446808510638,1699.36431528573,94.4091286269849,475.417397728746,66,28.1551184910148
transformers_4.23.0,tests/models/rag/test_modeling_tf_rag.py,1077,421,861,4,32,17,37,36,54,168,2.3125,645.594384555109,35.866354697506,279.175950077885,58,29.529186609928
transformers_4.23.0,tests/models/rag/test_tokenization_rag.py,169,70,138,2,6,3,7,8,10,17.5097750043269,1.16666666666667,35,1.94444444444444,30,12,66.2513945765571
transformers_4.23.0,tests/models/megatron_bert/__init__.py,0,0,0,0,0,0,0,0,0,0,0,0,0,0,1,100
transformers_4.23.0,tests/models/megatron_bert/test_modeling_megatron_bert.py,380,196,314,4,16,17,21,20,38,72,2.625,431.112327465014,23.9506848591675,164.23326760572,36,42.825266692128
transformers_4.23.0,tests/models/data2vec/test_modeling_data2vec_audio.py,743,431,538,14,105,73,130,119,203,758.298748263749,8.66666666666667,12130.2827182464,673.904595458136,1399.64800595151,93,25.6982305860924
transformers_4.23.0,tests/models/data2vec/__init__.py,0,0,0,0,0,0,0,0,0,0,0,0,0,0,1,100
transformers_4.23.0,tests/models/data2vec/test_modeling_tf_data2vec_vision.py,495,270,366,12,54,35,65,66,100,353.783475125481,7.22222222222222,4365.39575286999,242.521986270555,604.439411935845,60,38.6630670430457
transformers_4.23.0,tests/models/data2vec/test_modeling_data2vec_text.py,506,233,403,4,31,34,51,35,85,161.580085621993,3.29032258064516,1434.54463731977,79.6969242955428,435.989056440322,39,41.1861211030938
transformers_4.23.0,tests/models/data2vec/test_modeling_data2vec_vision.py,351,199,260,11,35,23,42,46,65,217.578653398084,6.6,2369.60807914846,131.644893286025,359.031527143706,46,44.697433249402
transformers_4.23.0,tests/models/luke/test_tokenization_luke.py,668,333,506,3,15,508,513,18,1021,63.3582464362913,51.3,218409.412778044,12133.8562654469,4257.4934264726,29,33.8349462265578
transformers_4.23.0,tests/models/luke/__init__.py,0,0,0,0,0,0,0,0,0,0,0,0,0,0,1,100
transformers_4.23.0,tests/models/luke/test_modeling_luke.py,908,364,776,7,32,47,61,39,108,179.651484454403,6.671875,3808.46263632893,211.581257573829,570.823439637123,60,28.1627391989024
transformers_4.23.0,tests/models/bloom/test_tokenization_bloom.py,136,67,78,0,0,0,0,0,0,0,0,0,0,0,9,100
transformers_4.23.0,tests/models/bloom/__init__.py,0,0,0,0,0,0,0,0,0,0,0,0,0,0,1,100
transformers_4.23.0,tests/models/bloom/test_modeling_bloom.py,794,361,593,9,79,110,126,88,236,526.528004118972,7.17721518987342,10941.1324525708,607.84069180949,1524.4258619984,52,35.094866908788
transformers_4.23.0,tests/models/vision_encoder_decoder/test_modeling_flax_vision_encoder_decoder.py,521,263,384,9,49,44,65,58,109,303.650107374626,5.96938775510204,3811.57304239091,211.754057910606,638.519928468905,43,38.4745856144754
transformers_4.23.0,tests/models/vision_encoder_decoder/test_modeling_vision_encoder_decoder.py,1002,491,786,8,88,96,122,96,218,592.429982440082,5.54545454545455,7960.62103041727,442.25672391207,1435.52182515721,52,28.1539085059993
transformers_4.23.0,tests/models/vision_encoder_decoder/__init__.py,0,0,0,0,0,0,0,0,0,0,0,0,0,0,1,100
transformers_4.23.0,tests/models/vision_encoder_decoder/test_modeling_tf_vision_encoder_decoder.py,991,472,701,11,79,63,100,90,163,536.052426911001,6.9620253164557,7367.02063399943,409.27892411108,1058.17205470174,78,30.4557766305481
transformers_4.23.0,tests/models/dpt/test_feature_extraction_dpt.py,188,69,135,0,0,0,0,0,0,0,0,0,0,0,15,100
transformers_4.23.0,tests/models/dpt/__init__.py,0,0,0,0,0,0,0,0,0,0,0,0,0,0,1,100
transformers_4.23.0,tests/models/dpt/test_modeling_dpt.py,321,195,229,8,21,11,21,29,32,116.238665878354,4,621.821567376329,34.5456426320183,155.455391844082,37,48.5193274194595
transformers_4.23.0,tests/models/deberta_v2/test_modeling_deberta_v2.py,308,161,252,1,6,11,11,7,22,15.5097750043269,0.916666666666667,56.6149909281617,3.14527727378676,61.7618082852673,29,49.5812658039106
transformers_4.23.0,tests/models/deberta_v2/__init__.py,0,0,0,0,0,0,0,0,0,0,0,0,0,0,1,100
transformers_4.23.0,tests/models/deberta_v2/test_modeling_tf_deberta_v2.py,278,135,222,1,5,5,5,6,10,11.6096404744368,0.5,12.9248125036058,0.71804513908921,25.8496250072116,24,54.9483672599128
transformers_4.23.0,tests/models/deberta_v2/test_tokenization_deberta_v2.py,250,150,155,2,12,7,13,14,20,45.0195500086539,1.08333333333333,82.4926899779148,4.58292722099526,76.1470984411521,16,60.8418818935568
transformers_4.23.0,tests/models/yoso/__init__.py,0,0,0,0,0,0,0,0,0,0,0,0,0,0,1,100
transformers_4.23.0,tests/models/yoso/test_modeling_yoso.py,405,202,329,1,20,25,25,21,50,86.4385618977473,0.625,137.259919461836,7.62555108121313,219.615871138938,35,40.7282361896379
transformers_4.23.0,tests/models/poolformer/test_modeling_poolformer.py,253,147,178,4,11,9,13,15,22,46.0537478050103,2.36363636363636,203.158310971643,11.2865728317579,85.9515931033874,27,54.2618571016134
transformers_4.23.0,tests/models/poolformer/test_feature_extraction_poolformer.py,193,72,139,0,0,0,0,0,0,0,0,0,0,0,16,100
transformers_4.23.0,tests/models/poolformer/__init__.py,0,0,0,0,0,0,0,0,0,0,0,0,0,0,1,100
transformers_4.23.0,tests/models/opt/__init__.py,0,0,0,0,0,0,0,0,0,0,0,0,0,0,1,100
transformers_4.23.0,tests/models/opt/test_modeling_flax_opt.py,406,179,285,7,68,74,94,75,168,433.598957659426,4.83823529411765,5062.93039207483,281.273910670824,1046.44154000331,26,48.3585862960742
transformers_4.23.0,tests/models/opt/test_modeling_opt.py,492,272,376,8,62,60,74,70,134,393.160171243986,4.7741935483871,3921.15938038879,217.842187799377,821.323924270626,43,36.6140704374065
transformers_4.23.0,tests/models/opt/test_modeling_tf_opt.py,415,230,307,9,71,66,88,80,154,465.161370497813,5.57746478873239,5430.09102730438,301.671723739132,973.576926612654,38,39.3037239444338
transformers_4.23.0,tests/models/wav2vec2_conformer/__init__.py,0,0,0,0,0,0,0,0,0,0,0,0,0,0,1,100
transformers_4.23.0,tests/models/wav2vec2_conformer/test_modeling_wav2vec2_conformer.py,939,526,679,15,154,112,196,169,308,1177.68848620114,9.54545454545455,21758.5855426696,1208.81030792609,2279.47086637491,107,21.1134773784712
transformers_4.23.0,tests/models/bigbird_pegasus/test_modeling_bigbird_pegasus.py,789,407,596,11,107,92,138,118,230,759.390715349933,7.09345794392523,11228.9999731504,623.833331841691,1583.00790135322,62,30.2006896372217
transformers_4.23.0,tests/models/bigbird_pegasus/__init__.py,0,0,0,0,0,0,0,0,0,0,0,0,0,0,1,100
transformers_4.23.0,tests/models/deit/test_modeling_tf_deit.py,282,149,199,7,13,8,14,20,22,67.7572007902374,3.76923076923077,358.387575868352,19.9104208815751,95.082418087522,31,54.4829016403758
transformers_4.23.0,tests/models/deit/__init__.py,0,0,0,0,0,0,0,0,0,0,0,0,0,0,1,100
transformers_4.23.0,tests/models/deit/test_modeling_deit.py,396,217,291,11,38,22,39,49,61,237.474993315867,5.64473684210526,1933.3071304033,107.405951689072,342.497300491028,50,43.1069532737484
transformers_4.23.0,tests/models/deit/test_feature_extraction_deit.py,199,75,145,0,0,0,0,0,0,0,0,0,0,0,16,100
transformers_4.23.0,tests/models/whisper/test_processor_whisper.py,118,67,69,0,0,0,0,0,0,0,0,0,0,0,13,100
transformers_4.23.0,tests/models/whisper/test_tokenization_whisper.py,190,97,126,3,6,4,7,9,11,20.2646625064904,1.75,61.0210562777645,3.39005868209803,34.8691750158654,17,67.2083331974644
transformers_4.23.0,tests/models/whisper/__init__.py,0,0,0,0,0,0,0,0,0,0,0,0,0,0,1,100
transformers_4.23.0,tests/models/whisper/test_feature_extraction_whisper.py,225,133,157,7,42,34,45,49,79,246.128816211111,3.75,1663.35779131913,92.4087661843961,443.562077685102,32,52.0131569573077
transformers_4.23.0,tests/models/whisper/test_modeling_whisper.py,1042,554,777,14,141,127,187,155,314,1059.97970959704,9.28368794326241,21210.4702822855,1178.35946012697,2284.70306325611,87,23.1621151368926
transformers_4.23.0,tests/models/whisper/test_modeling_tf_whisper.py,983,490,714,14,121,104,140,135,244,890.485420619032,8.09917355371901,13985.191285676,776.955071426444,1726.7430056804,69,28.5370127792992
transformers_4.23.0,tests/models/splinter/__init__.py,0,0,0,0,0,0,0,0,0,0,0,0,0,0,1,100
transformers_4.23.0,tests/models/splinter/test_modeling_splinter.py,493,234,390,2,5,5,8,7,13,13.6096404744368,1.6,58.3929823787982,3.2440545765999,36.4956139867489,42,49.5475005815673
transformers_4.23.0,tests/models/nllb/__init__.py,0,0,0,0,0,0,0,0,0,0,0,0,0,0,1,100
transformers_4.23.0,tests/models/nllb/test_tokenization_nllb.py,428,180,331,6,24,31,58,30,89,125.548875021635,7.25,3166.1711568164,175.898397600911,436.713263009158,34,45.9880542945891
transformers_4.23.0,tests/models/visual_bert/test_modeling_visual_bert.py,690,373,548,8,91,88,131,99,219,616.209312258081,5.75824175824176,8359.98294828413,464.443497126896,1451.82909979743,75,23.4671048797254
transformers_4.23.0,tests/models/visual_bert/__init__.py,0,0,0,0,0,0,0,0,0,0,0,0,0,0,1,100
transformers_4.23.0,tests/models/distilbert/test_modeling_distilbert.py,293,163,237,2,6,8,9,8,17,17.5097750043269,1.5,76.5,4.25,51,29,50.4477342248719
transformers_4.23.0,tests/models/distilbert/__init__.py,0,0,0,0,0,0,0,0,0,0,0,0,0,0,1,100
transformers_4.23.0,tests/models/distilbert/test_tokenization_distilbert.py,43,17,19,2,15,8,16,17,24,60.6033589341278,1.06666666666667,104.639048736009,5.81328048533382,98.0991081900082,4,87.2856935820907
transformers_4.23.0,tests/models/distilbert/test_modeling_tf_distilbert.py,247,141,192,1,3,3,3,4,6,4.75488750216347,0.5,6,0.333333333333333,12,25,57.717992807654
transformers_4.23.0,tests/models/distilbert/test_modeling_flax_distilbert.py,152,67,118,1,3,3,3,4,6,4.75488750216347,0.5,6,0.333333333333333,12,11,69.6917336443761
transformers_4.23.0,tests/models/xlnet/test_modeling_tf_xlnet.py,504,211,383,8,43,28,52,51,80,257.32938445219,4.83720930232558,2195.09669047455,121.949816137475,453.79402735772,44,45.7390495904191
transformers_4.23.0,tests/models/xlnet/test_modeling_xlnet.py,716,283,574,10,70,53,100,80,153,462.269092135021,7.14285714285714,6908.9642751269,383.831348618161,967.254998517766,62,35.1693698380877
transformers_4.23.0,tests/models/xlnet/test_tokenization_xlnet.py,212,65,166,3,41,43,85,44,128,224.414519691505,3.10975609756098,2173.12009795514,120.728894330841,698.807247185574,12,57.3613815434146
transformers_4.23.0,tests/models/xlnet/__init__.py,0,0,0,0,0,0,0,0,0,0,0,0,0,0,1,100
transformers_4.23.0,tests/models/time_series_transformer/test_modeling_time_series_transformer.py,438,220,345,5,33,31,46,38,77,178.074646413266,3.48484848484848,1408.19388277403,78.232993487446,404.090418535156,31,41.6785821131187
transformers_4.23.0,tests/models/time_series_transformer/__init__.py,0,0,0,0,0,0,0,0,0,0,0,0,0,0,1,100
transformers_4.23.0,tests/models/deformable_detr/test_modeling_deformable_detr.py,625,373,476,12,79,62,96,91,158,541.018229114645,7.29113924050633,7496.9794255089,416.498856972717,1028.23155315139,60,30.1174866592314
transformers_4.23.0,tests/models/deformable_detr/test_feature_extraction_deformable_detr.py,341,180,229,5,6,7,13,11,20,27.1194154787637,5.41666666666667,374.771758685707,20.8206532603171,69.188632372746,26,59.2685028494106
transformers_4.23.0,tests/models/deformable_detr/__init__.py,0,0,0,0,0,0,0,0,0,0,0,0,0,0,1,100
transformers_4.23.0,tests/models/groupvit/test_modeling_groupvit.py,696,431,525,13,34,21,39,47,60,221.079452938346,7.45588235294118,2484.86165982403,138.047869990224,333.275331100658,87,28.634086418841
transformers_4.23.0,tests/models/groupvit/__init__.py,0,0,0,0,0,0,0,0,0,0,0,0,0,0,1,100
transformers_4.23.0,tests/models/groupvit/test_modeling_tf_groupvit.py,715,408,524,12,49,35,61,61,96,318.140332370299,7.46938775510204,4252.7017774002,236.261209855566,569.350784406037,84,31.1909555812557
transformers_4.23.0,tests/models/ernie/test_modeling_ernie.py,577,253,488,3,9,13,16,12,29,33.2842125151443,2.66666666666667,277.237100055769,15.4020611142094,103.963912520914,49,40.0815632645032
transformers_4.23.0,tests/models/ernie/__init__.py,0,0,0,0,0,0,0,0,0,0,0,0,0,0,1,100
transformers_4.23.0,tests/models/yolos/test_modeling_yolos.py,371,217,269,7,32,24,36,39,60,179.651484454403,3.9375,1248.67627420621,69.370904122567,317.124133131735,35,45.9741046090269
transformers_4.23.0,tests/models/yolos/__init__.py,0,0,0,0,0,0,0,0,0,0,0,0,0,0,1,100
transformers_4.23.0,tests/models/yolos/test_feature_extraction_yolos.py,338,179,226,5,6,7,13,11,20,27.1194154787637,5.41666666666667,374.771758685707,20.8206532603171,69.188632372746,26,59.4242769887107
transformers_4.23.0,tests/models/xlm_prophetnet/test_tokenization_xlm_prophetnet.py,156,53,114,2,14,23,43,16,66,55.3029689088065,3.07142857142857,810.857142857143,45.0476190476191,264,11,65.3965222519422
transformers_4.23.0,tests/models/xlm_prophetnet/__init__.py,0,0,0,0,0,0,0,0,0,0,0,0,0,0,1,100
transformers_4.23.0,tests/models/xlm_prophetnet/test_modeling_xlm_prophetnet.py,153,70,115,1,21,21,21,22,42,92.238665878354,0.5,93.6480639913832,5.20267022174351,187.296127982766,7,64.2713034671368
transformers_4.23.0,tests/models/wav2vec2_with_lm/test_processor_wav2vec2_with_lm.py,454,265,315,6,24,20,30,30,50,125.548875021635,3.75,920.041986676597,51.1134437042554,245.344529780426,38,43.4678478049126
transformers_4.23.0,tests/models/wav2vec2_with_lm/__init__.py,0,0,0,0,0,0,0,0,0,0,0,0,0,0,1,100
transformers_4.23.0,tests/models/funnel/test_modeling_tf_funnel.py,412,193,338,2,5,3,5,7,8,13.6096404744368,1,22.4588393764608,1.24771329869227,22.4588393764608,35,50.4122725154506
transformers_4.23.0,tests/models/funnel/__init__.py,0,0,0,0,0,0,0,0,0,0,0,0,0,0,1,100
transformers_4.23.0,tests/models/funnel/test_tokenization_funnel.py,83,39,53,3,14,8,16,17,24,58.0578564109699,1.71428571428571,168.1698997543,9.34277220857221,98.0991081900082,9,75.7144056765841
transformers_4.23.0,tests/models/funnel/test_modeling_funnel.py,512,252,425,9,51,36,65,60,101,317.823017453527,5.73529411764706,3421.65324354441,190.091846863578,596.59595015646,58,34.2022656733342
transformers_4.23.0,tests/models/flava/test_feature_extraction_flava.py,347,144,267,3,8,7,11,11,18,28.7548875021635,2.0625,128.43139884191,7.13507771343943,62.2697691354714,27,55.6940114582177
transformers_4.23.0,tests/models/flava/__init__.py,0,0,0,0,0,0,0,0,0,0,0,0,0,0,1,100
transformers_4.23.0,tests/models/flava/test_processor_flava.py,234,115,157,2,3,2,3,5,5,6.75488750216347,1,11.6096404744368,0.644980026357601,11.6096404744368,19,65.134231745844
transformers_4.23.0,tests/models/flava/test_modeling_flava.py,1228,685,959,16,85,58,107,101,165,608.798229571705,10.0705882352941,11063.5975273396,614.644307074421,1098.60489465405,152,11.8335589982974
transformers_4.23.0,tests/models/bart/test_modeling_tf_bart.py,924,225,835,7,48,37,59,55,96,287.729684489019,4.30208333333333,2387.70156168568,132.650086760316,555.010532498367,49,32.9450373301511
transformers_4.23.0,tests/models/bart/test_modeling_bart.py,1422,503,1229,12,70,61,94,82,155,472.069361194802,8.05714285714286,7939.67423205304,441.093012891836,985.420560715803,86,20.2949398747876
transformers_4.23.0,tests/models/bart/test_tokenization_bart.py,183,108,138,5,15,10,18,20,28,70.2129994085646,3,363.041959970538,20.168997776141,121.013986656846,20,58.6996144109001
transformers_4.23.0,tests/models/bart/__init__.py,0,0,0,0,0,0,0,0,0,0,0,0,0,0,1,100
transformers_4.23.0,tests/models/bart/test_modeling_flax_bart.py,764,257,661,7,45,43,70,52,113,266.784873789239,5.44444444444444,3507.03719103858,194.835399502143,644.149688149944,43,32.7695079786315
transformers_4.23.0,tests/models/gptj/test_modeling_flax_gptj.py,328,199,246,4,28,41,59,32,100,142.605937817613,4.21428571428571,2107.14285714286,117.063492063492,500,31,44.4155522518272
transformers_4.23.0,tests/models/gptj/__init__.py,0,0,0,0,0,0,0,0,0,0,0,0,0,0,1,100
transformers_4.23.0,tests/models/gptj/test_modeling_tf_gptj.py,446,251,322,7,30,33,51,37,84,166.858202322659,5.95,2603.68479214135,144.649155118964,437.594082712832,39,44.1849786625407
transformers_4.23.0,tests/models/gptj/test_modeling_gptj.py,574,307,434,7,37,42,67,44,109,212.401258982674,6.33783783783784,3771.50815913996,209.528231063331,595.078046431465,41,38.7253396105894
transformers_4.23.0,tests/models/longt5/__init__.py,0,0,0,0,0,0,0,0,0,0,0,0,0,0,1,100
transformers_4.23.0,tests/models/longt5/test_modeling_longt5.py,1319,643,1074,11,86,108,174,97,282,590.712516709391,11.1279069767442,20710.9869578187,1150.61038654548,1861.17542149677,113,16.051004012173
transformers_4.23.0,tests/models/longt5/test_modeling_flax_longt5.py,757,387,591,8,53,46,78,61,124,327.57978409185,5.88679245283019,4329.21445501194,240.51191416733,735.411429857798,64,31.447083780546
transformers_4.23.0,tests/models/prophetnet/test_tokenization_prophetnet.py,206,106,144,2,13,7,14,15,21,50.1057163358342,1.07692307692308,88.3558334699157,4.90865741499532,82.0447025077789,23,56.9284967272063
transformers_4.23.0,tests/models/prophetnet/__init__.py,0,0,0,0,0,0,0,0,0,0,0,0,0,0,1,100
transformers_4.23.0,tests/models/prophetnet/test_modeling_prophetnet.py,1304,596,1070,10,65,69,98,75,167,424.673188795723,7.53846153846154,7841.60359143504,435.644643968614,1040.21272131281,92,20.8370326999592
transformers_4.23.0,tests/models/regnet/__init__.py,0,0,0,0,0,0,0,0,0,0,0,0,0,0,1,100
transformers_4.23.0,tests/models/regnet/test_modeling_regnet.py,274,161,192,4,14,12,19,18,31,61.3029689088065,2.71428571428571,350.869403692789,19.4927446495994,129.267675044712,33,52.5187362580397
transformers_4.23.0,tests/models/regnet/test_modeling_tf_regnet.py,289,170,202,5,13,12,19,18,31,59.715356810271,3.65384615384615,472.324197278754,26.240233182153,129.267675044712,31,52.1799218040527
transformers_4.23.0,tests/models/wav2vec2_phoneme/__init__.py,0,0,0,0,0,0,0,0,0,0,0,0,0,0,1,100
transformers_4.23.0,tests/models/wav2vec2_phoneme/test_tokenization_wav2vec2_phoneme.py,411,237,281,10,40,31,58,50,89,246.096404744368,7.25,3641.69820645214,202.316567025119,502.303200889951,44,45.284523812526
transformers_4.23.0,tests/models/rembert/test_modeling_tf_rembert.py,713,318,537,5,30,35,43,35,78,158.816358342692,3.58333333333333,1433.63460323612,79.646366846451,400.084075321707,42,39.2606666598792
transformers_4.23.0,tests/models/rembert/__init__.py,0,0,0,0,0,0,0,0,0,0,0,0,0,0,1,100
transformers_4.23.0,tests/models/rembert/test_modeling_rembert.py,498,207,406,2,17,23,24,19,47,71.4868683012558,1.41176470588235,281.862484421433,15.6590269123018,199.652593131849,36,44.3726272682238
transformers_4.23.0,tests/models/roformer/test_modeling_roformer.py,558,233,463,4,70,73,82,74,155,437.049811186148,2.34285714285714,2254.91863648983,125.273257582768,962.465271672487,38,35.3865651335957
transformers_4.23.0,tests/models/roformer/test_modeling_flax_roformer.py,163,71,124,1,6,6,6,7,12,15.5097750043269,0.5,16.8441295323456,0.935784974019201,33.6882590646913,12,65.4856896708118
transformers_4.23.0,tests/models/roformer/__init__.py,0,0,0,0,0,0,0,0,0,0,0,0,0,0,1,100
transformers_4.23.0,tests/models/roformer/test_tokenization_roformer.py,77,43,43,1,4,2,4,5,6,8,0.5,6.96578428466209,0.38698801581456,13.9315685693242,10,83.2086861918228
transformers_4.23.0,tests/models/roformer/test_modeling_tf_roformer.py,401,190,320,3,65,62,70,68,132,396.208795349013,1.61538461538462,1298.03438430353,72.1130213501963,803.545095045045,30,39.3551283138475
transformers_4.23.0,tests/models/canine/__init__.py,0,0,0,0,0,0,0,0,0,0,0,0,0,0,1,100
transformers_4.23.0,tests/models/canine/test_modeling_canine.py,536,314,414,10,37,41,58,47,99,225.969055477145,7.83783783783784,4310.06070085581,239.447816714212,549.904296316086,40,38.5216910438027
transformers_4.23.0,tests/models/canine/test_tokenization_canine.py,343,212,230,2,8,7,14,10,21,26,1.75,122.080857487111,6.78226986039503,69.7604899926346,35,54.8384813723974
transformers_4.23.0,tests/models/hubert/test_modeling_hubert.py,935,561,687,14,132,109,175,146,284,983.162992664122,9.28030303030303,18949.5451820785,1052.75251011547,2041.91017472192,129,16.9062949842939
transformers_4.23.0,tests/models/hubert/__init__.py,0,0,0,0,0,0,0,0,0,0,0,0,0,0,1,100
transformers_4.23.0,tests/models/hubert/test_modeling_tf_hubert.py,554,325,391,9,61,43,74,70,117,390.304302604317,5.45901639344262,3914.80320693759,217.489067052088,717.126112982561,63,34.7280470169518
transformers_4.23.0,tests/models/lxmert/test_modeling_tf_lxmert.py,695,317,592,7,37,38,55,44,93,212.401258982674,5.2027027027027,2641.55336628795,146.752964793775,507.727140533269,65,29.1259795249822
transformers_4.23.0,tests/models/lxmert/__init__.py,0,0,0,0,0,0,0,0,0,0,0,0,0,0,1,100
transformers_4.23.0,tests/models/lxmert/test_modeling_lxmert.py,787,336,674,8,35,39,56,43,95,203.524905593074,6.4,3299.16897085888,183.287165047715,515.495151696699,57,29.1536847817853
transformers_4.23.0,tests/models/lxmert/test_tokenization_lxmert.py,89,43,57,2,3,2,3,5,5,6.75488750216347,1,11.6096404744368,0.644980026357601,11.6096404744368,7,80.9907862206158
transformers_4.23.0,tests/models/blenderbot_small/test_modeling_tf_blenderbot_small.py,337,190,255,9,45,35,65,54,100,275.662714347816,6.5,3740.67687640626,207.81538202257,575.488750216347,50,42.2056798810529
transformers_4.23.0,tests/models/blenderbot_small/test_modeling_blenderbot_small.py,547,281,416,10,50,42,70,60,112,315.41209043761,7,4631.00222695708,257.277901497616,661.571746708154,53,36.8434950832949
transformers_4.23.0,tests/models/blenderbot_small/__init__.py,0,0,0,0,0,0,0,0,0,0,0,0,0,0,1,100
transformers_4.23.0,tests/models/blenderbot_small/test_tokenization_blenderbot_small.py,87,53,54,4,14,8,15,18,23,61.3029689088065,2.14285714285714,205.517732213943,11.4176517896635,95.9082750331732,11,73.4486972401928
transformers_4.23.0,tests/models/blenderbot_small/test_modeling_flax_blenderbot_small.py,398,181,322,6,39,40,64,45,104,221.640461539955,4.92307692307692,2811.82878532079,156.2127102956,571.152722018286,31,41.7161038985193
transformers_4.23.0,tests/models/gpt_neox/__init__.py,0,0,0,0,0,0,0,0,0,0,0,0,0,0,1,100
transformers_4.23.0,tests/models/gpt_neox/test_modeling_gpt_neox.py,230,128,166,2,4,5,6,6,11,10,1.5,42.6518812618991,2.36954895899439,28.4345875079327,23,60.0232741796294
transformers_4.23.0,tests/models/electra/test_modeling_tf_electra.py,602,303,447,5,19,24,32,24,56,92.3202632298649,4.21052631578947,1081.08589490688,60.0603274948269,256.757900040385,41,41.1815518957419
transformers_4.23.0,tests/models/electra/test_modeling_flax_electra.py,137,61,118,1,2,1,2,3,3,2,0.5,2.37744375108173,0.13208020839343,4.75488750216347,12,54.6994991863665
transformers_4.23.0,tests/models/electra/__init__.py,0,0,0,0,0,0,0,0,0,0,0,0,0,0,1,100
transformers_4.23.0,tests/models/electra/test_modeling_electra.py,455,198,390,2,6,10,11,8,21,17.5097750043269,1.83333333333333,115.5,6.41666666666667,63,39,43.613779153169
transformers_4.23.0,tests/models/auto/test_modeling_tf_auto.py,307,177,239,1,3,2,4,4,6,4.75488750216347,0.666666666666667,8,0.444444444444444,12,32,56.2971328859911
transformers_4.23.0,tests/models/auto/test_processor_auto.py,317,190,221,3,9,7,14,12,21,33.2842125151443,2.33333333333333,175.663162535337,9.75906458529648,75.2842125151443,28,54.3740392766756
transformers_4.23.0,tests/models/auto/__init__.py,0,0,0,0,0,0,0,0,0,0,0,0,0,0,1,100
transformers_4.23.0,tests/models/auto/test_tokenization_auto.py,353,216,255,4,13,8,16,17,24,56.1057163358342,2.46153846153846,241.474727852328,13.4152626584627,98.0991081900082,42,50.2374836727679
transformers_4.23.0,tests/models/auto/test_feature_extraction_auto.py,123,63,79,3,7,4,8,10,12,24.4063719565667,1.71428571428571,68.3368065233972,3.79648925129984,39.8631371386484,12,73.5535426393829
transformers_4.23.0,tests/models/auto/test_configuration_auto.py,112,66,73,2,4,2,4,6,6,10,1,15.5097750043269,0.861654166907052,15.5097750043269,13,75.6894632156235
transformers_4.23.0,tests/models/auto/test_modeling_auto.py,374,226,295,2,8,5,10,10,15,26,1.25,62.2861517791381,3.46034176550767,49.8289214233104,42,47.4052489520698
transformers_4.23.0,tests/models/auto/test_modeling_tf_pytorch.py,235,132,182,0,0,0,0,0,0,0,0,0,0,0,21,100
transformers_4.23.0,tests/models/auto/test_modeling_flax_auto.py,101,62,69,0,0,0,0,0,0,0,0,0,0,0,14,100
transformers_4.23.0,tests/models/van/__init__.py,0,0,0,0,0,0,0,0,0,0,0,0,0,0,1,100
transformers_4.23.0,tests/models/van/test_modeling_van.py,276,166,190,6,23,16,28,29,44,119.551699993638,3.65217391304348,780.6564242605,43.3698013478056,213.751163785613,33,51.404749369434
transformers_4.23.0,tests/models/fsmt/test_modeling_fsmt.py,540,300,429,9,43,31,50,52,81,261.858709465171,5.23255813953488,2416.05846193306,134.225470107392,461.735617169429,57,36.5519351754261
transformers_4.23.0,tests/models/fsmt/__init__.py,0,0,0,0,0,0,0,0,0,0,0,0,0,0,1,100
transformers_4.23.0,tests/models/fsmt/test_tokenization_fsmt.py,168,84,113,2,13,7,14,15,21,50.1057163358342,1.07692307692308,88.3558334699157,4.90865741499532,82.0447025077789,14,66.6062741809119
transformers_4.23.0,tests/models/bert/test_modeling_bert.py,625,291,527,3,13,17,20,16,37,52.8606038379977,2.30769230769231,341.538461538461,18.974358974359,148,52,36.815034199914
transformers_4.23.0,tests/models/bert/test_modeling_tf_bert.py,771,374,593,7,32,33,46,39,79,179.651484454403,5.03125,2100.7822131784,116.710122954356,417.546775290118,62,32.9845199737971
transformers_4.23.0,tests/models/bert/__init__.py,0,0,0,0,0,0,0,0,0,0,0,0,0,0,1,100
transformers_4.23.0,tests/models/bert/test_tokenization_bert_tf.py,100,69,78,4,12,7,13,16,20,51.0195500086539,2.16666666666667,173.333333333333,9.62962962962963,80,24,56.5561816428704
transformers_4.23.0,tests/models/bert/test_tokenization_bert.py,338,166,248,4,21,12,22,25,34,100.238665878354,2.0952380952381,330.81946951919,18.3788594177328,157.891110452341,37,46.6891019890887
transformers_4.23.0,tests/models/bert/test_modeling_flax_bert.py,164,63,126,0,0,0,0,0,0,0,0,0,0,0,11,100
transformers_4.23.0,tests/models/xlm/test_modeling_tf_xlm.py,367,152,306,2,4,2,4,6,6,10,1,15.5097750043269,0.861654166907052,15.5097750043269,27,54.8724116746332
transformers_4.23.0,tests/models/xlm/__init__.py,0,0,0,0,0,0,0,0,0,0,0,0,0,0,1,100
transformers_4.23.0,tests/models/xlm/test_modeling_xlm.py,488,202,410,5,34,27,48,39,75,184.583377076948,3.52941176470588,1399.07705793412,77.7265032185625,396.405166414669,41,40.0566176542804
transformers_4.23.0,tests/models/xlm/test_tokenization_xlm.py,98,43,64,2,17,9,18,19,27,71.4868683012558,1.05882352941176,121.440751266681,6.74670840370452,114.694042862977,7,73.6590373246785
transformers_4.23.0,tests/models/vilt/__init__.py,0,0,0,0,0,0,0,0,0,0,0,0,0,0,1,100
transformers_4.23.0,tests/models/vilt/test_feature_extraction_vilt.py,251,119,176,7,18,17,33,25,50,94.7101344803648,6.41666666666667,1489.90386088606,82.7724367158921,232.192809488736,24,57.784296225539
transformers_4.23.0,tests/models/vilt/test_modeling_vilt.py,646,357,493,10,50,42,66,60,108,315.41209043761,6.6,4210.43161654975,233.912867586097,637.94418432572,65,33.0666853870152
transformers_4.23.0,tests/models/bartpho/__init__.py,0,0,0,0,0,0,0,0,0,0,0,0,0,0,1,100
transformers_4.23.0,tests/models/bartpho/test_tokenization_bartpho.py,67,38,37,1,2,1,2,3,3,2,0.5,2.37744375108173,0.13208020839343,4.75488750216347,6,87.5310320619114
transformers_4.23.0,tests/models/layoutxlm/test_processor_layoutxlm.py,461,239,292,2,4,8,9,6,17,10,2.25,98.8748156525842,5.49304531403246,43.9443625122597,25,59.0090319290123
transformers_4.23.0,tests/models/layoutxlm/__init__.py,0,0,0,0,0,0,0,0,0,0,0,0,0,0,1,100
transformers_4.23.0,tests/models/layoutxlm/test_tokenization_layoutxlm.py,1948,1044,1399,15,206,224,368,221,592,1642.02246753387,13.3980582524272,61770.9211157323,3431.7178397629,4610.43831515973,217,0
transformers_4.23.0,tests/models/markuplm/test_tokenization_markuplm.py,2306,1256,1729,18,320,332,567,338,899,2738.07564038992,15.946875,120437.029060156,6690.94605889754,7552.39061321768,232,0
transformers_4.23.0,tests/models/markuplm/__init__.py,0,0,0,0,0,0,0,0,0,0,0,0,0,0,1,100
transformers_4.23.0,tests/models/markuplm/test_processor_markuplm.py,451,228,292,2,5,22,24,7,46,13.6096404744368,4.8,619.863966790319,34.4368870439066,129.13832641465,25,55.6823142236471
transformers_4.23.0,tests/models/markuplm/test_feature_extraction_markuplm.py,114,39,65,1,4,2,4,5,6,8,0.5,6.96578428466209,0.38698801581456,13.9315685693242,8,82.8878701257286
transformers_4.23.0,tests/models/markuplm/test_modeling_markuplm.py,364,138,297,1,5,5,5,6,10,11.6096404744368,0.5,12.9248125036058,0.71804513908921,25.8496250072116,22,54.7486753397098
transformers_4.23.0,tests/models/layoutlmv2/__init__.py,0,0,0,0,0,0,0,0,0,0,0,0,0,0,1,100
transformers_4.23.0,tests/models/layoutlmv2/test_feature_extraction_layoutlmv2.py,221,84,150,0,0,0,0,0,0,0,0,0,0,0,17,100
transformers_4.23.0,tests/models/layoutlmv2/test_tokenization_layoutlmv2.py,2483,1321,1870,18,324,327,563,342,890,2777.17005096058,15.6388888888889,117164.815545385,6509.15641918808,7491.88873824845,258,0
transformers_4.23.0,tests/models/layoutlmv2/test_processor_layoutlmv2.py,466,241,298,2,5,9,11,7,20,13.6096404744368,2.2,123.523616570535,6.86242314280748,56.1470984411521,26,57.8017267444355
transformers_4.23.0,tests/models/layoutlmv2/test_modeling_layoutlmv2.py,544,272,423,9,46,29,49,55,78,282.613174991603,4.79347826086957,2161.60012419371,120.088895788539,450.946057654924,47,39.7499772554245
transformers_4.23.0,tests/models/camembert/__init__.py,0,0,0,0,0,0,0,0,0,0,0,0,0,0,1,100
transformers_4.23.0,tests/models/camembert/test_tokenization_camembert.py,130,69,78,2,2,2,2,4,4,4,1,8,0.444444444444444,8,10,78.283594041642
transformers_4.23.0,tests/models/camembert/test_modeling_tf_camembert.py,54,21,26,1,5,5,5,6,10,11.6096404744368,0.5,12.9248125036058,0.71804513908921,25.8496250072116,3,89.5175111163942
transformers_4.23.0,tests/models/camembert/test_modeling_camembert.py,55,21,28,1,5,5,5,6,10,11.6096404744368,0.5,12.9248125036058,0.71804513908921,25.8496250072116,3,89.8330492203084
transformers_4.23.0,tests/models/perceiver/test_modeling_perceiver.py,1002,611,757,15,128,107,174,143,281,954.603358934128,10.1953125,20512.1923324478,1139.56624069154,2011.92384563473,95,19.8856887639193
transformers_4.23.0,tests/models/perceiver/__init__.py,0,0,0,0,0,0,0,0,0,0,0,0,0,0,1,100
transformers_4.23.0,tests/models/perceiver/test_tokenization_perceiver.py,298,176,201,8,31,20,41,39,61,177.580085621993,5.29032258064516,1705.65044508058,94.7583580600321,322.409535350597,40,52.1831533064501
transformers_4.23.0,tests/models/videomae/test_feature_extraction_videomae.py,202,75,148,0,0,0,0,0,0,0,0,0,0,0,16,100
transformers_4.23.0,tests/models/videomae/__init__.py,0,0,0,0,0,0,0,0,0,0,0,0,0,0,1,100
transformers_4.23.0,tests/models/videomae/test_modeling_videomae.py,423,239,303,11,46,28,48,57,76,292.137597783633,5.73913043478261,2544.15446183046,141.341914546137,443.29964107652,37,44.3980209955044
transformers_4.23.0,tests/models/layoutlmv3/test_feature_extraction_layoutlmv3.py,213,84,142,0,0,0,0,0,0,0,0,0,0,0,17,100
transformers_4.23.0,tests/models/layoutlmv3/__init__.py,0,0,0,0,0,0,0,0,0,0,0,0,0,0,1,100
transformers_4.23.0,tests/models/layoutlmv3/test_modeling_tf_layoutlmv3.py,497,228,396,14,70,45,80,84,125,482.352780094954,8,6392.31742277876,355.128745709931,799.039677847345,55,36.8605468872629
transformers_4.23.0,tests/models/layoutlmv3/test_tokenization_layoutlmv3.py,2445,1304,1831,18,337,335,578,355,913,2904.71446128425,15.4362017804154,119393.455569107,6632.96975383929,7734.63947073994,253,0
transformers_4.23.0,tests/models/layoutlmv3/test_processor_layoutlmv3.py,446,234,284,2,5,9,11,7,20,13.6096404744368,2.2,123.523616570535,6.86242314280748,56.1470984411521,24,58.6145776152908
transformers_4.23.0,tests/models/layoutlmv3/test_modeling_layoutlmv3.py,399,186,323,8,29,22,35,37,57,164.8814488587,4.82758620689655,1433.49785716272,79.6387698423736,296.93884184085,41,42.7172984100039
transformers_4.23.0,tests/models/wav2vec2/test_modeling_tf_wav2vec2.py,591,350,416,9,63,44,76,72,120,405.097960193476,5.42857142857143,4019.26542951099,223.292523861722,740.391000173078,68,32.972879510965
transformers_4.23.0,tests/models/wav2vec2/test_processor_wav2vec2.py,139,78,89,1,3,2,4,4,6,4.75488750216347,0.666666666666667,8,0.444444444444444,12,12,70.3655392396165
transformers_4.23.0,tests/models/wav2vec2/__init__.py,0,0,0,0,0,0,0,0,0,0,0,0,0,0,1,100
transformers_4.23.0,tests/models/wav2vec2/test_feature_extraction_wav2vec2.py,225,143,152,7,26,16,31,33,47,141.862917126072,4.17307692307692,989.380300448786,54.9655722471548,237.086523609847,32,54.151796176988
transformers_4.23.0,tests/models/wav2vec2/test_modeling_flax_wav2vec2.py,549,265,384,12,80,58,105,92,163,548.773797599643,7.875,8373.80721584368,465.211511991316,1063.34059883729,48,39.8411185200168
transformers_4.23.0,tests/models/wav2vec2/test_modeling_wav2vec2.py,1665,916,1215,18,247,199,320,265,519,2038.30535622738,11.6599190283401,48713.6422017601,2706.31345565334,4177.87139716484,179,3.49145782242769
transformers_4.23.0,tests/models/wav2vec2/test_tokenization_wav2vec2.py,766,439,514,11,68,56,103,79,159,452.001221010033,8.33088235294118,8350.05287089603,463.891826160891,1002.30113896016,61,36.2133229840315
transformers_4.23.0,tests/models/tapas/__init__.py,0,0,0,0,0,0,0,0,0,0,0,0,0,0,1,100
transformers_4.23.0,tests/models/tapas/test_modeling_tf_tapas.py,1048,446,847,11,81,127,159,92,286,551.581598038665,10.7962962962963,20143.0680264636,1119.05933480353,1865.73871943231,65,28.6713928926388
transformers_4.23.0,tests/models/tapas/test_modeling_tapas.py,1100,464,889,8,76,125,153,84,278,498.842491021713,8.05263157894737,14310.043645288,795.002424738222,1777.0642435325,68,28.0938097059354
transformers_4.23.0,tests/models/tapas/test_tokenization_tapas.py,1243,690,942,16,147,115,221,163,336,1122.35183469095,12.0272108843537,29697.2602895555,1649.8477938642,2469.17265982164,164,8.49303672134272
transformers_4.23.0,tests/models/mpnet/test_tokenization_mpnet.py,82,36,52,2,19,10,20,21,30,82.7106227554281,1.05263157894737,138.704760719329,7.70582003996274,131.769522683363,8,75.8529576303579
transformers_4.23.0,tests/models/mpnet/test_modeling_tf_mpnet.py,262,141,212,1,6,6,6,7,12,15.5097750043269,0.5,16.8441295323456,0.935784974019201,33.6882590646913,25,53.9031805650444
transformers_4.23.0,tests/models/mpnet/__init__.py,0,0,0,0,0,0,0,0,0,0,0,0,0,0,1,100
transformers_4.23.0,tests/models/mpnet/test_modeling_mpnet.py,251,131,203,1,7,10,10,8,20,19.6514844544032,0.714285714285714,42.8571428571429,2.38095238095238,60,23,53.8819913133028
transformers_4.23.0,tests/models/led/__init__.py,0,0,0,0,0,0,0,0,0,0,0,0,0,0,1,100
transformers_4.23.0,tests/models/led/test_modeling_led.py,556,300,414,11,64,51,83,75,134,422.05374780501,7.1328125,5953.48543931755,330.749191073197,834.661704526448,47,39.0816366935843
transformers_4.23.0,tests/models/led/test_modeling_tf_led.py,431,255,321,11,70,58,97,81,155,467.103558991158,7.62142857142857,7489.40066233624,416.077814574236,982.676750447117,53,38.7518750942023
transformers_4.23.0,tests/models/megatron_gpt2/__init__.py,0,0,0,0,0,0,0,0,0,0,0,0,0,0,1,100
transformers_4.23.0,tests/models/megatron_gpt2/test_modeling_megatron_gpt2.py,85,31,59,4,23,20,24,27,44,112.041924989311,2.08695652173913,436.622713242141,24.2568174023412,209.215050095193,5,75.833150506637
transformers_4.23.0,tests/models/bert_generation/test_tokenization_bert_generation.py,245,75,193,3,16,22,43,19,65,68.7548875021635,4.03125,1113.08975625701,61.8383197920564,276.115288373833,12,57.6833495532247
transformers_4.23.0,tests/models/bert_generation/__init__.py,0,0,0,0,0,0,0,0,0,0,0,0,0,0,1,100
transformers_4.23.0,tests/models/bert_generation/test_modeling_bert_generation.py,333,149,265,2,8,9,10,10,19,26,1.25,78.8957922535749,4.38309956964305,63.1166338028599,26,52.2525807579479
transformers_4.23.0,tests/models/bertweet/__init__.py,0,0,0,0,0,0,0,0,0,0,0,0,0,0,1,100
transformers_4.23.0,tests/models/bertweet/test_tokenization_bertweet.py,65,37,36,1,2,1,2,3,3,2,0.5,2.37744375108173,0.13208020839343,4.75488750216347,6,88.3550357627131
transformers_4.23.0,tests/models/swinv2/__init__.py,0,0,0,0,0,0,0,0,0,0,0,0,0,0,1,100
transformers_4.23.0,tests/models/swinv2/test_modeling_swinv2.py,430,248,331,12,57,34,63,69,97,375.494280816044,6.63157894736842,3929.38873214436,218.29937400802,592.526872307483,46,37.6468684209258
transformers_4.23.0,tests/models/swin/test_modeling_swin.py,453,257,348,12,56,34,61,68,95,368.23142564388,6.53571428571429,3779.6621962549,209.981233125272,578.308969918782,46,37.5913404047603
transformers_4.23.0,tests/models/swin/__init__.py,0,0,0,0,0,0,0,0,0,0,0,0,0,0,1,100
transformers_4.23.0,tests/models/swin/test_modeling_tf_swin.py,405,229,299,9,49,30,53,58,83,303.650107374626,4.86734693877551,2366.56454671526,131.475808150848,486.212422595589,38,41.0879957150509
transformers_4.23.0,tests/models/codegen/test_modeling_codegen.py,554,307,416,7,37,43,69,44,112,212.401258982674,6.52702702702703,3990.99206542977,221.721781412765,611.456341287377,41,37.6616175790605
transformers_4.23.0,tests/models/codegen/test_tokenization_codegen.py,265,135,173,5,26,22,39,31,61,133.821073146105,3.75,1133.272406001,62.9595781111665,302.205974933599,17,58.8053980668868
transformers_4.23.0,tests/models/codegen/__init__.py,0,0,0,0,0,0,0,0,0,0,0,0,0,0,1,100
transformers_4.23.0,tests/models/encoder_decoder/__init__.py,0,0,0,0,0,0,0,0,0,0,0,0,0,0,1,100
transformers_4.23.0,tests/models/encoder_decoder/test_modeling_encoder_decoder.py,1088,451,908,8,44,40,64,52,104,264.214991220041,5.81818181818182,3449.28425126792,191.626902848218,592.845730686674,74,25.0518911939085
transformers_4.23.0,tests/models/encoder_decoder/test_modeling_tf_encoder_decoder.py,1263,557,928,12,74,57,100,86,157,502.519099065196,8.10810810810811,8180.46134990456,454.470074994698,1008.92356648823,95,25.9829811330194
transformers_4.23.0,tests/models/encoder_decoder/test_modeling_flax_encoder_decoder.py,601,289,459,10,36,35,57,46,92,219.336581000797,7.91666666666667,4022.99429132819,223.499682851566,508.167699957245,50,36.06785561852
transformers_4.23.0,tests/models/byt5/__init__.py,0,0,0,0,0,0,0,0,0,0,0,0,0,0,1,100
transformers_4.23.0,tests/models/byt5/test_tokenization_byt5.py,369,218,253,8,35,25,51,43,76,203.524905593074,5.82857142857143,2403.68025019718,133.537791677621,412.39612135736,48,47.3392264923612
transformers_4.23.0,tests/models/bert_japanese/__init__.py,0,0,0,0,0,0,0,0,0,0,0,0,0,0,1,100
transformers_4.23.0,tests/models/bert_japanese/test_tokenization_bert_japanese.py,449,231,327,2,28,18,36,30,54,136.605937817613,1.28571428571429,340.678404209391,18.9265780116329,264.97209216286,52,42.8168233908205
transformers_4.23.0,tests/models/sew_d/__init__.py,0,0,0,0,0,0,0,0,0,0,0,0,0,0,1,100
transformers_4.23.0,tests/models/sew_d/test_modeling_sew_d.py,575,318,421,12,108,85,127,120,212,772.547400242309,7.05555555555556,10331.1734664535,573.954081469641,1464.26080626901,68,31.8996285690303
transformers_4.23.0,tests/models/speech_to_text_2/__init__.py,0,0,0,0,0,0,0,0,0,0,0,0,0,0,1,100
transformers_4.23.0,tests/models/speech_to_text_2/test_modeling_speech_to_text_2.py,212,99,151,4,12,11,19,16,30,51.0195500086539,3.16666666666667,380,21.1111111111111,120,18,60.9872476212928
transformers_4.23.0,tests/models/speech_to_text_2/test_tokenization_speech_to_text_2.py,97,56,55,6,12,7,12,18,19,58.5293250129808,3,237.685725082212,13.2047625045673,79.2285750274039,11,74.1844631737087
transformers_4.23.0,tests/models/glpn/__init__.py,0,0,0,0,0,0,0,0,0,0,0,0,0,0,1,100
transformers_4.23.0,tests/models/glpn/test_feature_extraction_glpn.py,127,65,79,3,24,18,30,27,48,114.793987519471,1.875,427.939875194712,23.7744375108173,228.234600103846,16,68.0813911009607
transformers_4.23.0,tests/models/glpn/test_modeling_glpn.py,355,213,260,8,32,32,54,40,86,184,6.75,3089.37925908211,171.632181060117,457.685816160313,32,44.3808215254777
transformers_4.23.0,tests/models/cpm/test_tokenization_cpm.py,39,17,17,1,2,1,2,3,3,2,0.5,2.37744375108173,0.13208020839343,4.75488750216347,2,96.5421274873175
transformers_4.23.0,tests/models/cpm/__init__.py,0,0,0,0,0,0,0,0,0,0,0,0,0,0,1,100
transformers_4.23.0,tests/models/owlvit/__init__.py,0,0,0,0,0,0,0,0,0,0,0,0,0,0,1,100
transformers_4.23.0,tests/models/owlvit/test_processor_owlvit.py,241,146,156,3,5,3,5,8,8,16.3645279766003,1.5,36,2,24,21,60.4471602907968
transformers_4.23.0,tests/models/owlvit/test_feature_extraction_owlvit.py,201,75,147,0,0,0,0,0,0,0,0,0,0,0,15,100
transformers_4.23.0,tests/models/owlvit/test_modeling_owlvit.py,793,484,617,13,46,36,70,59,106,302.189566314457,9.89130434782609,6167.82335371134,342.656852983963,623.560163232355,102,21.4352825246833
transformers_4.23.0,tests/models/m2m_100/test_modeling_m2m_100.py,384,203,290,7,38,35,49,45,84,219.072729965259,4.51315789473684,2081.99041330856,115.666134072698,461.315660091693,32,45.0350299213
transformers_4.23.0,tests/models/m2m_100/test_tokenization_m2m_100.py,246,145,175,4,16,12,20,20,32,72,2.5,345.754247590989,19.2085693106105,138.301699036396,29,54.5908696900643
transformers_4.23.0,tests/models/m2m_100/__init__.py,0,0,0,0,0,0,0,0,0,0,0,0,0,0,1,100
transformers_4.23.0,tests/models/unispeech/test_modeling_unispeech.py,583,318,422,13,79,53,95,92,148,546.104395441825,7.81645569620253,7546.68768562089,419.260426978938,965.487169496438,75,32.7344057056237
transformers_4.23.0,tests/models/unispeech/__init__.py,0,0,0,0,0,0,0,0,0,0,0,0,0,0,1,100
transformers_4.23.0,tests/models/ctrl/__init__.py,0,0,0,0,0,0,0,0,0,0,0,0,0,0,1,100
transformers_4.23.0,tests/models/ctrl/test_tokenization_ctrl.py,66,38,37,1,4,2,4,5,6,8,0.5,6.96578428466209,0.38698801581456,13.9315685693242,5,84.8222070495732
transformers_4.23.0,tests/models/ctrl/test_modeling_ctrl.py,248,130,193,1,2,1,2,3,3,2,0.5,2.37744375108173,0.13208020839343,4.75488750216347,24,65.0939424077032
transformers_4.23.0,tests/models/ctrl/test_modeling_tf_ctrl.py,261,142,206,3,8,6,12,11,18,28.7548875021635,2.25,140.106980554811,7.78372114193392,62.2697691354714,35,54.4444352846867
transformers_4.23.0,tests/models/speech_to_text/test_tokenization_speech_to_text.py,163,97,110,4,19,25,47,23,72,88.7106227554281,4.94736842105263,1611.34038518915,89.5189102882862,325.696460836105,16,59.5158200890715
transformers_4.23.0,tests/models/speech_to_text/test_processor_speech_to_text.py,146,82,92,2,6,5,9,8,14,17.5097750043269,1.5,63,3.5,42,14,65.5440129580321
transformers_4.23.0,tests/models/speech_to_text/test_modeling_speech_to_text.py,780,428,583,13,76,69,122,89,191,522.948207357547,10.4342105263158,12905.7106928219,716.983927378994,1236.86508531458,76,29.1349528901185
transformers_4.23.0,tests/models/speech_to_text/__init__.py,0,0,0,0,0,0,0,0,0,0,0,0,0,0,1,100
transformers_4.23.0,tests/models/speech_to_text/test_modeling_tf_speech_to_text.py,610,300,436,8,41,37,58,49,95,243.659632189341,5.65853658536585,3018.24890156827,167.680494531571,533.397435190945,52,41.219942568046
transformers_4.23.0,tests/models/speech_to_text/test_feature_extraction_speech_to_text.py,250,154,184,7,30,19,36,37,55,166.858202322659,4.2,1203.38372746029,66.8546515255715,286.519935109592,35,49.5717913746422
transformers_4.23.0,tests/models/mobilebert/test_modeling_tf_mobilebert.py,353,195,286,3,16,13,17,19,30,68.7548875021635,1.59375,203.104034236521,11.2835574575845,127.437825403308,30,45.0323802227574
transformers_4.23.0,tests/models/mobilebert/test_tokenization_mobilebert.py,345,169,252,4,21,12,22,25,34,100.238665878354,2.0952380952381,330.81946951919,18.3788594177328,157.891110452341,38,47.0124208617639
transformers_4.23.0,tests/models/mobilebert/__init__.py,0,0,0,0,0,0,0,0,0,0,0,0,0,0,1,100
transformers_4.23.0,tests/models/mobilebert/test_modeling_mobilebert.py,369,179,301,8,17,17,25,25,42,93.4868683012558,5.88235294117647,1147.30564688552,63.7392026047511,195.041959970538,33,44.9259900621679
transformers_4.23.0,tests/models/decision_transformer/test_modeling_decision_transformer.py,251,116,189,4,11,11,15,15,26,46.0537478050103,2.72727272727273,277.034060415877,15.3907811342154,101.579155485821,17,58.9517618191198
transformers_4.23.0,tests/models/decision_transformer/__init__.py,0,0,0,0,0,0,0,0,0,0,0,0,0,0,1,100
transformers_4.23.0,tests/models/convnext/__init__.py,0,0,0,0,0,0,0,0,0,0,0,0,0,0,1,100
transformers_4.23.0,tests/models/convnext/test_modeling_convnext.py,264,151,183,3,10,9,14,13,23,37.9741684510371,2.1,178.731238386215,9.9295132436786,85.1101135172451,28,55.4558408724189
transformers_4.23.0,tests/models/convnext/test_modeling_tf_convnext.py,298,167,209,5,13,11,18,18,29,59.715356810271,3.46153846153846,418.596317452478,23.2553509695821,120.927825041827,29,52.548596602273
transformers_4.23.0,tests/models/convnext/test_feature_extraction_convnext.py,195,73,141,0,0,0,0,0,0,0,0,0,0,0,16,100
transformers_4.23.0,tests/models/unispeech_sat/test_modeling_unispeech_sat.py,923,494,683,13,148,125,190,161,315,1115.10481444892,8.3445945945946,19269.6617466793,1070.53676370441,2309.2388166061,122,18.8370977217348
transformers_4.23.0,tests/models/unispeech_sat/__init__.py,0,0,0,0,0,0,0,0,0,0,0,0,0,0,1,100
transformers_4.23.0,tests/models/mctct/test_feature_extraction_mctct.py,274,168,205,8,36,23,44,44,67,210.117300051923,4.88888888888889,1788.26715686031,99.3481753811281,365.781918448699,37,47.2363251530232
transformers_4.23.0,tests/models/mctct/test_processor_mctct.py,146,83,94,2,5,3,6,7,9,13.6096404744368,1.2,30.3194331582221,1.68441295323456,25.2661942985184,14,66.8005199823832
transformers_4.23.0,tests/models/mctct/__init__.py,0,0,0,0,0,0,0,0,0,0,0,0,0,0,1,100
transformers_4.23.0,tests/models/mctct/test_modeling_mctct.py,647,374,471,11,93,75,135,104,210,646.195517238057,7.98387096774194,11234.043688722,624.113538262336,1407.09234080963,97,26.5853945914649
transformers_4.23.0,tests/models/resnet/test_modeling_tf_resnet.py,252,146,172,3,11,10,15,14,25,42.8086353071737,2.04545454545455,194.694285787037,10.8163492103909,95.1838730514401,29,55.8023723352412
transformers_4.23.0,tests/models/resnet/test_modeling_resnet.py,275,162,193,4,15,12,19,19,31,66.6033589341278,2.53333333333333,333.603907389103,18.5335504105057,131.685752916751,33,52.3620953964745
transformers_4.23.0,tests/models/resnet/__init__.py,0,0,0,0,0,0,0,0,0,0,0,0,0,0,1,100
transformers_4.23.0,tests/models/marian/test_modeling_flax_marian.py,489,261,388,6,37,39,62,43,101,208.259549532598,5.02702702702703,2755.07593734685,153.059774297048,548.052740224912,40,35.6684979770651
transformers_4.23.0,tests/models/marian/test_modeling_marian.py,850,471,663,10,54,49,82,64,131,343.983206065701,7.59259259259259,5967.77777777778,331.543209876543,786,85,25.8783072820159
transformers_4.23.0,tests/models/marian/__init__.py,0,0,0,0,0,0,0,0,0,0,0,0,0,0,1,100
transformers_4.23.0,tests/models/marian/test_modeling_tf_marian.py,437,268,328,9,43,34,63,52,97,261.858709465171,6.59302325581395,3645.56376811677,202.531320450931,552.942652659686,59,37.2845875413674
transformers_4.23.0,tests/models/marian/test_tokenization_marian.py,152,95,101,4,10,8,14,14,22,41.2192809488736,2.8,234.533063198748,13.0296146221527,83.7618082852673,17,63.0754577829388
transformers_4.23.0,tests/models/xlm_roberta/test_tokenization_xlm_roberta.py,346,122,253,5,17,26,49,22,75,81.0965087756926,7.20588235294118,2410.06047036648,133.892248353693,334.457371397797,25,55.8719843617692
transformers_4.23.0,tests/models/xlm_roberta/__init__.py,0,0,0,0,0,0,0,0,0,0,0,0,0,0,1,100
transformers_4.23.0,tests/models/xlm_roberta/test_modeling_tf_xlm_roberta.py,57,22,32,1,3,3,3,4,6,4.75488750216347,0.5,6,0.333333333333333,12,3,91.8333281749974
transformers_4.23.0,tests/models/xlm_roberta/test_modeling_flax_xlm_roberta.py,47,22,23,1,4,4,4,5,8,8,0.5,9.28771237954945,0.51598402108608,18.5754247590989,3,90.3059460543788
transformers_4.23.0,tests/models/xlm_roberta/test_modeling_xlm_roberta.py,69,30,32,1,11,11,11,12,22,38.0537478050103,0.5,39.4345875079327,2.19081041710737,78.8691750158654,4,81.9179877584145
transformers_4.23.0,tests/models/detr/test_feature_extraction_detr.py,341,180,229,5,6,7,13,11,20,27.1194154787637,5.41666666666667,374.771758685707,20.8206532603171,69.188632372746,26,59.2685028494106
transformers_4.23.0,tests/models/detr/__init__.py,0,0,0,0,0,0,0,0,0,0,0,0,0,0,1,100
transformers_4.23.0,tests/models/detr/test_modeling_detr.py,554,333,418,8,79,66,93,87,159,521.998679105991,4.70886075949367,4823.88888471469,267.993826928594,1024.42801583995,60,32.1170518600005
transformers_4.23.0,tests/models/vit_mae/test_modeling_vit_mae.py,331,188,229,8,36,24,41,44,65,210.117300051923,4.55555555555556,1616.59836262982,89.8110201461012,354.863055211424,33,49.5070900152931
transformers_4.23.0,tests/models/vit_mae/test_modeling_tf_vit_mae.py,502,276,336,11,73,44,80,84,124,489.910940603252,6.02739726027397,4777.60052858643,265.422251588135,792.647360424566,54,42.3009569128811
transformers_4.23.0,tests/models/vit_mae/__init__.py,0,0,0,0,0,0,0,0,0,0,0,0,0,0,1,100
transformers_4.23.0,tests/models/beit/test_modeling_beit.py,482,281,351,12,80,70,87,92,157,548.773797599643,6.525,6682.89995683371,371.272219824095,1024.19922710095,50,36.7904586448139
transformers_4.23.0,tests/models/beit/__init__.py,0,0,0,0,0,0,0,0,0,0,0,0,0,0,1,100
transformers_4.23.0,tests/models/beit/test_modeling_flax_beit.py,296,167,206,5,20,16,20,25,36,98.0482023721841,2.5,417.947057079725,23.2192809488736,167.17882283189,28,51.8134020601331
transformers_4.23.0,tests/models/beit/test_feature_extraction_beit.py,344,133,264,3,18,13,25,21,38,79.8135375281251,2.08333333333333,347.725129303319,19.3180627390733,166.908062065593,19,55.3467925016145
transformers_4.23.0,tests/models/transfo_xl/__init__.py,0,0,0,0,0,0,0,0,0,0,0,0,0,0,1,100
transformers_4.23.0,tests/models/transfo_xl/test_modeling_tf_transfo_xl.py,262,139,173,5,17,11,22,22,33,81.0965087756926,3.23529411764706,476.109905166276,26.4505502870153,147.161243415031,34,58.9618142651459
transformers_4.23.0,tests/models/transfo_xl/test_tokenization_transfo_xl.py,131,46,91,1,4,2,4,5,6,8,0.5,6.96578428466209,0.38698801581456,13.9315685693242,10,76.700457308402
transformers_4.23.0,tests/models/transfo_xl/test_modeling_transfo_xl.py,487,274,353,11,79,63,122,90,185,536.052426911001,8.49367088607595,10200.8377735808,566.713209643379,1200.99282282099,78,37.2184176706275
transformers_4.23.0,tests/models/mt5/test_modeling_mt5.py,53,20,19,4,9,6,9,13,15,36.5293250129808,2,111.013191544233,6.16739953023515,55.5065957721164,3,81.195587443302
transformers_4.23.0,tests/models/mt5/test_modeling_flax_mt5.py,61,26,25,4,9,7,10,13,17,36.5293250129808,2.22222222222222,139.794389351997,7.76635496399982,62.9074752083986,3,82.87381844139
transformers_4.23.0,tests/models/mt5/__init__.py,0,0,0,0,0,0,0,0,0,0,0,0,0,0,1,100
transformers_4.23.0,tests/models/mt5/test_modeling_tf_mt5.py,73,34,32,3,6,4,6,9,10,20.2646625064904,1.5,47.5488750216347,2.64160416786859,31.6992500144231,4,83.1819994650858
transformers_4.23.0,tests/repo_utils/test_check_dummies.py,127,49,79,0,0,0,0,0,0,0,0,0,0,0,5,100
transformers_4.23.0,tests/repo_utils/test_check_copies.py,209,60,157,4,12,8,16,16,24,51.0195500086539,2.66666666666667,256,14.2222222222222,96,9,66.955033962147
transformers_4.23.0,tests/mixed_int8/test_mixed_int8.py,233,105,123,6,15,11,21,21,32,74.1131339384547,4.2,590.327461621465,32.7959700900814,140.55415752892,16,67.953147202709
transformers_4.23.0,tests/mixed_int8/__init__.py,0,0,0,0,0,0,0,0,0,0,0,0,0,0,1,100
transformers_4.23.0,tests/sagemaker/test_multi_node_model_parallel.py,124,46,96,4,14,8,16,18,24,61.3029689088065,2.28571428571429,228.750171507693,12.7083428615385,100.078200034616,12,66.2372854890966
transformers_4.23.0,tests/sagemaker/__init__.py,5,3,3,1,2,1,2,3,3,2,0.5,2.37744375108173,0.13208020839343,4.75488750216347,1,84.7162462759479
transformers_4.23.0,tests/sagemaker/conftest.py,65,36,50,1,4,2,4,5,6,8,0.5,6.96578428466209,0.38698801581456,13.9315685693242,7,71.3107646450788
transformers_4.23.0,tests/sagemaker/test_single_node_gpu.py,96,38,73,4,12,7,14,16,21,51.0195500086539,2.33333333333333,196,10.8888888888889,84,11,69.1059155122177
transformers_4.23.0,tests/sagemaker/test_multi_node_data_parallel.py,110,42,84,6,15,9,18,21,27,74.1131339384547,3.6,426.933253494096,23.7185140830053,118.592570415027,13,67.4880486198285
transformers_4.23.0,tests/sagemaker/scripts/tensorflow/run_tf_dist.py,194,118,139,6,23,15,28,29,43,119.551699993638,3.65217391304348,762.914232800035,42.3841240444464,208.893182790486,26,52.3761255167188
transformers_4.23.0,tests/sagemaker/scripts/tensorflow/run_tf.py,91,50,64,2,4,2,4,6,6,10,1,15.5097750043269,0.861654166907052,15.5097750043269,5,75.2893720187177
transformers_4.23.0,tests/sagemaker/scripts/pytorch/run_glue_model_parallelism.py,541,266,390,15,101,83,157,116,240,731.082718692059,11.6584158415842,19188.7666259708,1066.04259033171,1645.91543883062,88,37.5360007373857
transformers_4.23.0,tests/sagemaker/scripts/pytorch/run_ddp.py,52,32,42,2,4,2,4,6,6,10,1,15.5097750043269,0.861654166907052,15.5097750043269,8,57.7540537588094
transformers_4.23.0,tests/utils/test_file_utils.py,113,60,64,1,3,2,4,4,6,4.75488750216347,0.666666666666667,8,0.444444444444444,12,11,80.678630682467
transformers_4.23.0,tests/utils/test_skip_decorators.py,120,48,48,2,4,2,4,6,6,10,1,15.5097750043269,0.861654166907052,15.5097750043269,11,79.4504276353346
transformers_4.23.0,tests/utils/test_doc_samples.py,114,63,72,5,10,9,18,15,27,44.8289214233104,4.5,474.687207366435,26.3715115203575,105.48604608143,25,70.6891589129412
transformers_4.23.0,tests/utils/test_versions_utils.py,97,51,50,0,0,0,0,0,0,0,0,0,0,0,14,100
transformers_4.23.0,tests/utils/test_convert_slow_tokenizer.py,34,22,25,0,0,0,0,0,0,0,0,0,0,0,2,100
transformers_4.23.0,tests/utils/test_hub_utils.py,125,70,79,1,2,1,2,3,3,2,0.5,2.37744375108173,0.13208020839343,4.75488750216347,8,80.2274122166512
transformers_4.23.0,tests/utils/test_cli.py,47,21,23,0,0,0,0,0,0,0,0,0,0,0,3,100
transformers_4.23.0,tests/utils/test_add_new_model_like.py,1342,441,1021,3,17,9,17,20,26,74.2417558034193,1.5,168.555195700607,9.36417753892262,112.370130467071,66,28.9160501417786
transformers_4.23.0,tests/utils/test_modeling_tf_core.py,404,235,314,12,53,38,69,65,107,346.599334100503,7.81132075471698,5033.56319587801,279.642399771001,644.393355994045,70,37.1542430301966
transformers_4.23.0,tests/utils/__init__.py,0,0,0,0,0,0,0,0,0,0,0,0,0,0,1,100
transformers_4.23.0,tests/utils/test_generic.py,45,9,26,0,0,0,0,0,0,0,0,0,0,0,2,100
transformers_4.23.0,tests/utils/test_model_output.py,109,87,78,0,0,0,0,0,0,0,0,0,0,0,8,100
transformers_4.23.0,tests/utils/test_hf_argparser.py,305,231,220,2,6,6,12,8,18,17.5097750043269,2,108,6,54,22,49.6842273906623
transformers_4.23.0,tests/utils/test_activations_tf.py,60,35,35,3,7,6,9,10,15,24.4063719565667,1.92857142857143,96.0986341735273,5.3388130096404,49.8289214233104,4,81.7580233365582
transformers_4.23.0,tests/utils/test_offline.py,121,34,57,0,0,0,0,0,0,0,0,0,0,0,3,100
transformers_4.23.0,tests/utils/test_image_utils.py,487,305,328,7,70,52,102,77,154,448.701295640551,5.1,4921.93414906178,273.440786058987,965.085127267015,40,43.0817551861199
transformers_4.23.0,tests/utils/test_model_card.py,84,38,57,0,0,0,0,0,0,0,0,0,0,0,7,100
transformers_4.23.0,tests/utils/test_logging.py,133,70,74,3,7,5,9,10,14,24.4063719565667,1.92857142857143,89.6920585619588,4.98289214233104,46.5069933284231,9,75.0163771356812
transformers_4.23.0,tests/utils/test_activations.py,65,40,40,4,11,10,14,15,24,46.0537478050103,2.54545454545455,238.675498204448,13.2597499002471,93.7653742946045,5,77.6212880977393
transformers_4.23.0,tests/pipelines/test_pipelines_feature_extraction.py,106,54,77,6,426,442,448,432,890,3736.49607322053,3.15492957746479,24582.7376398776,1365.70764665987,7791.84987692549,16,56.9872494781566
transformers_4.23.0,tests/pipelines/test_pipelines_object_detection.py,251,86,204,1,2,1,2,3,3,2,0.5,2.37744375108173,0.13208020839343,4.75488750216347,14,67.2079163175176
transformers_4.23.0,tests/pipelines/test_pipelines_zero_shot_image_classification.py,229,56,167,1,10,6,12,11,18,33.2192809488736,0.6,37.3618614812828,2.07565897118238,62.2697691354714,7,74.8519208845236
transformers_4.23.0,tests/pipelines/test_pipelines_common.py,979,579,717,14,75,51,97,89,148,520.464370695997,9.05333333333333,8676.79205259567,482.044002921982,958.408547783027,109,22.9545899997488
transformers_4.23.0,tests/pipelines/test_pipelines_automatic_speech_recognition.py,803,462,636,5,16,10,20,21,30,75.6096404744368,3.125,411.779758385509,22.8766532436394,131.769522683363,65,35.5405559300196
transformers_4.23.0,tests/pipelines/test_pipelines_image_to_text.py,170,66,135,0,0,0,0,0,0,0,0,0,0,0,9,100
transformers_4.23.0,tests/pipelines/test_pipelines_summarization.py,139,44,109,4,6,5,8,10,13,23.5097750043269,2.66666666666667,115.160173956095,6.39778744200529,43.1850652335357,8,71.9499777211752
transformers_4.23.0,tests/pipelines/test_pipelines_text_classification.py,186,106,132,2,13,7,14,15,21,50.1057163358342,1.07692307692308,88.3558334699157,4.90865741499532,82.0447025077789,8,63.5948242086591
transformers_4.23.0,tests/pipelines/__init__.py,0,0,0,0,0,0,0,0,0,0,0,0,0,0,1,100
transformers_4.23.0,tests/pipelines/test_pipelines_text_generation.py,295,112,237,9,17,12,24,26,36,98.0161933142366,6.35294117647059,1075.01821318427,59.7232340657927,169.215829853079,13,57.6020754641791
transformers_4.23.0,tests/pipelines/test_pipelines_zero_shot_object_detection.py,255,78,211,0,0,0,0,0,0,0,0,0,0,0,14,100
transformers_4.23.0,tests/pipelines/test_pipelines_table_question_answering.py,664,232,612,0,0,0,0,0,0,0,0,0,0,0,10,100
transformers_4.23.0,tests/pipelines/test_pipelines_fill_mask.py,402,163,327,2,5,3,6,7,9,13.6096404744368,1.2,30.3194331582221,1.68441295323456,25.2661942985184,28,55.0761631550353
transformers_4.23.0,tests/pipelines/test_pipelines_question_answering.py,483,258,384,1,5,4,8,6,12,11.6096404744368,0.8,24.8156400069231,1.37864666705128,31.0195500086539,31,47.2573523399262
transformers_4.23.0,tests/pipelines/test_pipelines_text2text_generation.py,126,51,94,0,0,0,0,0,0,0,0,0,0,0,6,100
transformers_4.23.0,tests/pipelines/test_pipelines_image_classification.py,219,69,175,0,0,0,0,0,0,0,0,0,0,0,9,100
transformers_4.23.0,tests/pipelines/test_pipelines_translation.py,174,95,132,0,0,0,0,0,0,0,0,0,0,0,13,100
transformers_4.23.0,tests/pipelines/test_pipelines_visual_question_answering.py,107,58,76,1,2,1,2,3,3,2,0.5,2.37744375108173,0.13208020839343,4.75488750216347,8,77.816718541563
transformers_4.23.0,tests/pipelines/test_pipelines_audio_classification.py,118,54,82,0,0,0,0,0,0,0,0,0,0,0,7,100
transformers_4.23.0,tests/pipelines/test_pipelines_zero_shot.py,295,104,242,2,3,2,3,5,5,6.75488750216347,1,11.6096404744368,0.644980026357601,11.6096404744368,11,62.7233080097087
transformers_4.23.0,tests/pipelines/test_pipelines_token_classification.py,815,311,711,0,0,0,0,0,0,0,0,0,0,0,32,100
transformers_4.23.0,tests/pipelines/test_pipelines_image_segmentation.py,377,136,300,2,15,11,22,17,33,60.6033589341278,1.46666666666667,197.833201516516,10.9907334175842,134.886273761261,28,52.8464212731071
transformers_4.23.0,tests/pipelines/test_pipelines_document_question_answering.py,273,114,208,1,6,3,6,7,9,15.5097750043269,0.5,12.6330971492592,0.701838730514401,25.2661942985184,10,64.9391469909809
transformers_4.23.0,tests/pipelines/test_pipelines_conversational.py,383,178,306,3,7,4,7,10,11,24.4063719565667,1.5,54.8118135656415,3.04510075364675,36.541209043761,17,59.5686384559972
transformers_4.23.0,tests/benchmark/test_benchmark.py,264,125,229,0,0,0,0,0,0,0,0,0,0,0,18,100
transformers_4.23.0,tests/benchmark/__init__.py,0,0,0,0,0,0,0,0,0,0,0,0,0,0,1,100
transformers_4.23.0,tests/benchmark/test_benchmark_tf.py,226,106,193,0,0,0,0,0,0,0,0,0,0,0,16,100
transformers_4.23.0,tests/extended/test_trainer_ext.py,377,147,281,9,40,27,50,49,77,241.406448808475,5.625,2431.8712012324,135.103955624022,432.332657996871,35,52.7634750679502
transformers_4.23.0,tests/trainer/test_trainer.py,2469,1492,1843,20,290,239,459,310,698,2458.61219800208,15.8275862068966,91431.768593468,5079.54269963711,5776.73483488142,204,0
transformers_4.23.0,tests/trainer/test_data_collator.py,864,651,657,6,77,75,133,83,208,498.052338637834,5.18181818181818,6871.13340891356,381.729633828531,1326.00820172016,81,20.6499976942789
transformers_4.23.0,tests/trainer/test_trainer_tpu.py,131,70,77,4,16,10,20,20,30,72,2.5,324.144607116552,18.0080337286973,129.657842846621,15,69.709572476659
transformers_4.23.0,tests/trainer/__init__.py,0,0,0,0,0,0,0,0,0,0,0,0,0,0,1,100
transformers_4.23.0,tests/trainer/test_trainer_callback.py,245,152,172,8,40,31,54,48,85,236.877123795494,5.4,2563.49778783101,142.41654376839,474.721812561298,40,48.7236464469182
transformers_4.23.0,tests/trainer/test_trainer_seq2seq.py,126,48,83,3,11,6,11,14,17,42.8086353071737,1.5,97.0875505124689,5.39375280624827,64.7250336749793,3,75.1124263228115
transformers_4.23.0,tests/trainer/test_trainer_distributed.py,143,75,95,7,25,16,30,32,46,135.747889198771,4.2,966,53.6666666666667,230,19,63.8016480137341
transformers_4.23.0,tests/trainer/test_trainer_utils.py,499,324,352,11,85,63,110,96,173,582.851977376715,7.11764705882353,8108.41294279976,450.467385711098,1139.19851262476,69,36.7603114287142
transformers_4.23.0,tests/deepspeed/test_model_zoo.py,367,121,240,2,14,7,14,16,21,55.3029689088065,1,84,4.66666666666667,84,10,67.6024177950422
transformers_4.23.0,tests/deepspeed/test_deepspeed.py,1141,508,762,12,90,53,100,102,153,627.286328678325,6.66666666666667,6805.87384881093,378.104102711718,1020.88107732164,72,35.9367630238135
transformers_4.23.0,tests/generation/test_generation_flax_logits_process.py,301,184,183,8,48,32,58,56,90,292.078200034615,4.83333333333333,2526.19939109506,140.344410616392,522.661942985184,11,56.472235582206
transformers_4.23.0,tests/generation/test_generation_flax_utils.py,296,195,188,9,29,24,33,38,57,169.41077387168,5.12068965517241,1531.76146336356,85.0978590757533,299.131868266284,31,48.2630780557191
transformers_4.23.0,tests/generation/test_generation_stopping_criteria.py,109,54,65,2,4,2,4,6,6,10,1,15.5097750043269,0.861654166907052,15.5097750043269,8,76.7774449780822
transformers_4.23.0,tests/generation/test_generation_beam_constraints.py,115,66,66,4,33,32,60,37,92,174.465005938829,3.63636363636364,1742.79894413769,96.8221635632047,479.269709637863,12,67.8972884972489
transformers_4.23.0,tests/generation/test_generation_tf_logits_process.py,480,292,323,11,85,66,121,96,187,582.851977376715,7.82941176470588,9641.04359730585,535.613533183658,1231.38798763486,34,44.1520546080668
transformers_4.23.0,tests/generation/test_generation_utils.py,2740,1043,2230,16,218,182,280,234,462,1757.46418280137,10.2752293577982,37361.848811938,2075.65826732989,3636.10850044753,193,0
transformers_4.23.0,tests/generation/__init__.py,0,0,0,0,0,0,0,0,0,0,0,0,0,0,1,100
transformers_4.23.0,tests/generation/test_generation_beam_search.py,572,287,385,12,80,81,133,92,214,548.773797599643,9.975,13925.5215294971,773.640084972061,1396.0422585962,48,41.3926793934983
transformers_4.23.0,tests/generation/test_generation_tf_utils.py,183,57,144,3,35,33,35,38,68,184.279793095237,1.5,535.288606371246,29.7382559095136,356.859070914164,6,66.9942632775268
transformers_4.23.0,tests/generation/test_generation_logits_process.py,555,275,348,8,80,68,114,88,182,529.754247590989,5.7,6701.01436117433,372.278575620796,1175.61655459199,20,47.6686286213708
transformers_4.23.0,tests/tokenization/test_tokenization_fast.py,176,106,106,1,2,1,2,3,3,2,0.5,2.37744375108173,0.13208020839343,4.75488750216347,20,76.0492042895211
transformers_4.23.0,tests/tokenization/test_tokenization_utils.py,287,200,208,0,0,0,0,0,0,0,0,0,0,0,25,100
transformers_4.23.0,tests/tokenization/__init__.py,0,0,0,0,0,0,0,0,0,0,0,0,0,0,1,100
transformers_4.23.0,tests/optimization/test_optimization_tf.py,100,70,71,2,5,11,12,7,23,13.6096404744368,2.4,154.96599169758,8.60922176097665,64.5691632073249,7,68.7952418304477
transformers_4.23.0,tests/optimization/__init__.py,0,0,0,0,0,0,0,0,0,0,0,0,0,0,1,100
transformers_4.23.0,tests/optimization/test_optimization.py,166,80,125,4,13,12,15,17,27,56.1057163358342,2.30769230769231,254.680377031752,14.1489098350973,110.361496713759,17,63.4495451453121
transformers_4.23.0,tests/onnx/test_onnx.py,195,116,116,2,4,3,6,6,9,10,1.5,34.8969937597356,1.93872187554087,23.2646625064904,24,70.021195390472
transformers_4.23.0,tests/onnx/test_onnx_v2.py,525,212,369,11,25,15,28,36,43,154.150152549378,6.16,1369.40973438204,76.07831857678,222.306775062019,42,50.7901062959736
transformers_4.23.0,tests/onnx/test_features.py,111,66,66,0,0,0,0,0,0,0,0,0,0,0,7,100
transformers_4.23.0,tests/onnx/__init__.py,0,0,0,0,0,0,0,0,0,0,0,0,0,0,1,100
transformers_4.23.0,utils/update_metadata.py,286,134,203,8,29,18,34,37,52,164.8814488587,4.68965517241379,1270.38807592165,70.5771153289807,270.891575012705,37,55.4344664613021
transformers_4.23.0,utils/past_ci_versions.py,141,17,134,1,4,2,4,5,6,8,0.5,6.96578428466209,0.38698801581456,13.9315685693242,3,74.9909025730058
transformers_4.23.0,utils/check_dummies.py,169,94,106,11,31,24,45,42,69,191.633833427003,7.98387096774194,2970.55808991949,165.031004995527,372.069902171734,24,60.4339472375361
transformers_4.23.0,utils/check_repo.py,800,329,637,15,194,116,221,209,337,1532.98645031843,8.54381443298969,22191.5329670098,1232.86294261166,2597.38002751126,135,27.8184907909091
transformers_4.23.0,utils/notification_service_doc_tests.py,382,221,279,16,73,52,99,89,151,515.857192798241,10.8493150684932,10608.8481161114,589.380450895079,977.835748075926,55,36.2652026661527
transformers_4.23.0,utils/download_glue_data.py,157,97,117,5,23,15,25,28,40,115.651565463748,2.71739130434783,522.538578484522,29.0299210269179,192.294196882304,18,58.5232937830922
transformers_4.23.0,utils/tests_fetcher.py,706,378,474,16,193,116,220,209,336,1529.34420819274,9.11917098445596,23615.667856722,1311.98154759567,2589.67266837918,152,25.6194650937663
transformers_4.23.0,utils/check_table.py,232,144,152,14,75,55,105,89,160,520.464370695997,9.8,10153.9500197553,564.108334430851,1036.11734895462,37,52.3766007059829
transformers_4.23.0,utils/get_github_job_time.py,68,43,39,4,13,7,14,17,21,56.1057163358342,2.15384615384615,184.879088511938,10.2710604728855,85.8367196662571,7,69.6439635489697
transformers_4.23.0,utils/check_copies.py,552,304,407,16,162,119,228,178,347,1253.05570046731,11.2592592592593,29207.4136357698,1622.6340908761,2594.07950054534,86,30.8353365729823
transformers_4.23.0,utils/notification_service.py,918,536,666,17,181,129,248,198,377,1426.95897386332,11.646408839779,33498.1866059845,1861.01036699914,2876.26744577001,165,11.4526591518694
transformers_4.23.0,utils/check_tf_ops.py,101,41,60,5,18,10,20,23,30,86.6682905003984,2.77777777777778,376.963496338084,20.9424164632269,135.70685868171,14,75.7944135602514
transformers_4.23.0,utils/check_doc_toc.py,98,53,56,5,20,12,24,25,36,98.0482023721841,3,501.53646849567,27.8631371386483,167.17882283189,20,72.2942753044921
transformers_4.23.0,utils/print_env.py,57,28,28,0,0,0,0,0,0,0,0,0,0,0,4,100
transformers_4.23.0,utils/get_modified_files.py,34,10,9,0,0,0,0,0,0,0,0,0,0,0,3,100
transformers_4.23.0,utils/check_inits.py,299,196,199,18,89,90,168,107,258,651.398925381971,16.9887640449438,29548.5315227769,1641.58508459872,1739.2984824915,72,43.6714306479462
transformers_4.23.0,utils/prepare_for_doc_test.py,148,58,56,8,26,15,27,34,42,146.211432671668,4.15384615384615,887.566594150444,49.3092552305802,213.673439332514,17,67.7676897268236
transformers_4.23.0,utils/release.py,158,100,102,5,23,17,29,28,46,115.651565463748,3.15217391304348,697.066463698353,38.7259146499085,221.13832641465,21,61.1218782072162
transformers_4.23.0,utils/custom_init_isort.py,250,157,143,15,96,72,131,111,203,690.759759003359,10.234375,14115.9297760819,784.218320893439,1379.26642086907,53,51.785467262805
transformers_4.23.0,utils/get_ci_error_statistics.py,278,197,189,13,54,32,63,67,95,358.869641452662,7.58333333333333,4370.11175429229,242.783986349571,576.278473093488,54,41.2130056991468
transformers_4.23.0,utils/check_config_docstrings.py,87,30,45,5,11,6,11,16,17,49.6633882794471,2.5,170,9.44444444444444,68,8,82.9937861003701
transformers_4.23.0,utils/check_self_hosted_runner.py,53,27,38,3,8,4,8,11,12,28.7548875021635,1.5,62.2697691354714,3.4594316186373,41.5131794236476,6,70.0207280509346
transformers_4.23.0,utils/sort_auto_mappings.py,89,51,52,8,28,22,40,36,62,158.605937817613,5.71428571428571,1831.63057193956,101.757253996642,320.535350089423,17,70.9725272595385
transformers_4.23.0,utils/test_module/custom_tokenization.py,5,3,3,0,0,0,0,0,0,0,0,0,0,0,1,100
transformers_4.23.0,utils/test_module/__init__.py,0,0,0,0,0,0,0,0,0,0,0,0,0,0,1,100
transformers_4.23.0,utils/test_module/custom_processing.py,6,4,4,0,0,0,0,0,0,0,0,0,0,0,1,100
transformers_4.23.0,utils/test_module/custom_tokenization_fast.py,8,5,5,0,0,0,0,0,0,0,0,0,0,0,1,100
transformers_4.23.0,utils/test_module/custom_feature_extraction.py,5,3,3,0,0,0,0,0,0,0,0,0,0,0,1,100
transformers_4.23.0,utils/test_module/custom_modeling.py,33,21,21,0,0,0,0,0,0,0,0,0,0,0,7,100
transformers_4.23.0,utils/test_module/custom_pipeline.py,33,25,24,4,7,5,8,11,13,27.6514844544032,2.28571428571429,102.794539525223,5.71080775140125,44.9726110422849,6,57.1244050293025
transformers_4.23.0,utils/test_module/custom_configuration.py,16,10,10,0,0,0,0,0,0,0,0,0,0,0,3,100
transformers_4.23.0,scripts/check_tokenizers.py,169,118,123,11,67,53,106,78,159,444.481723565681,8.70149253731343,8696.08849972946,483.116027762748,999.378952799098,42,46.9666284537726
transformers_4.23.0,scripts/stale.py,66,19,39,8,31,18,38,39,56,177.580085621993,4.90322580645161,1451.26915119211,80.6260639551173,295.982524256286,15,81.7973011670692
transformers_4.23.0,scripts/pegasus/build_test_sample_spm_no_bos.py,33,2,2,0,0,0,0,0,0,0,0,0,0,0,1,100
transformers_4.23.0,scripts/benchmark/trainer-benchmark.py,448,174,251,14,77,48,92,91,140,535.845532542314,8.36363636363636,7620.03590597811,423.335328109895,911.091249627818,33,55.164742932217
transformers_4.23.0,scripts/distributed/torch-distributed-gpu-test.py,92,33,32,1,2,1,2,3,3,2,0.5,2.37744375108173,0.13208020839343,4.75488750216347,3,80.216177384299
transformers_4.23.0,scripts/fsmt/gen-card-facebook-wmt19.py,164,20,107,1,6,3,6,7,9,15.5097750043269,0.5,12.6330971492592,0.701838730514401,25.2661942985184,2,83.937937049477
transformers_4.23.0,scripts/fsmt/gen-card-allenai-wmt19.py,152,19,97,1,6,3,6,7,9,15.5097750043269,0.5,12.6330971492592,0.701838730514401,25.2661942985184,2,85.2267104798243
transformers_4.23.0,scripts/fsmt/fsmt-make-super-tiny-model.py,87,31,42,1,4,3,6,5,9,8,0.75,15.6730146404897,0.870723035582761,20.8973528539863,1,86.6908735221516
transformers_4.23.0,scripts/fsmt/gen-card-allenai-wmt16.py,155,19,100,1,6,3,6,7,9,15.5097750043269,0.5,12.6330971492592,0.701838730514401,25.2661942985184,2,84.9780137675216
transformers_4.23.0,scripts/fsmt/fsmt-make-tiny-model.py,59,15,19,0,0,0,0,0,0,0,0,0,0,0,1,100
transformers_4.23.0,examples/flax/test_flax_examples.py,257,97,210,2,4,2,4,6,6,10,1,15.5097750043269,0.861654166907052,15.5097750043269,12,62.0874887453788
transformers_4.23.0,examples/flax/conftest.py,45,14,14,0,0,0,0,0,0,0,0,0,0,0,2,100
transformers_4.23.0,examples/flax/text-classification/run_flax_glue.py,666,339,493,19,131,99,190,150,289,1002.08903595683,13.7786259541985,28785.3215710208,1599.18453172338,2089.12860155331,73,33.3074761461806
transformers_4.23.0,examples/flax/image-captioning/run_image_captioning_flax.py,1256,660,923,18,199,173,318,217,491,1594.74694951415,14.3819095477387,54808.3305376017,3044.90725208898,3810.92165513024,111,20.8030022458641
transformers_4.23.0,examples/flax/image-captioning/create_model_from_encoder_decoder_models.py,122,48,72,2,5,3,6,7,9,13.6096404744368,1.2,30.3194331582221,1.68441295323456,25.2661942985184,6,81.1456359708442
transformers_4.23.0,examples/flax/token-classification/run_flax_ner.py,799,437,610,18,126,95,178,144,273,954.195920386951,12.7142857142857,24886.8096800063,1382.60053777813,1957.38952539375,77,29.6117892303176
transformers_4.23.0,examples/flax/summarization/run_summarization_flax.py,982,522,751,15,135,104,196,150,300,1013.97346453599,10.8888888888889,23614.1410556199,1311.89672531222,2168.64560714876,101,24.7512772931831
transformers_4.23.0,examples/flax/question-answering/utils_qa.py,443,190,250,15,131,94,182,146,276,979.981772135534,10.4198473282443,20677.0572848279,1148.72540471266,1984.39157825088,83,45.2713819160691
transformers_4.23.0,examples/flax/question-answering/run_qa.py,1066,519,746,20,162,128,245,182,373,1275.49426236506,15.1234567901235,42351.8403206517,2352.88001781398,2800.40740079411,92,29.2279772673845
transformers_4.23.0,examples/flax/vision/run_image_classification.py,570,284,421,11,66,38,76,77,114,436.983759682668,6.33333333333333,4524.61988238172,251.367771243429,714.413665639219,43,42.4673196511632
transformers_4.23.0,examples/flax/language-modeling/run_mlm_flax.py,888,423,623,19,138,101,188,157,289,1061.68699779082,12.9420289855072,27283.6788262566,1515.75993479203,2108.14539642968,92,31.7676819401231
transformers_4.23.0,examples/flax/language-modeling/run_bart_dlm_flax.py,964,504,682,21,182,137,257,203,394,1458.65729039452,14.8269230769231,44779.4183251348,2487.74546250749,3020.14235137096,111,26.2642657691817
transformers_4.23.0,examples/flax/language-modeling/run_clm_flax.py,842,438,633,17,130,94,181,147,275,982.394683994955,11.8346153846154,23431.4721015073,1301.74845008374,1979.90989483,97,28.5542744930335
transformers_4.23.0,examples/flax/language-modeling/t5_tokenizer_model.py,112,38,82,1,2,1,2,3,3,2,0.5,2.37744375108173,0.13208020839343,4.75488750216347,7,75.3999153073977
transformers_4.23.0,examples/flax/language-modeling/run_t5_mlm_flax.py,991,467,653,20,162,127,235,182,362,1275.49426236506,14.5061728395062,39425.190743315,2190.28837462861,2717.82165975193,97,31.2586926924481
transformers_4.23.0,examples/tensorflow/test_tensorflow_examples.py,296,110,240,2,6,3,6,8,9,17.5097750043269,1,27,1.5,27,15,58.7491417379867
transformers_4.23.0,examples/tensorflow/text-classification/run_glue.py,586,273,418,13,72,57,106,85,163,492.340316439681,9.56944444444444,9997.49260923357,555.416256068532,1044.73072259045,77,40.2548973500782
transformers_4.23.0,examples/tensorflow/text-classification/run_text_classification.py,564,264,398,14,106,85,155,120,240,766.462537092506,10.2358490566038,16967.49350091,942.638527828333,1657.65374294604,84,39.1822697633134
transformers_4.23.0,examples/tensorflow/multiple-choice/run_swag.py,554,229,379,14,65,54,96,79,150,444.756876755656,10.3384615384615,9775.70922178849,543.094956766027,945.567112226565,58,46.2217548742627
transformers_4.23.0,examples/tensorflow/token-classification/run_ner.py,588,280,423,11,59,56,97,70,153,385.129687717359,9.04237288135593,8479.75916779053,471.097731543919,937.78030159258,50,43.8819735245755
transformers_4.23.0,examples/tensorflow/summarization/run_summarization.py,725,307,537,12,93,82,148,105,230,651.161319441701,9.54838709677419,14745.3495110552,819.186083947508,1544.27646906321,77,36.99574511863
transformers_4.23.0,examples/tensorflow/question-answering/utils_qa.py,443,190,250,15,131,94,182,146,276,979.981772135534,10.4198473282443,20677.0572848279,1148.72540471266,1984.39157825088,83,45.2713819160691
transformers_4.23.0,examples/tensorflow/question-answering/run_qa.py,801,338,561,18,96,91,165,114,256,707.215050095193,15.46875,27058.2444560924,1503.23580311624,1749.21984362617,77,37.4405536471692
transformers_4.23.0,examples/tensorflow/translation/run_translation.py,690,295,509,12,92,78,141,104,219,643.187249965899,9.19565217391304,13493.6659602051,749.648108900285,1467.3962982729,76,37.6629994243439
transformers_4.23.0,examples/tensorflow/language-modeling/run_clm.py,614,267,450,15,80,79,146,95,225,564.357606525117,13.6875,20233.1021937817,1124.06123298787,1478.21751187446,69,40.2116858519593
transformers_4.23.0,examples/tensorflow/language-modeling/run_mlm.py,637,276,465,15,87,83,152,102,235,619.139443072967,13.1034482758621,20546.4683806226,1141.47046559014,1568.0199553633,70,39.7630226805167
transformers_4.23.0,examples/tensorflow/benchmarking/plot_csv_file.py,178,99,126,7,14,10,18,21,28,72.9544533632097,4.5,553.431995270124,30.7462219594513,122.984887837805,25,59.9601780008079
transformers_4.23.0,examples/tensorflow/benchmarking/run_benchmark_tf.py,48,27,24,5,12,8,14,17,22,54.6291904830907,2.91666666666667,262.278865646897,14.5710480914943,89.9241825075075,6,82.7995569673769
transformers_4.23.0,examples/pytorch/conftest.py,45,14,14,0,0,0,0,0,0,0,0,0,0,0,2,100
transformers_4.23.0,examples/pytorch/test_accelerate_examples.py,333,155,271,4,30,15,30,34,45,155.206717868256,2,457.871655712531,25.4373142062517,228.935827856265,20,48.2570587609958
transformers_4.23.0,examples/pytorch/test_pytorch_examples.py,588,216,497,6,22,11,22,28,33,113.617270614347,3,475.928137283703,26.4404520713168,158.642712427901,39,39.657051667495
transformers_4.23.0,examples/pytorch/xla_spawn.py,83,23,34,2,6,3,6,8,9,17.5097750043269,1,27,1.5,27,2,87.2054647193187
transformers_4.23.0,examples/pytorch/test_xla_examples.py,94,38,61,1,2,1,2,3,3,2,0.5,2.37744375108173,0.13208020839343,4.75488750216347,4,85.2889945460733
transformers_4.23.0,examples/pytorch/text-classification/run_glue.py,622,315,468,15,116,101,192,131,293,854.129154368926,12.4137931034483,25582.2571793852,1421.23650996584,2060.79293945047,107,30.9661736810388
transformers_4.23.0,examples/pytorch/text-classification/run_xnli.py,436,172,330,10,25,23,42,35,65,149.315685693242,8.4,2800.58852725195,155.588251513997,333.403396101423,43,50.1087896884428
transformers_4.23.0,examples/pytorch/text-classification/run_glue_no_trainer.py,633,324,491,19,112,111,210,131,321,843.13437402588,17.8125,40215.7939559783,2234.21077533213,2257.72878349352,103,29.7032813691871
transformers_4.23.0,examples/pytorch/multiple-choice/run_swag_no_trainer.py,658,307,484,18,70,65,122,88,187,504.108461212109,15.6857142857143,18946.989378976,1052.61052105422,1207.91371268517,79,37.4230971951191
transformers_4.23.0,examples/pytorch/multiple-choice/run_swag.py,480,198,338,13,54,45,83,67,128,358.869641452662,9.99074074074074,7757.40472474541,430.966929152523,776.459416378595,55,47.5593627171701
transformers_4.23.0,examples/pytorch/text-generation/run_generation.py,290,125,193,9,50,32,60,59,92,310.722134501717,5.4,2922.49706692296,162.360948162387,541.20316054129,32,54.6843841082088
transformers_4.23.0,examples/pytorch/token-classification/run_ner_no_trainer.py,770,389,606,20,113,102,190,133,292,857.118784650664,16.8141592920354,34639.5636744784,1924.42020413769,2060.14247116635,101,28.271429321539
transformers_4.23.0,examples/pytorch/token-classification/run_ner.py,630,305,480,12,80,67,122,92,189,548.773797599643,9.15,11281.5218687072,626.751214928178,1232.95320969478,80,35.7901454297516
transformers_4.23.0,examples/pytorch/summarization/run_summarization_no_trainer.py,759,340,610,18,97,92,172,115,264,715.250195718113,15.9587628865979,28840.8258773148,1602.26810429527,1807.20937344932,91,29.3665189489927
transformers_4.23.0,examples/pytorch/summarization/run_summarization.py,732,324,580,13,93,84,156,106,240,656.247485768881,10.9032258064516,17605.4486217473,978.080478985962,1614.70090909517,90,30.5990487961151
transformers_4.23.0,examples/pytorch/image-classification/run_image_classification.py,388,166,290,12,50,35,69,62,104,325.21235949739,8.28,5127.27752680035,284.848751488908,619.236416280235,44,47.9355501195484
transformers_4.23.0,examples/pytorch/image-classification/run_image_classification_no_trainer.py,576,270,450,19,77,71,139,96,210,563.253186388936,17.1493506493506,23714.8444969153,1317.49136093974,1382.84212515144,73,35.6176916504501
transformers_4.23.0,examples/pytorch/image-pretraining/run_mae.py,384,184,282,13,53,36,71,66,107,351.685500427684,8.70754716981132,5631.6076190751,312.867089948616,646.750170771355,47,47.4661903876407
transformers_4.23.0,examples/pytorch/image-pretraining/run_mim.py,467,220,346,16,62,45,89,78,134,433.160171243986,11.4838709677419,9672.22024027757,537.34556890431,842.243897327541,57,43.2345205648342
transformers_4.23.0,examples/pytorch/question-answering/utils_qa.py,443,190,250,15,131,94,182,146,276,979.981772135534,10.4198473282443,20677.0572848279,1148.72540471266,1984.39157825088,83,45.2713819160691
transformers_4.23.0,examples/pytorch/question-answering/run_qa_beam_search_no_trainer.py,1014,465,732,20,137,134,243,157,377,1058.86895726334,17.7372262773723,48778.649739176,2709.92498550978,2750.07202233214,95,29.3450128042833
transformers_4.23.0,examples/pytorch/question-answering/trainer_seq2seq_qa.py,141,63,96,7,22,17,32,29,49,117.758980064424,5.09090909090909,1211.84544096637,67.3247467203538,238.041068761251,23,67.0582338312984
transformers_4.23.0,examples/pytorch/question-answering/trainer_qa.py,105,52,65,5,16,13,24,21,37,75.6096404744368,3.75,609.434042410553,33.8574468005863,162.515744642814,21,72.5166546044194
transformers_4.23.0,examples/pytorch/question-answering/run_qa_beam_search.py,714,304,522,16,101,90,169,117,259,736.479359757931,13.3861386138614,23819.6225062087,1323.31236145604,1779.4244623721,68,38.3685555790612
transformers_4.23.0,examples/pytorch/question-answering/run_seq2seq_qa.py,715,320,548,11,85,82,152,96,234,582.851977376715,9.83529411764706,15155.020049895,841.9455583275,1540.88122516875,83,33.8162411411502
transformers_4.23.0,examples/pytorch/question-answering/run_qa.py,681,285,493,15,87,81,152,102,233,619.139443072967,13.1034482758621,20371.6048199364,1131.7558233298,1554.67510467936,69,39.5062544778766
transformers_4.23.0,examples/pytorch/question-answering/run_qa_no_trainer.py,992,441,715,20,124,121,225,144,346,948.75890438572,18.1451612903226,45014.4081743777,2500.8004541321,2480.79405049904,103,29.077279362022
transformers_4.23.0,examples/pytorch/speech-recognition/run_speech_recognition_seq2seq.py,524,223,373,11,45,34,65,56,99,285.187137139846,7.94444444444444,4567.48464619831,253.749147011017,574.928137283703,50,46.7725607451904
transformers_4.23.0,examples/pytorch/speech-recognition/run_speech_recognition_ctc.py,772,301,544,14,62,46,86,76,132,422.463140152793,9.70967741935484,8007.82761174647,444.879311763693,824.726431774553,51,43.0865379636882
transformers_4.23.0,examples/pytorch/translation/run_translation.py,656,293,504,12,89,79,146,101,225,619.359825364663,9.84269662921348,14745.3200365211,819.184446473395,1498.09758361915,83,34.0704841827038
transformers_4.23.0,examples/pytorch/translation/run_translation_no_trainer.py,750,334,579,19,108,104,196,127,300,810.238472989083,17.2407407407407,36147.0302410272,2008.16834672373,2096.60540603165,94,30.2725199465469
transformers_4.23.0,examples/pytorch/semantic-segmentation/run_semantic_segmentation.py,512,265,374,14,64,46,89,78,135,437.302968908806,9.734375,8259.90240027202,458.883466681779,848.529299546404,68,38.7849938191208
transformers_4.23.0,examples/pytorch/semantic-segmentation/run_semantic_segmentation_no_trainer.py,684,359,527,19,80,72,139,99,211,586.464870346417,16.50625,23088.8475368499,1282.71375204722,1398.7942468368,88,29.2183761056945
transformers_4.23.0,examples/pytorch/audio-classification/run_audio_classification.py,411,176,307,15,45,32,61,60,93,305.736748268963,10.1666666666667,5584.96505814786,310.27583656377,549.340825391592,39,48.7635857800171
transformers_4.23.0,examples/pytorch/language-modeling/run_plm.py,553,240,420,16,74,61,115,90,176,523.499549056542,12.4324324324324,14204.8763967257,789.159799818094,1142.56614495402,66,40.5652937763967
transformers_4.23.0,examples/pytorch/language-modeling/run_clm_no_trainer.py,670,308,516,19,91,88,166,110,254,672.91993501351,17.3296703296703,29849.7569684617,1658.3198315812,1722.46536723526,81,34.0489346485133
transformers_4.23.0,examples/pytorch/language-modeling/run_mlm_no_trainer.py,715,319,547,19,97,92,173,116,265,720.90216844758,16.9432989690722,30792.1579160353,1710.67543977974,1817.36496370881,84,33.8259385419715
transformers_4.23.0,examples/pytorch/language-modeling/run_clm.py,580,258,437,17,82,72,132,99,204,590.806132679939,13.6829268292683,18504.6363177656,1028.03535098698,1352.38875049624,74,38.375999974074
transformers_4.23.0,examples/pytorch/language-modeling/run_mlm.py,613,266,465,15,89,75,136,104,211,634.943634290137,11.4606741573034,16203.0183835767,900.167687976483,1413.79278052777,77,37.8014157978928
transformers_4.23.0,examples/pytorch/speech-pretraining/run_wav2vec2_pretraining_no_trainer.py,741,295,544,18,104,89,171,122,260,771.904380712635,14.7980769230769,26666.0119062732,1481.44510590407,1801.99170776635,66,37.3033518956557
transformers_4.23.0,examples/pytorch/contrastive-image-text/run_clip.py,531,257,399,12,55,57,105,67,162,360.99433425251,11.4545454545455,11256.4556868749,625.358649270829,982.706448854159,72,39.2180601180647
transformers_4.23.0,examples/pytorch/benchmarking/plot_csv_file.py,178,99,126,7,14,10,18,21,28,72.9544533632097,4.5,553.431995270124,30.7462219594513,122.984887837805,25,59.9601780008079
transformers_4.23.0,examples/pytorch/benchmarking/run_benchmark.py,48,26,23,5,12,8,14,17,22,54.6291904830907,2.91666666666667,262.278865646897,14.5710480914943,89.9241825075075,6,82.8856038242335
transformers_4.23.0,examples/research_projects/movement-pruning/counts_parameters.py,97,44,66,10,30,21,41,40,62,180.425998817129,6.83333333333333,2254.72353620061,125.262418677812,329.959541883016,10,71.383321784432
transformers_4.23.0,examples/research_projects/movement-pruning/masked_run_glue.py,964,468,800,19,325,280,523,344,803,2792.60679282807,15.2876923076923,103440.96872705,5746.72048483609,6766.29059802579,173,8.69012906127323
transformers_4.23.0,examples/research_projects/movement-pruning/masked_run_squad.py,1149,511,935,20,327,281,522,347,803,2817.91757383562,15.9633027522936,108172.924332655,6009.60690736972,6776.34985762034,183,6.4063666158778
transformers_4.23.0,examples/research_projects/movement-pruning/bertarize.py,137,76,103,9,32,29,54,41,83,188.529325012981,7.59375,3376.76457441069,187.598031911705,444.676816383301,18,60.286510975837
transformers_4.23.0,examples/research_projects/movement-pruning/emmental/modeling_bert_masked.py,1019,429,667,15,112,133,224,127,357,821.027110204579,15,37424.406497665,2079.13369431472,2494.96043317766,96,32.8414524720457
transformers_4.23.0,examples/research_projects/movement-pruning/emmental/__init__.py,10,3,9,0,0,0,0,0,0,0,0,0,0,0,1,100
transformers_4.23.0,examples/research_projects/movement-pruning/emmental/configuration_bert_masked.py,71,24,41,0,0,0,0,0,0,0,0,0,0,0,2,100
transformers_4.23.0,examples/research_projects/movement-pruning/emmental/modules/__init__.py,3,2,2,0,0,0,0,0,0,0,0,0,0,0,1,100
transformers_4.23.0,examples/research_projects/movement-pruning/emmental/modules/masked_nn.py,106,44,49,7,32,21,40,39,61,179.651484454403,4.375,1410.54171715886,78.3634287310479,322.409535350597,14,70.6379598448219
transformers_4.23.0,examples/research_projects/movement-pruning/emmental/modules/binarizer.py,144,52,41,5,13,9,18,18,27,59.715356810271,3.46153846153846,389.727605904031,21.6515336613351,112.587975038942,8,51.2244264788087
transformers_4.23.0,examples/research_projects/quantization-qdqbert/trainer_quant_qa.py,212,104,139,8,28,21,40,36,61,158.605937817613,5.71428571428571,1802.08814335989,100.116007964438,315.365425087981,33,59.493769604741
transformers_4.23.0,examples/research_projects/quantization-qdqbert/utils_qa.py,434,189,243,15,124,89,169,139,258,920.923701422101,10.2217741935484,18774.1977007797,1043.01098337665,1836.68679676267,79,46.1003680338296
transformers_4.23.0,examples/research_projects/quantization-qdqbert/run_quant_qa.py,688,295,495,16,86,86,162,102,248,616.65876890438,15.0697674418605,24936.8707478183,1385.38170821213,1654.76148480893,74,38.2853974327079
transformers_4.23.0,examples/research_projects/quantization-qdqbert/ort-infer-benchmark.py,51,29,43,3,6,3,6,9,9,20.2646625064904,1.5,42.7939875194712,2.37744375108173,28.5293250129808,2,57.6403266213612
transformers_4.23.0,examples/research_projects/quantization-qdqbert/quant_trainer.py,305,210,202,11,55,34,61,66,95,356.028532048867,6.1,3502.72639216822,194.595910676012,574.217441339053,63,41.6423765812851
transformers_4.23.0,examples/research_projects/quantization-qdqbert/evaluate-hf-trt-qa.py,458,190,309,12,36,28,50,48,78,229.136850060577,8.33333333333333,3630.22562546875,201.679201414931,435.62707505625,42,50.986460708139
transformers_4.23.0,examples/research_projects/adversarial/run_hans.py,242,85,166,8,25,14,27,33,41,140.096404744368,4.32,893.463086420769,49.6368381344872,206.820158893697,20,64.2577673543155
transformers_4.23.0,examples/research_projects/adversarial/utils_hans.py,340,142,207,6,25,14,27,31,41,131.606179748695,3.24,658.115437871793,36.5619687706551,203.122048725862,31,59.8408147683371
transformers_4.23.0,examples/research_projects/longform-qa/eli5_app.py,351,166,316,10,46,31,60,56,91,287.303130927496,6.52173913043478,3446.53889939506,191.474383299725,528.469297907242,34,34.6859259183569
transformers_4.23.0,examples/research_projects/longform-qa/eli5_utils.py,688,403,582,19,196,129,254,215,383,1573.19375220201,12.3112244897959,36534.271018065,2029.68172322583,2967.55786139276,105,20.6616896760081
transformers_4.23.0,examples/research_projects/performer/run_mlm_performer.py,692,317,438,19,140,105,196,159,301,1078.81024512772,13.3,29275.6643348899,1626.42579638277,2201.17776954059,59,41.4431261652499
transformers_4.23.0,examples/research_projects/performer/modeling_flax_performer.py,553,287,384,11,44,38,66,55,104,278.268739025051,8.25,4960.40663420416,275.578146344675,601.261410206565,41,43.7958502331159
transformers_4.23.0,examples/research_projects/performer/modeling_flax_performer_utils.py,660,309,433,14,146,128,238,160,366,1103.01735450529,11.4109589041096,30579.3807357955,1698.85448532197,2679.82568272877,39,43.4028711491159
transformers_4.23.0,examples/research_projects/bert-loses-patience/run_glue_with_pabee.py,755,376,611,16,174,152,275,190,427,1359.07216827768,12.6436781609195,40868.5193015293,2270.4732945294,3232.32834475731,123,20.5124152791131
transformers_4.23.0,examples/research_projects/bert-loses-patience/test_run_glue_with_pabee.py,50,23,40,0,0,0,0,0,0,0,0,0,0,0,3,100
transformers_4.23.0,examples/research_projects/bert-loses-patience/pabee/__init__.py,0,0,0,0,0,0,0,0,0,0,0,0,0,0,1,100
transformers_4.23.0,examples/research_projects/bert-loses-patience/pabee/modeling_pabee_bert.py,346,139,195,10,43,47,88,53,135,266.548665401064,10.2325581395349,7912.52267444312,439.584593024618,773.269261366032,37,57.0060047948014
transformers_4.23.0,examples/research_projects/bert-loses-patience/pabee/modeling_pabee_albert.py,320,141,197,10,52,54,101,62,155,329.64214629221,9.71153846153846,8962.78300376025,497.932389097791,922.900428109966,35,55.5739082426198
transformers_4.23.0,examples/research_projects/tapex/run_wikisql_with_tapex.py,649,296,497,12,78,66,120,90,186,533.280923079909,9.23076923076923,11146.012393083,619.22291072683,1207.48467591732,65,37.4741894302296
transformers_4.23.0,examples/research_projects/tapex/run_wikitablequestions_with_tapex.py,625,275,478,12,78,66,120,90,186,533.280923079909,9.23076923076923,11146.012393083,619.22291072683,1207.48467591732,65,38.1814953240232
transformers_4.23.0,examples/research_projects/tapex/wikisql_utils.py,257,161,155,12,61,44,82,73,126,404.79452759999,8.0655737704918,6290.48531236213,349.471406242341,779.917894418882,51,49.5485903715576
transformers_4.23.0,examples/research_projects/tapex/run_tabfact_with_tapex.py,471,220,334,12,60,47,88,72,135,397.432985745165,8.8,7329.87090171347,407.215050095193,832.939875194712,58,45.4757484328647
transformers_4.23.0,examples/research_projects/zero-shot-distillation/distill_classifier.py,338,169,269,11,46,36,60,57,96,292.137597783633,7.17391304347826,4017.08599236389,223.171444020216,559.957441359815,31,43.6440768164196
transformers_4.23.0,examples/research_projects/codeparrot/scripts/validation_loss.py,99,74,74,7,18,11,21,25,32,94.7101344803648,4.08333333333333,606.797208797231,33.7109560442906,148.603398072791,14,59.5313439346418
transformers_4.23.0,examples/research_projects/codeparrot/scripts/pretokenizing.py,49,24,40,3,8,5,10,11,15,28.7548875021635,1.875,97.296514274174,5.40536190412078,51.8914742795595,2,57.6139909499438
transformers_4.23.0,examples/research_projects/codeparrot/scripts/human_eval.py,228,112,130,8,22,13,24,30,37,122.107495610021,4.36363636363636,792.239790709157,44.0133217060643,181.554952037515,22,64.5758906156623
transformers_4.23.0,examples/research_projects/codeparrot/scripts/codeparrot_training.py,326,231,262,16,92,59,115,108,174,664.167699957245,10,11753.5042537644,652.972458542469,1175.35042537644,43,40.0219461271822
transformers_4.23.0,examples/research_projects/codeparrot/scripts/preprocessing.py,215,175,149,12,60,36,71,72,107,397.432985745165,7.1,4687.29202359572,260.405112421985,660.181975154327,34,44.6223193477306
transformers_4.23.0,examples/research_projects/codeparrot/scripts/initialize_model.py,26,10,13,0,0,0,0,0,0,0,0,0,0,0,1,100
transformers_4.23.0,examples/research_projects/codeparrot/scripts/bpe_training.py,32,16,18,0,0,0,0,0,0,0,0,0,0,0,3,100
transformers_4.23.0,examples/research_projects/codeparrot/scripts/arguments.py,220,159,178,1,1,3,3,2,6,0,1.5,9,0.5,6,1,65.4931334460374
transformers_4.23.0,examples/research_projects/codeparrot/scripts/minhash_deduplication.py,269,126,131,11,32,17,34,43,51,198.05374780501,5.84375,1617.19646767481,89.8442482041561,276.739502489807,34,61.4358428955048
transformers_4.23.0,examples/research_projects/codeparrot/scripts/tests/__init__.py,0,0,0,0,0,0,0,0,0,0,0,0,0,0,1,100
transformers_4.23.0,examples/research_projects/codeparrot/scripts/tests/test_deduplicate.py,30,20,23,1,5,3,6,6,9,11.6096404744368,0.6,13.9587975038942,0.775488750216347,23.2646625064904,3,61.6462410287617
transformers_4.23.0,examples/research_projects/codeparrot/examples/train_complexity_predictor.py,132,65,108,1,2,1,2,3,3,2,0.5,2.37744375108173,0.13208020839343,4.75488750216347,7,54.7703078573012
transformers_4.23.0,examples/research_projects/fsner/setup.py,27,5,24,0,0,0,0,0,0,0,0,0,0,0,1,100
transformers_4.23.0,examples/research_projects/fsner/src/fsner/__init__.py,5,3,3,0,0,0,0,0,0,0,0,0,0,0,1,100
transformers_4.23.0,examples/research_projects/fsner/src/fsner/tokenizer_utils.py,102,45,63,5,16,8,16,21,24,75.6096404744368,2.5,263.539045366726,14.6410580759292,105.41561814669,19,75.2199636645161
transformers_4.23.0,examples/research_projects/fsner/src/fsner/model.py,80,47,43,5,13,10,20,18,30,59.715356810271,3.84615384615385,481.145192474113,26.7302884707841,125.097750043269,9,76.098077250786
transformers_4.23.0,examples/research_projects/bertology/run_prune_gpt.py,391,195,294,17,97,77,136,114,213,709.678413993407,11.9175257731959,17344.8334268841,963.601857049116,1455.40557301709,45,42.666112857791
transformers_4.23.0,examples/research_projects/bertology/run_bertology.py,452,206,327,18,105,83,147,123,230,780.054429380905,12.6,20119.4070364731,1117.74483535962,1596.77833622803,46,44.3640392624022
transformers_4.23.0,examples/research_projects/robust-speech-event/eval.py,137,63,83,5,14,9,17,19,26,64.9126093832433,3.03571428571429,335.282850168226,18.6268250093459,110.446115349533,6,70.1035272989544
transformers_4.23.0,examples/research_projects/robust-speech-event/run_speech_recognition_ctc_bnb.py,781,302,556,14,64,48,90,78,138,437.302968908806,9.84375,8538.32607668569,474.35144870476,867.38550620299,55,41.9271503741211
transformers_4.23.0,examples/research_projects/robust-speech-event/run_speech_recognition_ctc_streaming.py,680,275,493,12,56,36,67,68,103,368.23142564388,7.17857142857143,4501.02654294306,250.057030163504,627.008672648785,42,45.2087207685558
transformers_4.23.0,examples/research_projects/jax-projects/model_parallel/run_clm_mp.py,664,326,481,15,116,86,162,131,248,854.129154368926,10.4741379310345,18269.9225760626,1014.99569867015,1744.28890438129,61,37.2909064588901
transformers_4.23.0,examples/research_projects/jax-projects/model_parallel/partitions.py,85,35,47,4,10,5,10,14,15,41.2192809488736,2,114.220647661728,6.34559153676267,57.1103238308641,8,82.1290811392078
transformers_4.23.0,examples/research_projects/jax-projects/big_bird/bigbird_flax.py,321,255,249,12,60,39,72,72,111,397.432985745165,7.2,4931.0040611527,273.944670064039,684.861675160097,23,36.8909136542936
transformers_4.23.0,examples/research_projects/jax-projects/big_bird/evaluate.py,165,108,119,17,74,47,89,91,136,528.986417357798,10.222972972973,9047.94518597571,502.663621443095,885.060071067023,21,46.2674168393145
transformers_4.23.0,examples/research_projects/jax-projects/big_bird/train.py,78,47,62,6,18,10,20,24,30,90.5684250302886,3.33333333333333,458.496250072116,25.4720138928953,137.548875021635,4,58.6457107662884
transformers_4.23.0,examples/research_projects/jax-projects/big_bird/prepare_natural_questions.py,330,207,264,14,95,87,151,109,238,677.439251700246,11.1263157894737,17922.5795562824,995.698864237914,1610.82786929691,48,38.2692622337096
transformers_4.23.0,examples/research_projects/jax-projects/dataset-streaming/run_mlm_flax_stream.py,636,296,416,19,112,78,146,131,224,843.13437402588,12.3839285714286,19510.7154062649,1083.92863368138,1575.48675234439,53,42.4916987607983
transformers_4.23.0,examples/research_projects/jax-projects/wav2vec2/run_wav2vec2_pretrain_flax.py,614,268,425,18,110,77,137,128,214,821.008218513674,11.2090909090909,16791.2181818182,932.845454545455,1498,28,44.3160486277951
transformers_4.23.0,examples/research_projects/jax-projects/hybrid_clip/configuration_hybrid_clip.py,112,40,37,2,6,4,8,8,12,17.5097750043269,1.33333333333333,48,2.66666666666667,36,8,75.652735932817
transformers_4.23.0,examples/research_projects/jax-projects/hybrid_clip/modeling_hybrid_clip.py,423,147,259,10,45,38,67,55,105,280.352670283709,7.44444444444444,4519.09617607178,251.060898670654,607.042769920089,40,55.394699649548
transformers_4.23.0,examples/research_projects/jax-projects/hybrid_clip/run_hybrid_clip.py,579,268,409,11,68,45,88,79,133,452.001221010033,7.11764705882353,5967.45550473024,331.525305818347,838.402839507555,43,43.7718284480901
transformers_4.23.0,examples/research_projects/deebert/test_glue_deebert.py,104,36,84,1,2,1,2,3,3,2,0.5,2.37744375108173,0.13208020839343,4.75488750216347,6,75.8800371103732
transformers_4.23.0,examples/research_projects/deebert/run_glue_deebert.py,735,409,618,18,218,187,338,236,525,1768.52283282733,13.954128440367,57747.5921191896,3208.1995621772,4138.38760091497,146,13.7286600226157
transformers_4.23.0,examples/research_projects/deebert/src/modeling_highway_roberta.py,156,76,103,6,17,23,33,23,56,84.9966433055827,5.82352941176471,1475.21338143412,81.9562989685624,253.319469539193,14,67.0062222619852
transformers_4.23.0,examples/research_projects/deebert/src/__init__.py,0,0,0,0,0,0,0,0,0,0,0,0,0,0,1,100
transformers_4.23.0,examples/research_projects/deebert/src/modeling_highway_bert.py,396,203,253,13,72,63,109,85,172,492.340316439681,9.84027777777778,10848.0721980502,602.670677669454,1102.41524101568,55,48.5790550982671
transformers_4.23.0,examples/research_projects/rag/callbacks_rag.py,117,78,90,5,23,15,29,28,44,115.651565463748,3.15217391304348,666.75922614625,37.0421792303472,211.523616570535,21,56.5554901370497
transformers_4.23.0,examples/research_projects/rag/lightning_base.py,404,178,338,11,43,25,49,54,74,271.3831322572,6.26744186046512,2669.06328966619,148.281293870344,425.861675160097,51,40.3869249950565
transformers_4.23.0,examples/research_projects/rag/test_distributed_retriever.py,338,165,290,5,15,11,16,20,27,70.2129994085646,2.66666666666667,311.17882283189,17.2877123795495,116.692058561959,31,47.776010799966
transformers_4.23.0,examples/research_projects/rag/distributed_ray_retriever.py,151,57,82,6,19,10,20,25,30,96.2203977597551,3.15789473684211,439.944270610237,24.4413483672354,139.315685693242,21,73.0676978305568
transformers_4.23.0,examples/research_projects/rag/__init__.py,5,3,3,0,0,0,0,0,0,0,0,0,0,0,1,100
transformers_4.23.0,examples/research_projects/rag/_test_finetune_rag.py,110,62,95,3,6,3,6,9,9,20.2646625064904,1.5,42.7939875194712,2.37744375108173,28.5293250129808,11,49.2313297839637
transformers_4.23.0,examples/research_projects/rag/use_own_knowledge_dataset.py,209,95,143,5,18,10,20,23,30,86.6682905003984,2.77777777777778,376.963496338084,20.9424164632269,135.70685868171,11,63.356954984399
transformers_4.23.0,examples/research_projects/rag/utils_rag.py,244,155,187,11,49,30,57,60,87,313.174530166655,6.39795918367347,3287.90790918213,182.661550510119,513.899481817941,34,37.3916007859281
transformers_4.23.0,examples/research_projects/rag/parse_dpr_relevance_data.py,47,19,33,2,5,3,6,7,9,13.6096404744368,1.2,30.3194331582221,1.68441295323456,25.2661942985184,4,84.3486848748723
transformers_4.23.0,examples/research_projects/rag/eval_rag.py,320,163,272,12,44,31,60,56,91,283.234541228695,8.18181818181818,4323.83971015016,240.213317230564,528.469297907242,38,34.8358785628199
transformers_4.23.0,examples/research_projects/rag/finetune_rag.py,649,320,550,16,95,65,123,111,188,688.13628279144,10.3578947368421,13230.658736293,735.036596460725,1277.35018287382,98,22.4433506860752
transformers_4.23.0,examples/research_projects/rag/distributed_pytorch_retriever.py,138,59,62,4,10,6,10,14,16,41.2192809488736,2,121.835357505843,6.76863097254685,60.9176787529217,18,74.3121998509071
transformers_4.23.0,examples/research_projects/rag/consolidate_rag_checkpoint.py,102,37,77,3,11,8,16,14,24,42.8086353071737,2.18181818181818,199.366948645925,11.0759415914403,91.3765181293825,7,67.1052001931944
transformers_4.23.0,examples/research_projects/luke/luke_utils.py,115,71,70,11,47,31,60,58,91,299.119423833859,7.02127659574468,3742.87594220598,207.937552344777,533.076270556609,27,64.7561906352045
transformers_4.23.0,examples/research_projects/luke/run_luke_ner_no_trainer.py,712,352,561,19,114,91,168,133,259,859.660084370209,14,25582.4541111273,1421.24745061818,1827.31815079481,60,32.8514930919156
transformers_4.23.0,examples/research_projects/xtreme-s/run_xtreme_s.py,951,395,729,14,89,70,131,103,201,629.643244264816,10.3033707865169,13847.5923333576,769.310685186535,1343.98660596383,90,29.8876767950557
transformers_4.23.0,examples/research_projects/visual_bert/utils.py,560,367,426,16,111,71,130,127,201,818.180161164862,9.36936936936937,13161.3932155212,731.1885119734,1404.72562204121,94,26.899776032768
transformers_4.23.0,examples/research_projects/visual_bert/extracting_data.py,149,101,120,9,28,21,36,37,57,163.135262830594,5.78571428571429,1718.00329922206,95.444627734559,296.93884184085,31,51.958422504243
transformers_4.23.0,examples/research_projects/visual_bert/modeling_frcnn.py,1922,1047,1339,21,381,301,546,402,847,3358.79824431331,15.0472440944882,110257.79004111,6125.43278006166,7327.44078242855,258,0
transformers_4.23.0,examples/research_projects/visual_bert/processing_image.py,149,100,102,9,36,28,51,45,79,214.646625064904,6.375,2765.83451563903,153.657473091057,433.856394610044,26,60.2737989332999
transformers_4.23.0,examples/research_projects/visual_bert/visualizing_image.py,499,171,451,16,105,71,135,121,206,768.995779354943,10.2857142857143,14660.082790751,814.44904393061,1425.28582687857,54,34.3003563606783
transformers_4.23.0,examples/research_projects/seq2seq-distillation/utils.py,645,432,470,15,102,76,138,117,214,739.19074381522,10.1470588235294,14918.7949190248,828.821939945821,1470.25804999085,112,22.4166753541796
transformers_4.23.0,examples/research_projects/seq2seq-distillation/run_eval.py,167,90,122,11,29,17,34,40,51,178.93519666371,6.44827586206897,1750.18028417037,97.2322380094651,271.418332839255,25,57.8590550451287
transformers_4.23.0,examples/research_projects/seq2seq-distillation/_test_seq2seq_examples_multi_gpu.py,164,62,141,8,20,16,27,28,43,110.438561897747,5.4,1116.26781290178,62.0148784945431,206.716261648477,13,54.0619037503401
transformers_4.23.0,examples/research_projects/seq2seq-distillation/lightning_base.py,393,174,331,10,35,21,41,45,62,212.744186541947,5.85714285714286,1994.32722441001,110.795956911667,340.49489197244,48,39.4222119925002
transformers_4.23.0,examples/research_projects/seq2seq-distillation/sentence_splitter.py,22,15,14,0,0,0,0,0,0,0,0,0,0,0,4,100
transformers_4.23.0,examples/research_projects/seq2seq-distillation/convert_pl_checkpoint_to_hf.py,74,47,44,4,7,4,7,11,11,27.6514844544032,2,76.1074956100206,4.2281942005567,38.0537478050103,14,75.7335882213974
transformers_4.23.0,examples/research_projects/seq2seq-distillation/callbacks.py,116,78,89,5,23,16,31,28,47,115.651565463748,3.3695652173913,761.338708851949,42.2965949362194,225.945681336707,22,55.3353772675303
transformers_4.23.0,examples/research_projects/seq2seq-distillation/make_student.py,187,99,142,7,18,17,34,25,51,94.7101344803648,6.61111111111111,1565.75351198571,86.9863062214284,236.836665678511,25,60.3037431492067
transformers_4.23.0,examples/research_projects/seq2seq-distillation/distillation.py,310,204,248,14,68,56,93,82,149,467.25044211383,9.57352941176471,9068.7674543522,503.820414130678,947.275248688095,45,42.0189981797744
transformers_4.23.0,examples/research_projects/seq2seq-distillation/finetune.py,454,269,389,16,86,58,108,102,166,616.65876890438,10.046511627907,11127.74339822,618.207966567778,1107.62260676727,76,27.0301669579008
transformers_4.23.0,examples/research_projects/seq2seq-distillation/_test_bash_script.py,203,107,151,8,45,28,52,53,80,271.133389334835,4.62222222222222,2118.05769697626,117.669872054237,458.233636365056,31,54.4280077355467
transformers_4.23.0,examples/research_projects/seq2seq-distillation/_test_make_student.py,39,29,29,0,0,0,0,0,0,0,0,0,0,0,7,100
transformers_4.23.0,examples/research_projects/seq2seq-distillation/_test_seq2seq_examples.py,444,236,384,10,46,41,67,56,108,287.303130927496,7.28260869565217,4567.61089304444,253.756160724691,627.194331582221,57,32.6259217782878
transformers_4.23.0,examples/research_projects/bertabs/modeling_bertabs.py,1058,559,608,17,161,142,250,178,392,1249.76448567771,13.1987577639752,38678.7947080435,2148.82192822464,2930.48750493883,126,27.3047660763773
transformers_4.23.0,examples/research_projects/bertabs/__init__.py,0,0,0,0,0,0,0,0,0,0,0,0,0,0,1,100
transformers_4.23.0,examples/research_projects/bertabs/configuration_bertabs.py,97,23,37,0,0,0,0,0,0,0,0,0,0,0,2,100
transformers_4.23.0,examples/research_projects/bertabs/utils_summarization.py,167,86,75,10,24,16,27,34,43,143.258380966181,5.625,1230.53007472743,68.3627819293014,218.760902173765,25,66.7815704983386
transformers_4.23.0,examples/research_projects/bertabs/test_utils_summarization.py,98,58,62,0,0,0,0,0,0,0,0,0,0,0,12,100
transformers_4.23.0,examples/research_projects/bertabs/run_summarization.py,348,136,252,6,27,18,29,33,47,143.891737562741,3.22222222222222,763.945464965064,42.4414147202813,237.086523609847,23,53.9037031712686
transformers_4.23.0,examples/research_projects/bertabs/convert_bertabs_original_pytorch_checkpoint.py,185,62,117,3,16,9,18,19,27,68.7548875021635,1.6875,193.546197331273,10.7525665184041,114.694042862977,4,73.315104043426
transformers_4.23.0,examples/research_projects/lxmert/utils.py,560,367,426,16,111,71,130,127,201,818.180161164862,9.36936936936937,13161.3932155212,731.1885119734,1404.72562204121,94,26.899776032768
transformers_4.23.0,examples/research_projects/lxmert/extracting_data.py,149,101,120,9,28,21,36,37,57,163.135262830594,5.78571428571429,1718.00329922206,95.444627734559,296.93884184085,31,51.958422504243
transformers_4.23.0,examples/research_projects/lxmert/modeling_frcnn.py,1922,1047,1339,21,381,301,546,402,847,3358.79824431331,15.0472440944882,110257.79004111,6125.43278006166,7327.44078242855,258,0
transformers_4.23.0,examples/research_projects/lxmert/processing_image.py,149,100,102,9,36,28,51,45,79,214.646625064904,6.375,2765.83451563903,153.657473091057,433.856394610044,26,60.2737989332999
transformers_4.23.0,examples/research_projects/lxmert/visualizing_image.py,499,171,451,16,105,71,135,121,206,768.995779354943,10.2857142857143,14660.082790751,814.44904393061,1425.28582687857,54,34.3003563606783
transformers_4.23.0,examples/research_projects/mlm_wwm/run_chinese_ref.py,163,95,123,12,77,52,106,89,158,525.562113642161,8.25974025974026,8451.08442871365,469.504690484092,1023.16588209269,47,51.9282890715925
transformers_4.23.0,examples/research_projects/mlm_wwm/run_mlm_wwm.py,434,199,320,12,66,47,87,78,134,441.949561886312,7.90909090909091,6661.38355159055,370.076863977253,842.243897327541,59,45.1855350731905
transformers_4.23.0,examples/research_projects/layoutlmv3/run_funsd_cord.py,533,247,407,12,64,52,96,76,148,427.019550008654,9,8322.23944790686,462.346635994825,924.693271989651,62,40.3624691783852
transformers_4.23.0,examples/research_projects/wav2vec2/run_asr.py,480,233,338,10,51,31,59,61,90,322.51297338942,5.7843137254902,3087.4720845548,171.526226919711,533.76636038066,39,48.9406097206965
transformers_4.23.0,examples/research_projects/wav2vec2/test_wav2vec2_deepspeed.py,201,65,140,2,8,4,8,10,12,26,1,39.8631371386484,2.21461872992491,39.8631371386484,12,74.1378274285996
transformers_4.23.0,examples/research_projects/wav2vec2/alignment.py,224,149,150,13,58,52,96,71,148,387.868614053233,10.7586206896552,9792.09389621546,544.005216456414,910.162573686693,20,54.2381473678651
transformers_4.23.0,examples/research_projects/wav2vec2/run_pretrain.py,396,160,264,15,37,30,53,52,83,251.353133462399,10.7432432432432,5083.02047029108,282.390026127282,473.136496605711,24,55.6740284133835
transformers_4.23.0,examples/research_projects/wav2vec2/run_common_voice.py,513,228,358,12,47,34,62,59,96,304.085226037503,7.91489361702128,4469.80741657043,248.322634253913,564.733732738737,39,47.9139597979098
transformers_4.23.0,examples/research_projects/pplm/run_pplm_discrim_train.py,523,309,398,12,67,45,88,79,133,449.447525769325,7.88059701492537,6607.11491432819,367.0619396849,838.402839507555,52,32.7313190517509
transformers_4.23.0,examples/research_projects/pplm/run_pplm.py,827,384,648,17,151,135,238,168,373,1162.48598393934,13.3973509933775,36940.9767454502,2052.27648585834,2757.33439869648,83,26.7806197622101
transformers_4.23.0,examples/research_projects/pplm/pplm_classification_head.py,19,11,10,0,0,0,0,0,0,0,0,0,0,0,3,100
transformers_4.23.0,examples/research_projects/mm-imdb/run_mmimdb.py,576,306,461,17,130,120,214,147,334,982.394683994955,13.9923076923077,33647.1702647381,1869.28723692989,2404.69056317535,87,29.1458931674159
transformers_4.23.0,examples/research_projects/mm-imdb/utils_mmimdb.py,146,71,104,1,2,3,3,3,6,2,0.75,7.1323312532452,0.396240625180289,9.50977500432694,16,72.3447174106491
transformers_4.23.0,examples/research_projects/rag-end2end-retriever/callbacks_rag.py,120,80,92,5,24,16,31,29,47,121.648740491745,3.22916666666667,737.299823948008,40.9611013304449,228.325106770996,22,55.7873865104558
transformers_4.23.0,examples/research_projects/rag-end2end-retriever/lightning_base.py,414,185,345,11,55,32,63,66,95,356.028532048867,6.3,3617.56988043603,200.976104468669,574.217441339053,54,38.2670163382608
transformers_4.23.0,examples/research_projects/rag-end2end-retriever/distributed_ray_retriever.py,185,69,103,6,19,10,20,25,30,96.2203977597551,3.15789473684211,439.944270610237,24.4413483672354,139.315685693242,25,70.6481313757007
transformers_4.23.0,examples/research_projects/rag-end2end-retriever/use_own_knowledge_dataset.py,176,84,123,5,16,10,20,21,30,75.6096404744368,3.125,411.779758385509,22.8766532436394,131.769522683363,10,63.5218243815522
transformers_4.23.0,examples/research_projects/rag-end2end-retriever/utils_rag.py,244,155,187,11,49,30,57,60,87,313.174530166655,6.39795918367347,3287.90790918213,182.661550510119,513.899481817941,34,37.3916007859281
transformers_4.23.0,examples/research_projects/rag-end2end-retriever/eval_rag.py,320,163,272,12,44,31,60,56,91,283.234541228695,8.18181818181818,4323.83971015016,240.213317230564,528.469297907242,38,34.8358785628199
transformers_4.23.0,examples/research_projects/rag-end2end-retriever/finetune_rag.py,822,407,689,17,133,87,164,150,251,1007.83943222291,10.4812030075188,19017.445766108,1056.52476478378,1814.43349131447,112,18.3567345820226
transformers_4.23.0,examples/research_projects/rag-end2end-retriever/kb_encode_utils.py,81,49,59,2,9,5,10,11,15,30.5293250129808,1.11111111111111,57.657193643955,3.20317742466416,51.8914742795595,8,63.2152865599177
transformers_4.23.0,examples/research_projects/distillation/utils.py,133,72,78,12,41,42,78,53,120,262.679182197995,11.4146341463415,7845.85396898218,435.880776054565,687.350454547584,15,66.1162866051217
transformers_4.23.0,examples/research_projects/distillation/train.py,324,158,251,11,62,52,99,73,151,407.213919048997,8.78225806451613,8208.45613417477,456.025340787487,934.663508390883,40,45.3177333888926
transformers_4.23.0,examples/research_projects/distillation/distiller.py,600,363,426,21,182,165,291,203,456,1458.65729039452,16.7884615384615,58682.2739346233,3260.1263297013,3495.39317823644,101,31.5029834629402
transformers_4.23.0,examples/research_projects/distillation/grouped_batch_sampler.py,108,61,57,8,22,17,33,30,50,122.107495610021,6,1472.06717868256,81.7815099268086,245.344529780426,14,71.3792163039776
transformers_4.23.0,examples/research_projects/distillation/run_squad_w_distillation.py,878,391,700,18,184,165,297,202,462,1459.39404994045,14.5271739130435,51398.5025736345,2855.47236520192,3538.09370503133,127,19.3413912175474
transformers_4.23.0,examples/research_projects/distillation/lm_seqs_dataset.py,166,100,91,13,50,32,60,63,92,330.29852582457,7.8,4289.29607310354,238.29422628353,549.909752961992,33,61.9853951624288
transformers_4.23.0,examples/research_projects/distillation/scripts/token_counts.py,56,26,33,2,4,2,4,6,6,10,1,15.5097750043269,0.861654166907052,15.5097750043269,4,89.3968683714619
transformers_4.23.0,examples/research_projects/distillation/scripts/extract_distilbert.py,95,44,64,2,6,3,6,8,9,17.5097750043269,1,27,1.5,27,9,78.9607271185457
transformers_4.23.0,examples/research_projects/distillation/scripts/binarized_data.py,96,62,65,6,16,10,20,22,30,79.5097750043269,3.75,501.686057096696,27.8714476164831,133.782948559119,10,72.2499464344665
transformers_4.23.0,examples/research_projects/distillation/scripts/extract.py,105,56,73,2,7,8,16,9,24,21.6514844544032,2.28571428571429,173.89302865055,9.66072381391943,76.0782000346155,20,72.2100899918302
transformers_4.23.0,examples/research_projects/decision_transformer/run_decision_transformer.py,173,70,146,6,30,35,50,36,85,162.716492872583,5,2197.21812561298,122.067673645166,439.443625122597,5,54.2057189106473
transformers_4.23.0,examples/research_projects/information-gain-filtration/run_clm_igf.py,446,125,279,10,26,22,43,36,65,155.430713620542,8.26923076923077,2778.83468827524,154.37970490418,336.04512509375,17,61.5630874068195
transformers_4.23.0,examples/research_projects/information-gain-filtration/igf/igf.py,419,195,206,12,58,39,77,70,116,382.782447726053,7.96551724137931,5663.45750765715,314.636528203175,710.996829965616,31,54.9806052906462
transformers_4.23.0,examples/research_projects/information-gain-filtration/igf/__init__.py,0,0,0,0,0,0,0,0,0,0,0,0,0,0,1,100
transformers_4.23.0,examples/research_projects/self-training-text-classification/finetuning.py,811,461,611,16,114,103,194,130,297,842.949461614781,13.6140350877193,28394.0202562157,1577.44556978976,2085.64324046945,112,24.3759784088027
transformers_4.23.0,examples/research_projects/self-training-text-classification/selftraining.py,388,228,283,15,42,36,69,57,105,285.080690690836,12.3214285714286,7546.30145582564,419.238969768091,612.453451487298,49,43.9614121529825
transformers_4.23.0,examples/research_projects/onnx/summarization/run_onnx_exporter.py,207,80,148,3,6,3,6,9,9,20.2646625064904,1.5,42.7939875194712,2.37744375108173,28.5293250129808,7,66.6924149882509
transformers_4.23.0,examples/research_projects/onnx/summarization/bart_onnx/generation_onnx.py,758,378,565,19,176,142,259,195,401,1393.57058763559,13.9801136363636,42646.8882444849,2369.27156913805,3050.53945581359,94,26.8767433713545
transformers_4.23.0,examples/research_projects/onnx/summarization/bart_onnx/reduce_onnx_size.py,122,81,79,7,33,25,50,40,75,186.116490393232,5.3030303030303,2116.6759468302,117.593108157233,399.144607116552,23,54.9747964408018
transformers_4.23.0,examples/legacy/run_language_modeling.py,375,148,282,13,40,26,47,53,73,260.982840131329,7.6375,3193.53045043603,177.418358357557,418.138193183114,34,51.4424692725917
transformers_4.23.0,examples/legacy/run_chinese_ref.py,148,95,106,12,77,52,106,89,158,525.562113642161,8.25974025974026,8451.08442871365,469.504690484092,1023.16588209269,47,53.5005332687855
transformers_4.23.0,examples/legacy/run_swag.py,724,365,526,18,173,143,260,191,403,1361.24933340712,13.5260115606936,41304.433141123,2294.69073006239,3053.70381769841,110,27.7951362486135
transformers_4.23.0,examples/legacy/run_openai_gpt.py,320,198,230,13,76,50,93,89,143,522.948207357547,7.95394736842105,7365.59293210189,409.199607338994,926.029880628195,34,48.2811623586228
transformers_4.23.0,examples/legacy/run_transfo_xl.py,145,81,88,10,35,23,45,45,68,212.744186541947,6.42857142857143,2400.7243535384,133.373575196578,373.446010550418,14,66.3918012785162
transformers_4.23.0,examples/legacy/run_camembert.py,47,26,39,2,6,3,6,8,9,17.5097750043269,1,27,1.5,27,5,76.4492276593583
transformers_4.23.0,examples/legacy/text-classification/run_tf_text_classification.py,313,134,224,6,34,20,41,40,61,188.483511606839,3.61764705882353,1174.42430870411,65.2457949280063,324.637613788129,32,53.7440276453376
transformers_4.23.0,examples/legacy/token-classification/tasks.py,163,103,143,7,32,23,46,39,69,179.651484454403,5.03125,1834.8604140419,101.936689668994,364.692753101495,36,41.9556575788578
transformers_4.23.0,examples/legacy/token-classification/utils_ner.py,372,164,243,13,76,57,112,89,169,522.948207357547,9.57894736842105,10483.1899405087,582.39944113937,1094.39894983332,41,52.0239116685642
transformers_4.23.0,examples/legacy/token-classification/run_ner.py,324,128,233,7,22,13,25,29,38,117.758980064424,3.97727272727273,734.217582218145,40.7898656787858,184.603277814848,28,57.849271022363
transformers_4.23.0,examples/legacy/token-classification/run_tf_ner.py,310,124,220,10,31,17,34,41,51,186.799366570867,5.48387096774194,1498.38631871093,83.2436843728294,273.235152235522,25,56.3053623007033
transformers_4.23.0,examples/legacy/token-classification/scripts/preprocess.py,41,26,26,5,7,6,11,12,17,31.26112492884,3.92857142857143,239.424281298163,13.3013489610091,60.9443625122597,5,71.8572040458364
transformers_4.23.0,examples/legacy/pytorch-lightning/lightning_base.py,393,174,331,10,35,21,41,45,62,212.744186541947,5.85714285714286,1994.32722441001,110.795956911667,340.49489197244,48,39.4222119925002
transformers_4.23.0,examples/legacy/pytorch-lightning/run_ner.py,217,133,168,7,22,14,26,29,40,117.758980064424,4.13636363636364,803.775037375653,44.6541687430918,194.319239805103,39,50.7464201709682
transformers_4.23.0,examples/legacy/pytorch-lightning/run_glue.py,203,129,155,7,27,17,31,34,48,148.033447012817,4.01851851851852,981.315054712288,54.5175030395715,244.198216380016,39,41.5492564673778
transformers_4.23.0,examples/legacy/question-answering/run_squad.py,843,378,652,16,167,146,260,183,406,1297.07861684317,12.4550898203593,38005.1389187671,2111.39660659817,3051.37413434332,125,21.5659627437264
transformers_4.23.0,examples/legacy/question-answering/run_squad_trainer.py,186,57,121,6,17,10,19,23,29,84.9966433055827,3.35294117647059,439.849877256603,24.4361042920335,131.183296725653,18,71.7643133612507
transformers_4.23.0,examples/legacy/seq2seq/finetune_trainer.py,375,146,272,8,29,21,38,37,59,164.8814488587,5.24137931034483,1610.97854424001,89.4988080133341,307.357748572108,36,53.5390208806422
transformers_4.23.0,examples/legacy/seq2seq/utils.py,664,437,475,15,105,78,141,120,219,763.599138289071,10.0714285714286,15234.1339072711,846.340772626172,1512.60904043827,112,24.1637457942975
transformers_4.23.0,examples/legacy/seq2seq/run_eval.py,185,91,123,11,33,19,38,44,57,204.518753743839,6.33333333333333,1970.85481432806,109.491934129337,311.187602262326,27,61.6406396848574
transformers_4.23.0,examples/legacy/seq2seq/old_test_fsmt_bleu_score.py,71,33,45,2,4,2,4,6,6,10,1,15.5097750043269,0.861654166907052,15.5097750043269,5,85.4779996147926
transformers_4.23.0,examples/legacy/seq2seq/sentence_splitter.py,35,15,14,0,0,0,0,0,0,0,0,0,0,0,4,100
transformers_4.23.0,examples/legacy/seq2seq/run_distributed_eval.py,262,140,214,13,36,22,44,49,66,234.223016387757,7.94444444444444,2943.97952826441,163.554418236912,370.570849711604,29,51.499293339555
transformers_4.23.0,examples/legacy/seq2seq/old_test_seq2seq_examples_multi_gpu.py,55,20,30,1,4,2,4,5,6,8,0.5,6.96578428466209,0.38698801581456,13.9315685693242,3,92.3969012832702
transformers_4.23.0,examples/legacy/seq2seq/rouge_cli.py,31,13,11,2,4,2,4,6,6,10,1,15.5097750043269,0.861654166907052,15.5097750043269,5,87.7474176305963
transformers_4.23.0,examples/legacy/seq2seq/old_test_tatoeba_conversion.py,38,19,19,1,2,1,2,3,3,2,0.5,2.37744375108173,0.13208020839343,4.75488750216347,5,95.632079094799
transformers_4.23.0,examples/legacy/seq2seq/__init__.py,5,3,3,0,0,0,0,0,0,0,0,0,0,0,1,100
transformers_4.23.0,examples/legacy/seq2seq/pack_dataset.py,88,52,51,5,23,15,30,28,45,115.651565463748,3.26086956521739,705.427080954105,39.1903933863392,216.330971492592,11,73.5081676749319
transformers_4.23.0,examples/legacy/seq2seq/old_test_seq2seq_examples.py,131,71,94,5,23,14,26,28,40,115.651565463748,2.82608695652174,543.440121623903,30.1911178679946,192.294196882304,16,64.9390393765469
transformers_4.23.0,examples/legacy/seq2seq/seq2seq_trainer.py,262,121,182,11,48,39,68,59,107,306.131947839626,7.79166666666667,4904.40853227838,272.467140682132,629.442806281717,50,52.7741131893944
transformers_4.23.0,examples/legacy/seq2seq/seq2seq_training_args.py,59,27,30,0,0,0,0,0,0,0,0,0,0,0,1,100
transformers_4.23.0,examples/legacy/seq2seq/download_wmt.py,67,30,29,3,9,5,10,12,15,33.2842125151443,1.66666666666667,89.6240625180289,4.97911458433494,53.7744375108174,7,81.7500751511226
transformers_4.23.0,examples/legacy/seq2seq/save_len_file.py,56,29,33,1,2,1,2,3,3,2,0.5,2.37744375108173,0.13208020839343,4.75488750216347,2,91.6164746622838
transformers_4.23.0,examples/legacy/seq2seq/old_test_datasets.py,247,151,202,13,78,50,95,91,145,538.36708940709,7.91666666666667,7470.40593072809,415.022551707116,943.630222828811,57,45.1844335082117
transformers_4.23.0,examples/legacy/seq2seq/save_randomly_initialized_model.py,39,11,10,1,2,1,2,3,3,2,0.5,2.37744375108173,0.13208020839343,4.75488750216347,2,74.2654504356407
transformers_4.23.0,examples/legacy/seq2seq/xla_spawn.py,83,23,34,2,6,3,6,8,9,17.5097750043269,1,27,1.5,27,2,87.2054647193187
transformers_4.23.0,examples/legacy/seq2seq/run_eval_search.py,157,68,86,5,15,8,16,20,24,70.2129994085646,2.66666666666667,276.603398072791,15.3668554484884,103.726274277297,22,72.1835571216451
transformers_4.23.0,examples/legacy/seq2seq/convert_model_to_fp16.py,36,16,15,3,5,3,5,8,8,16.3645279766003,1.5,36,2,24,5,89.0389097782268
transformers_4.23.0,examples/legacy/seq2seq/minify_dataset.py,34,15,13,1,2,1,2,3,3,2,0.5,2.37744375108173,0.13208020839343,4.75488750216347,4,93.5313910858761
transformers_4.23.0,examples/legacy/seq2seq/old_test_calculate_rouge.py,110,38,77,2,10,5,10,12,15,35.2192809488736,1,53.7744375108174,2.98746875060096,53.7744375108174,9,74.2048333469388
transformers_4.23.0,examples/legacy/seq2seq/test_data/fsmt/build-eval-data.py,33,20,24,0,0,0,0,0,0,0,0,0,0,0,2,100
transformers_4.23.0,examples/legacy/multiple_choice/utils_multiple_choice.py,579,319,405,11,79,49,95,90,144,536.052426911001,6.61392405063291,6182.87375908664,343.492986615925,934.826845871473,73,34.834657098631
transformers_4.23.0,examples/legacy/multiple_choice/run_multiple_choice.py,245,87,167,8,21,12,23,29,35,116.238665878354,4.38095238095238,744.890419252895,41.3828010696053,170.029334829465,20,64.2077982747307
transformers_4.23.0,templates/adding_a_missing_tokenization_test/cookiecutter-template-{{cookiecutter.modelname}}/test_tokenization_{{cookiecutter.lowercase_modelname}}.py,78,46,48,2,9,5,10,11,15,30.5293250129808,1.11111111111111,57.657193643955,3.20317742466416,51.8914742795595,8,63.2152865599177
transformers_4.23.0,templates/adding_a_new_example_script/{{cookiecutter.directory_name}}/run_{{cookiecutter.example_shortcut}}.py,905,413,692,14,89,70,131,103,201,629.643244264816,10.3033707865169,13847.5923333576,769.310685186535,1343.98660596383,90,29.8876767950557
transformers_4.23.0,templates/adding_a_new_model/cookiecutter-template-{{cookiecutter.modelname}}/configuration_{{cookiecutter.lowercase_modelname}}.py,242,54,110,12,61,44,82,73,126,404.79452759999,8.0655737704918,6290.48531236213,349.471406242341,779.917894418882,51,49.5485903715576
transformers_4.23.0,templates/adding_a_new_model/cookiecutter-template-{{cookiecutter.modelname}}/__init__.py,291,147,251,18,89,90,168,107,258,651.398925381971,16.9887640449438,29548.5315227769,1641.58508459872,1739.2984824915,72,43.6714306479462
transformers_4.23.0,templates/adding_a_new_model/cookiecutter-template-{{cookiecutter.modelname}}/modeling_{{cookiecutter.lowercase_modelname}}.py,3352,1365,2327,24,686,643,1201,710,1844,6573.57552961186,21.0087463556851,366933.91283094,20385.2173794967,17465.7690953389,469,0
transformers_4.23.0,templates/adding_a_new_model/cookiecutter-template-{{cookiecutter.modelname}}/modeling_flax_{{cookiecutter.lowercase_modelname}}.py,3240,1280,2658,20,501,421,748,521,1169,4579.74062528855,14.9301397205589,157518.769160301,8751.04273112783,10550.3881483036,462,0
transformers_4.23.0,templates/adding_a_new_model/cookiecutter-template-{{cookiecutter.modelname}}/modeling_tf_{{cookiecutter.lowercase_modelname}}.py,3040,1107,2159,21,579,396,771,600,1167,5405.96457837412,13.9818652849741,150585.128314849,8365.84046193603,10770.0314118087,439,0
transformers_4.23.0,templates/adding_a_new_model/cookiecutter-template-{{cookiecutter.modelname}}/test_modeling_{{cookiecutter.lowercase_modelname}}.py,1070,524,861,17,161,142,250,178,392,1249.76448567771,13.1987577639752,38678.7947080435,2148.82192822464,2930.48750493883,126,27.3047660763773
transformers_4.23.0,templates/adding_a_new_model/cookiecutter-template-{{cookiecutter.modelname}}/test_modeling_flax_{{cookiecutter.lowercase_modelname}}.py,669,326,547,15,116,86,162,131,248,854.129154368926,10.4741379310345,18269.9225760626,1014.99569867015,1744.28890438129,61,37.2909064588901
transformers_4.23.0,templates/adding_a_new_model/cookiecutter-template-{{cookiecutter.modelname}}/test_modeling_tf_{{cookiecutter.lowercase_modelname}}.py,1054,525,808,20,137,134,243,157,377,1058.86895726334,17.7372262773723,48778.649739176,2709.92498550978,2750.07202233214,95,29.3450128042833
transformers_4.23.0,templates/adding_a_new_model/cookiecutter-template-{{cookiecutter.modelname}}/tokenization_{{cookiecutter.lowercase_modelname}}.py,332,122,156,11,46,36,60,57,96,292.137597783633,7.17391304347826,4017.08599236389,223.171444020216,559.957441359815,31,43.6440768164196
transformers_4.23.0,templates/adding_a_new_model/cookiecutter-template-{{cookiecutter.modelname}}/tokenization_fast_{{cookiecutter.lowercase_modelname}}.py,201,73,110,8,28,21,40,36,61,158.605937817613,5.71428571428571,1802.08814335989,100.116007964438,315.365425087981,33,59.493769604741
transformers_4.23.0,templates/adding_a_new_model/cookiecutter-template-{{cookiecutter.modelname}}/to_replace_{{cookiecutter.lowercase_modelname}}.py,472,146,259,11,85,66,121,96,187,582.851977376715,7.82941176470588,9641.04359730585,535.613533183658,1231.38798763486,34,44.1520546080668
