Project,Files,LOC,LLOC,SLOC,h1,h2,N1,N2,N,Length,Calculated_length,Difficulty,Effort,Time,Halstead_Volume,Cyclomatic_Complexity,Maintainabilty_Index,Bug Occurence,Buggy
transformers_2.0.0,./hubconf.py,112,27,23,0,0,0,0,0,0,0,0,0,0,0,1,100,0,0
transformers_2.0.0,./setup.py,72,5,36,0,0,0,0,0,0,0,0,0,0,0,1,100,0,0
transformers_2.0.0,docs/source/conf.py,188,30,61,0,0,0,0,0,0,0,0,0,0,0,1,100,0,0
transformers_2.0.0,transformers/configuration_auto.py,135,36,36,1,9,8,16,10,24,28.5293250129808,0.888888888888889,70.8677993575971,3.93709996431095,79.7262742772967,11,56.2265024638736,0,0
transformers_2.0.0,transformers/convert_bert_pytorch_checkpoint_to_original_tf.py,130,48,81,4,7,4,7,11,11,27.6514844544032,2,76.1074956100206,4.2281942005567,38.0537478050103,6,78.8940812814794,0,0
transformers_2.0.0,transformers/modeling_tf_pytorch_utils.py,291,170,168,11,61,42,77,72,119,399.828725396346,6.94262295081967,5097.42008746209,283.190004859005,734.221075171635,44,53.4457794913328,0,0
transformers_2.0.0,transformers/modeling_distilbert.py,695,339,374,15,107,94,160,122,254,779.94032647905,11.214953271028,19742.8854251324,1096.82696806291,1760.40728374097,70,41.6450977682888,0,0
transformers_2.0.0,transformers/modeling_gpt2.py,657,342,391,14,140,139,225,154,364,1051.4025912811,11.25,29757.4908841456,1653.19393800809,2645.11030081294,72,39.9718095850028,0,0
transformers_2.0.0,transformers/modeling_transfo_xl.py,890,534,606,20,209,184,336,229,520,1697.27662050265,16.0765550239234,65534.2433424066,3640.79129680037,4076.38596981041,149,20.4650041314774,0,0
transformers_2.0.0,transformers/convert_openai_original_tf_checkpoint_to_pytorch.py,75,29,45,2,10,6,12,12,18,35.2192809488736,1.2,77.435190015577,4.30195500086539,64.5293250129808,3,83.2786209172969,0,0
transformers_2.0.0,transformers/configuration_roberta.py,35,9,12,0,0,0,0,0,0,0,0,0,0,0,1,100,0,0
transformers_2.0.0,transformers/modeling_openai.py,621,337,369,14,135,130,215,149,345,1008.67307451067,11.1481481481482,27765.7242595331,1542.54023664073,2490.61313955945,73,40.0023982001245,0,0
transformers_2.0.0,transformers/modeling_tf_xlm.py,746,348,425,17,124,97,182,141,279,931.807210789228,12.4758064516129,24850.9933698621,1380.61074277012,1991.93482731926,82,39.5482175916748,0,0
transformers_2.0.0,transformers/convert_roberta_original_pytorch_checkpoint_to_pytorch.py,180,103,129,4,10,12,23,14,35,41.2192809488736,4.6,612.984142451274,34.0546745806263,133.257422272016,13,65.0276730030666,0,0
transformers_2.0.0,transformers/tokenization_gpt2.py,230,152,155,11,45,32,62,56,94,285.187137139846,7.57777777777778,4136.64343714743,229.813524285968,545.891362673415,38,54.5588637431171,0,0
transformers_2.0.0,transformers/tokenization_utils.py,991,528,543,14,211,138,266,225,404,1682.45489772602,8.82464454976303,27857.3520072542,1547.63066706968,3156.76760125168,170,22.1241324668551,0,0
transformers_2.0.0,transformers/tokenization_transfo_xl.py,579,401,415,19,135,103,204,154,307,1036.08072835729,14.3555555555556,32025.8586738599,1779.21437076999,2230.90346799333,132,23.1387443233262,0,0
transformers_2.0.0,transformers/convert_pytorch_checkpoint_to_tf2.py,233,99,177,11,38,30,54,49,84,237.474993315867,7.81578947368421,3686.20476818385,204.789153787992,471.635626905678,24,55.6821538773683,0,0
transformers_2.0.0,transformers/modeling_transfo_xl_utilities.py,332,208,198,17,85,82,143,102,225,614.285097872961,14.3,21468.5285377933,1192.69602987741,1501.29570194359,37,50.3276774262534,0,0
transformers_2.0.0,transformers/configuration_utils.py,207,94,95,4,8,6,11,12,17,32,2.75,167.596996908714,9.31094427270634,60.9443625122597,24,69.9170122790468,0,0
transformers_2.0.0,transformers/convert_gpt2_original_tf_checkpoint_to_pytorch.py,75,29,45,2,10,6,12,12,18,35.2192809488736,1.2,77.435190015577,4.30195500086539,64.5293250129808,3,83.2786209172969,0,0
transformers_2.0.0,transformers/optimization.py,189,102,94,15,62,53,99,77,152,427.763530178114,11.9758064516129,11407.5730481101,633.754058228339,952.551554185625,29,60.4353129285914,0,0
transformers_2.0.0,transformers/configuration_xlnet.py,170,68,95,6,11,7,13,17,20,53.5635228093372,3.54545454545455,289.838274197751,16.1021263443195,81.7492568250068,14,73.9507729602612,0,0
transformers_2.0.0,transformers/modeling_utils.py,798,416,412,14,141,156,262,155,418,1059.97970959704,13.0070921985816,39560.0303728801,2197.77946516001,3041.42000140463,115,32.0940864481404,0,0
transformers_2.0.0,transformers/configuration_gpt2.py,143,53,75,3,6,3,6,9,9,20.2646625064904,1.5,42.7939875194712,2.37744375108173,28.5293250129808,11,79.6794608071296,0,0
transformers_2.0.0,transformers/configuration_xlm.py,181,70,111,3,6,3,6,9,9,20.2646625064904,1.5,42.7939875194712,2.37744375108173,28.5293250129808,12,76.8472150021189,0,0
transformers_2.0.0,transformers/tokenization_distilbert.py,62,20,24,0,0,0,0,0,0,0,0,0,0,0,1,100,0,0
transformers_2.0.0,transformers/__init__.py,164,61,130,2,6,4,6,8,10,17.5097750043269,1,30,1.66666666666667,30,9,66.7171788354351,0,0
transformers_2.0.0,transformers/file_utils.py,324,223,216,11,74,47,83,85,130,497.553296861553,6.16891891891892,5140.07169060935,285.559538367186,833.220821697901,48,47.5680849228022,0,0
transformers_2.0.0,transformers/modeling_tf_transfo_xl.py,763,396,498,18,134,106,195,152,301,1021.9146015473,13.0970149253731,28572.7906612996,1587.37725896109,2181.62618154652,87,34.2946712769789,0,0
transformers_2.0.0,transformers/modeling_tf_gpt2.py,613,306,357,14,118,103,176,132,279,865.454848733504,10.4406779661017,20519.9618801597,1139.99788223109,1965.38595930101,63,42.7851263454507,0,0
transformers_2.0.0,transformers/modeling_tf_utils.py,485,202,212,12,68,51,94,80,145,456.967023213677,8.29411764705882,7603.04822941013,422.391568300563,916.679573758668,67,47.1067689789109,0,0
transformers_2.0.0,transformers/__main__.py,129,94,115,7,49,31,62,56,93,294.772266816048,4.42857142857143,2391.80060575601,132.87781143089,540.084007751357,30,48.0957080381902,0,0
transformers_2.0.0,transformers/modeling_tf_transfo_xl_utilities.py,175,115,134,12,43,38,73,55,111,276.348934460844,10.1860465116279,6536.70108260795,363.150060144886,641.730928201237,24,53.5469877899339,0,0
transformers_2.0.0,transformers/configuration_openai.py,134,55,79,3,6,3,6,9,9,20.2646625064904,1.5,42.7939875194712,2.37744375108173,28.5293250129808,11,79.4131937025166,0,0
transformers_2.0.0,transformers/convert_xlm_original_pytorch_checkpoint_to_pytorch.py,83,41,48,7,26,17,32,33,49,141.862917126072,4.30769230769231,1064.75518950151,59.1530660834171,247.175311848564,9,74.7696503528646,0,0
transformers_2.0.0,transformers/modeling_tf_distilbert.py,745,330,396,14,90,63,116,104,179,637.569747578477,9.02222222222222,10821.0612461375,601.170069229859,1199.37870954726,62,44.2879780702192,0,0
transformers_2.0.0,transformers/convert_transfo_xl_original_tf_checkpoint_to_pytorch.py,117,60,80,2,12,7,14,14,21,45.0195500086539,1.16666666666667,93.2801955904113,5.18223308835618,79.9544533632097,6,72.6113822717164,0,0
transformers_2.0.0,transformers/tokenization_roberta.py,110,42,58,2,24,14,28,26,42,112.039100017308,1.16666666666667,230.321546188914,12.7956414549396,197.418468161926,6,76.8473598451188,0,0
transformers_2.0.0,transformers/modeling_tf_bert.py,1044,464,561,15,116,90,165,131,255,854.129154368926,10.6681034482759,19133.4874648505,1062.97152582503,1793.52286539205,97,35.0996930945663,0,0
transformers_2.0.0,transformers/convert_xlnet_original_tf_checkpoint_to_pytorch.py,104,42,73,3,6,4,8,9,12,20.2646625064904,2,76.0782000346155,4.22656666858975,38.0391000173078,5,77.9041210932257,0,0
transformers_2.0.0,transformers/modeling_xlm.py,886,404,494,19,155,144,256,174,400,1208.50990557294,15.6903225806452,46712.8737597525,2595.15965331958,2977.17739833949,98,34.8784027725995,0,0
transformers_2.0.0,transformers/convert_bert_original_tf_checkpoint_to_pytorch.py,65,23,37,1,2,1,2,3,3,2,0.5,2.37744375108173,0.13208020839343,4.75488750216347,2,94.2945825026617,0,0
transformers_2.0.0,transformers/tokenization_xlnet.py,228,140,145,9,53,34,62,62,96,332.10910910483,5.26415094339623,3009.00365995098,167.166869997277,571.60284579714,42,54.6546975105149,0,0
transformers_2.0.0,transformers/modeling_bert.py,1147,549,633,16,166,161,272,182,433,1288.25654560359,13.1084337349398,42613.8805563394,2367.43780868552,3250.87507920604,120,28.5949973494996,0,0
transformers_2.0.0,transformers/tokenization_auto.py,120,36,36,1,9,8,16,10,24,28.5293250129808,0.888888888888889,70.8677993575971,3.93709996431095,79.7262742772967,11,63.2413524335326,0,0
transformers_2.0.0,transformers/modeling_tf_auto.py,501,95,96,1,9,25,50,10,75,28.5293250129808,2.77777777777778,692.068353101534,38.4482418389741,249.144607116552,34,21.2529612774579,0,0
transformers_2.0.0,transformers/tokenization_openai.py,208,149,147,11,34,26,48,45,74,211.027484407522,7.76470588235294,3155.5541791146,175.308565506367,406.397129128396,32,53.8324871674737,0,0
transformers_2.0.0,transformers/configuration_distilbert.py,89,45,64,3,6,3,6,9,9,20.2646625064904,1.5,42.7939875194712,2.37744375108173,28.5293250129808,10,76.5068926431678,0,0
transformers_2.0.0,transformers/modeling_tf_xlnet.py,1089,485,590,16,183,164,305,199,469,1439.37307040598,13.3333333333333,47754.3592937996,2653.01996076664,3581.57694703497,130,28.1861951522032,0,0
transformers_2.0.0,transformers/configuration_transfo_xl.py,168,73,102,7,20,11,20,27,31,106.090046352151,3.5,515.905293984736,28.6614052213742,147.401512567068,15,71.1814325892219,0,0
transformers_2.0.0,transformers/modeling_tf_roberta.py,382,125,193,2,12,7,14,14,21,45.0195500086539,1.16666666666667,93.2801955904113,5.18223308835618,79.9544533632097,20,67.4777528219491,0,0
transformers_2.0.0,transformers/modeling_tf_openai.py,576,289,336,14,110,94,161,124,255,799.252537396519,10.2454545454545,18168.4700605503,1009.35944780835,1773.32005914865,59,44.016017389288,0,0
transformers_2.0.0,transformers/tokenization_bert.py,470,249,282,17,147,90,189,164,279,1127.8387029922,10.9285714285714,22433.7016015094,1246.31675563941,2052.75700928845,94,40.3973715744832,0,0
transformers_2.0.0,transformers/modeling_auto.py,497,96,97,1,9,25,50,10,75,28.5293250129808,2.77777777777778,692.068353101534,38.4482418389741,249.144607116552,34,22.2729063101006,0,0
transformers_2.0.0,transformers/tokenization_xlm.py,806,294,653,14,85,57,110,99,167,598.101198480511,9.05882352941176,10029.0466797181,557.169259984338,1107.1025555533,62,36.9294860687009,0,0
transformers_2.0.0,transformers/modeling_xlnet.py,1345,645,770,17,241,251,446,258,697,1976.49319833268,15.7302904564315,87835.1953532812,4879.73307518229,5583.82539703001,165,19.2742097662706,0,0
transformers_2.0.0,transformers/modeling_roberta.py,466,151,219,6,25,35,54,31,89,131.606179748695,6.48,2857.18409612632,158.732449784796,440.923471624432,25,59.2119749949572,0,0
transformers_2.0.0,transformers/configuration_bert.py,113,35,61,3,6,3,6,9,9,20.2646625064904,1.5,42.7939875194712,2.37744375108173,28.5293250129808,7,84.1869430608338,0,0
transformers_2.0.0,transformers/tests/tokenization_transfo_xl_test.py,81,40,48,2,4,2,4,6,6,10,1,15.5097750043269,0.861654166907052,15.5097750043269,11,82.0240915857467,0,0
transformers_2.0.0,transformers/tests/tokenization_utils_test.py,46,26,26,1,2,1,2,3,3,2,0.5,2.37744375108173,0.13208020839343,4.75488750216347,7,92.6537319213762,0,0
transformers_2.0.0,transformers/tests/modeling_tf_gpt2_test.py,232,124,179,1,2,1,2,3,3,2,0.5,2.37744375108173,0.13208020839343,4.75488750216347,11,67.5344008176983,0,0
transformers_2.0.0,transformers/tests/tokenization_openai_test.py,72,36,40,2,4,2,4,6,6,10,1,15.5097750043269,0.861654166907052,15.5097750043269,6,84.8244591526269,0,0
transformers_2.0.0,transformers/tests/modeling_tf_auto_test.py,94,56,60,1,2,1,2,3,3,2,0.5,2.37744375108173,0.13208020839343,4.75488750216347,11,82.1501239618778,0,0
transformers_2.0.0,transformers/tests/modeling_tf_distilbert_test.py,222,119,170,1,2,1,2,3,3,2,0.5,2.37744375108173,0.13208020839343,4.75488750216347,10,68.0990711009265,0,0
transformers_2.0.0,transformers/tests/modeling_tf_transfo_xl_test.py,217,108,164,3,10,6,12,13,18,37.9741684510371,1.8,119.894246867771,6.66079149265397,66.6079149265397,10,58.1698730563175,0,0
transformers_2.0.0,transformers/tests/modeling_tf_xlm_test.py,264,135,203,3,6,3,6,9,9,20.2646625064904,1.5,42.7939875194712,2.37744375108173,28.5293250129808,12,57.337247405127,0,0
transformers_2.0.0,transformers/tests/configuration_common_test.py,63,40,40,2,6,3,6,8,9,17.5097750043269,1,27,1.5,27,8,81.4717082138219,0,0
transformers_2.0.0,transformers/tests/modeling_xlnet_test.py,328,159,263,4,15,14,26,19,40,66.6033589341278,3.46666666666667,589.045948530844,32.7247749183802,169.917100537743,12,49.4497047796414,0,0
transformers_2.0.0,transformers/tests/modeling_common_test.py,730,486,541,12,77,98,136,89,234,525.562113642161,10.5974025974026,16058.47330185,892.137405658332,1515.32162284614,18,33.4710705430931,0,0
transformers_2.0.0,transformers/tests/modeling_roberta_test.py,248,132,196,2,9,8,9,11,17,30.5293250129808,1,58.8103375168341,3.26724097315745,58.8103375168341,13,55.9205725446555,0,0
transformers_2.0.0,transformers/tests/modeling_distilbert_test.py,221,117,171,1,2,1,2,3,3,2,0.5,2.37744375108173,0.13208020839343,4.75488750216347,10,68.2130639018581,0,0
transformers_2.0.0,transformers/tests/tokenization_distilbert_test.py,48,21,22,2,17,9,18,19,27,71.4868683012558,1.05882352941176,121.440751266681,6.74670840370452,114.694042862977,6,85.0703621135796,0,0
transformers_2.0.0,transformers/tests/modeling_bert_test.py,320,177,261,2,3,7,8,5,15,6.75488750216347,2.66666666666667,92.8771237954945,5.1598402108608,34.8289214233104,16,51.5137608955785,0,0
transformers_2.0.0,transformers/tests/__init__.py,0,0,0,0,0,0,0,0,0,0,0,0,0,0,1,100,0,0
transformers_2.0.0,transformers/tests/modeling_tf_xlnet_test.py,302,149,234,4,13,11,20,17,31,56.1057163358342,3.07692307692308,389.881071011571,21.6600595006428,126.711348078761,12,51.7507853317397,0,0
transformers_2.0.0,transformers/tests/modeling_openai_test.py,216,109,165,1,2,1,2,3,3,2,0.5,2.37744375108173,0.13208020839343,4.75488750216347,11,68.6458988782939,0,0
transformers_2.0.0,transformers/tests/modeling_auto_test.py,93,60,64,1,2,1,2,3,3,2,0.5,2.37744375108173,0.13208020839343,4.75488750216347,12,78.9611029743181,0,0
transformers_2.0.0,transformers/tests/conftest.py,19,10,12,1,2,1,2,3,3,2,0.5,2.37744375108173,0.13208020839343,4.75488750216347,4,94.7950750275692,0,0
transformers_2.0.0,transformers/tests/modeling_tf_common_test.py,355,127,134,10,23,18,29,33,47,137.261205938185,6.30434782608696,1494.67590971425,83.0375505396808,237.086523609847,11,60.2617768856096,0,0
transformers_2.0.0,transformers/tests/tokenization_xlm_test.py,82,45,48,2,19,10,20,21,30,82.7106227554281,1.05263157894737,138.704760719329,7.70582003996274,131.769522683363,9,74.670921186441,0,0
transformers_2.0.0,transformers/tests/tokenization_tests_commons.py,277,186,188,6,58,46,82,64,128,355.272672721726,4.24137931034483,3257.37931034483,180.965517241379,768,4,46.8143967384425,0,0
transformers_2.0.0,transformers/tests/modeling_transfo_xl_test.py,217,113,172,3,10,6,12,13,18,37.9741684510371,1.8,119.894246867771,6.66079149265397,66.6079149265397,10,57.3969114518748,0,0
transformers_2.0.0,transformers/tests/modeling_xlm_test.py,325,158,256,4,8,5,10,12,15,32,2.5,134.436093777043,7.46867187650241,53.7744375108174,13,52.2310901359229,0,0
transformers_2.0.0,transformers/tests/modeling_tf_openai_gpt_test.py,231,124,179,1,2,1,2,3,3,2,0.5,2.37744375108173,0.13208020839343,4.75488750216347,11,66.7845046266252,0,0
transformers_2.0.0,transformers/tests/tokenization_auto_test.py,45,24,24,1,2,1,2,3,3,2,0.5,2.37744375108173,0.13208020839343,4.75488750216347,5,93.7159994459414,0,0
transformers_2.0.0,transformers/tests/modeling_gpt2_test.py,248,124,190,2,3,7,8,5,15,6.75488750216347,2.66666666666667,92.8771237954945,5.1598402108608,34.8289214233104,11,60.2674468190484,0,0
transformers_2.0.0,transformers/tests/tokenization_bert_test.py,141,75,94,2,19,10,20,21,30,82.7106227554281,1.05263157894737,138.704760719329,7.70582003996274,131.769522683363,18,62.8018887096557,0,0
transformers_2.0.0,transformers/tests/tokenization_roberta_test.py,98,54,63,2,10,5,10,12,15,35.2192809488736,1,53.7744375108174,2.98746875060096,53.7744375108174,10,73.5248847906414,0,0
transformers_2.0.0,transformers/tests/optimization_test.py,145,103,104,4,11,8,12,15,20,46.0537478050103,2.18181818181818,170.482498717463,9.47124992874792,78.1378119121704,34,59.4981728410801,0,0
transformers_2.0.0,transformers/tests/tokenization_xlnet_test.py,106,48,67,2,42,43,86,44,129,228.477331756708,2.04761904761905,1442.06986612291,80.1149925623838,704.266678804211,11,66.1965110128626,0,0
transformers_2.0.0,transformers/tests/modeling_tf_roberta_test.py,246,129,193,2,9,8,9,11,17,30.5293250129808,1,58.8103375168341,3.26724097315745,58.8103375168341,13,56.249407452775,0,0
transformers_2.0.0,transformers/tests/modeling_tf_bert_test.py,327,178,260,1,2,1,2,3,3,2,0.5,2.37744375108173,0.13208020839343,4.75488750216347,16,59.5512484911473,0,0
transformers_2.0.0,transformers/tests/tokenization_gpt2_test.py,72,40,43,2,6,3,6,8,9,17.5097750043269,1,27,1.5,27,6,81.7205070106887,0,0
transformers_2.0.0,transformers/data/__init__.py,6,5,5,0,0,0,0,0,0,0,0,0,0,0,2,100,0,0
transformers_2.0.0,transformers/data/processors/utils.py,111,58,47,2,5,3,6,7,9,13.6096404744368,1.2,30.3194331582221,1.68441295323456,25.2661942985184,16,77.9430600013085,0,0
transformers_2.0.0,transformers/data/processors/__init__.py,3,2,2,0,0,0,0,0,0,0,0,0,0,0,1,100,0,0
transformers_2.0.0,transformers/data/processors/glue.py,492,284,324,10,66,57,109,76,166,432.149292826532,8.25757575757576,8564.39397183699,475.799665102055,1037.15596723164,81,33.7276571394027,0,0
transformers_2.0.0,transformers/data/metrics/__init__.py,83,57,56,3,23,16,32,26,48,108.796812491475,2.08695652173913,470.861439591177,26.1589688661765,225.621106470772,14,69.0187650812154,0,0
transformers_2.0.0,examples/run_lm_finetuning.py,498,301,355,20,132,125,220,152,345,1016.29858565306,16.6666666666667,41675.5832023006,2315.31017790559,2500.53499213804,91,32.8073729412536,0,0
transformers_2.0.0,examples/test_examples.py,111,50,82,2,8,4,8,10,12,26,1,39.8631371386484,2.21461872992491,39.8631371386484,7,73.4417818729725,0,0
transformers_2.0.0,examples/run_squad.py,535,305,404,15,135,126,221,150,347,1013.97346453599,12.2777777777778,30797.578828781,1710.97660159894,2508.40008560207,103,29.6235622672864,0,0
transformers_2.0.0,examples/utils_multiple_choice.py,463,261,297,13,104,68,134,117,202,744.951447022508,8.375,11622.9395143552,645.718861908624,1387.81367335585,65,41.4569774000756,0,0
transformers_2.0.0,examples/run_multiple_choice.py,542,347,416,16,178,156,280,194,436,1394.68055071202,12.5842696629213,41698.7577426609,2316.59765237005,3313.56199919359,107,26.5184057724615,0,0
transformers_2.0.0,examples/run_glue.py,500,306,379,16,156,137,246,172,383,1200.52274614251,12.6153846153846,35881.4262901806,1993.4125716767,2844.2594010509,103,29.2050350528329,0,0
transformers_2.0.0,examples/run_generation.py,195,110,130,9,32,30,49,41,79,188.529325012981,6.890625,2916.4336607639,162.024092264661,423.246608364829,20,61.5514142169312,0,0
transformers_2.0.0,examples/run_tf_glue.py,48,26,27,0,0,0,0,0,0,0,0,0,0,0,3,100,0,0
transformers_2.0.0,examples/utils_squad_evaluate.py,330,276,292,14,108,77,141,122,218,782.830819142461,9.13888888888889,13807.9539812413,767.108554513403,1510.90073958871,69,27.1366134686025,0,0
transformers_2.0.0,examples/run_bertology.py,348,207,228,18,110,88,156,128,244,821.008218513674,12.7636363636364,21800.2909090909,1211.12727272727,1708,47,46.4379325678071,0,0
transformers_2.0.0,examples/utils_squad.py,996,573,678,19,244,192,361,263,553,2015.81053312077,14.0553278688525,62483.272084423,3471.29289357905,4445.52220107864,147,19.561641194827,0,0
transformers_2.0.0,examples/contrib/run_swag.py,673,376,485,18,184,151,273,202,424,1459.39404994045,13.3532608695652,43359.1285867575,2408.84047704208,3247.08166868676,114,27.4506119880824,0,0
transformers_2.0.0,examples/contrib/run_openai_gpt.py,290,201,208,13,79,53,97,92,150,546.104395441825,7.98101265822785,7809.6945822037,433.871921233539,978.534293408552,36,48.3402201455357,0,0
transformers_2.0.0,examples/contrib/run_transfo_xl.py,153,84,102,10,35,23,45,45,68,212.744186541947,6.42857142857143,2400.7243535384,133.373575196578,373.446010550418,14,64.9440920219433,0,0
transformers_2.0.0,examples/distillation/utils.py,129,72,76,12,41,42,78,53,120,262.679182197995,11.4146341463415,7845.85396898218,435.880776054565,687.350454547584,15,66.225800118315,0,0
transformers_2.0.0,examples/distillation/train.py,247,133,189,9,24,22,39,33,61,138.568425030289,7.3125,2250.11505186633,125.006391770352,307.708041280866,20,53.566350386158,0,0
transformers_2.0.0,examples/distillation/distiller.py,490,328,333,21,171,156,283,192,439,1360.69144592384,17.3771929824561,57862.5517843391,3214.58621024106,3329.79853781659,97,34.4437048811258,0,0
transformers_2.0.0,examples/distillation/dataset.py,201,126,118,13,58,38,69,71,107,387.868614053233,7.73275862068966,5088.332575715,282.685143095278,658.022941787001,37,58.2954619043388,0,0
transformers_2.0.0,examples/distillation/scripts/token_counts.py,51,26,29,2,4,2,4,6,6,10,1,15.5097750043269,0.861654166907052,15.5097750043269,4,89.4953500784336,0,0
transformers_2.0.0,examples/distillation/scripts/extract_for_distil.py,90,53,62,2,7,6,12,9,18,21.6514844544032,1.71428571428571,97.8148286159342,5.43415714532968,57.0586500259616,14,74.0628805179576,0,0
transformers_2.0.0,examples/distillation/scripts/binarized_data.py,86,52,56,5,13,8,16,18,24,59.715356810271,3.07692307692308,307.932923183432,17.1073846213018,100.078200034615,7,74.944816663938,0,0
transformers_3.5.0,./hubconf.py,127,30,32,0,0,0,0,0,0,0,0,0,0,0,1,100,0,0
transformers_3.5.0,./setup.py,166,33,101,3,24,12,24,27,36,114.793987519471,1.5,256.763925116827,14.2646625064904,171.175950077885,3,79.7771335384157,1,1
transformers_3.5.0,src/transformers/convert_funnel_original_tf_checkpoint_to_pytorch.py,61,20,30,1,2,1,2,3,3,2,0.5,2.37744375108173,0.13208020839343,4.75488750216347,2,95.8316665485003,0,0
transformers_3.5.0,src/transformers/configuration_auto.py,348,102,232,6,20,13,25,26,38,101.948336902074,3.75,669.812659835106,37.2118144352836,178.616709289362,21,65.240441431994,1,1
transformers_3.5.0,src/transformers/tokenization_bert_japanese.py,348,141,222,7,33,22,42,40,64,186.116490393232,4.45454545454545,1517.23331868789,84.2907399271049,340.603398072791,45,55.7758493904637,0,0
transformers_3.5.0,src/transformers/modeling_mobilebert.py,1636,745,1191,15,163,196,334,178,530,1256.44604807379,15.3680981595092,60890.5367461505,3382.80759700836,3962.13871841219,193,8.06278637556902,1,1
transformers_3.5.0,src/transformers/configuration_marian.py,99,7,6,0,0,0,0,0,0,0,0,0,0,0,1,100,0,0
transformers_3.5.0,src/transformers/configuration_bert_generation.py,105,19,35,0,0,0,0,0,0,0,0,0,0,0,2,100,0,0
transformers_3.5.0,src/transformers/modeling_tf_pegasus.py,41,12,18,0,0,0,0,0,0,0,0,0,0,0,1,100,0,0
transformers_3.5.0,src/transformers/modeling_lxmert.py,1438,701,975,16,151,155,277,167,432,1156.99911563809,14.6754966887417,46811.3160505756,2600.62866947642,3189.76025434879,182,13.7843448902025,1,1
transformers_3.5.0,src/transformers/convert_bert_pytorch_checkpoint_to_original_tf.py,113,48,61,4,7,4,7,11,11,27.6514844544032,2,76.1074956100206,4.2281942005567,38.0537478050103,6,80.2857168365976,0,0
transformers_3.5.0,src/transformers/tokenization_funnel.py,137,31,80,3,20,12,24,23,36,91.1934493999107,1.8,293.126814752494,16.2848230418052,162.848230418052,6,80.0321990958868,0,0
transformers_3.5.0,src/transformers/tokenization_fsmt.py,555,273,330,13,93,63,122,106,185,656.247485768881,8.52688172043011,10613.1136589967,589.617425499817,1244.66528409419,67,44.5374481121033,0,0
transformers_3.5.0,src/transformers/tokenization_albert.py,319,122,163,11,70,47,87,81,134,467.103558991158,6.83571428571429,5807.21203335656,322.622890742031,849.53990038654,38,58.0878853940794,0,0
transformers_3.5.0,src/transformers/convert_longformer_original_pytorch_lightning_to_pytorch.py,86,31,48,1,2,1,2,3,3,2,0.5,2.37744375108173,0.13208020839343,4.75488750216347,4,90.6359247875242,0,0
transformers_3.5.0,src/transformers/modeling_mbart.py,39,11,20,0,0,0,0,0,0,0,0,0,0,0,1,100,0,0
transformers_3.5.0,src/transformers/modeling_reformer.py,2574,1078,1755,20,435,489,811,455,1300,3899.15770386795,18.6436781609195,214004.061600028,11889.1145333349,11478.6395556119,285,0,1,1
transformers_3.5.0,src/transformers/convert_lxmert_original_tf_checkpoint_to_pytorch.py,61,20,30,1,2,1,2,3,3,2,0.5,2.37744375108173,0.13208020839343,4.75488750216347,2,95.8316665485003,0,0
transformers_3.5.0,src/transformers/modeling_tf_pytorch_utils.py,399,213,258,12,79,56,105,91,161,541.018229114645,7.9746835443038,8355.51405513106,464.195225285059,1047.75493707199,64,45.2314229417601,0,0
transformers_3.5.0,src/transformers/modeling_distilbert.py,946,404,665,14,101,122,207,115,329,725.782328666738,14.3465346534653,32310.7808175867,1795.04337875481,2252.1662267607,104,31.4423026617569,0,0
transformers_3.5.0,src/transformers/tokenization_bert_fast.py,259,48,149,5,29,17,34,34,51,152.491089333136,2.93103448275862,760.487979890352,42.2493322161307,259.460604903767,9,74.3951381894473,0,0
transformers_3.5.0,src/transformers/modeling_gpt2.py,1087,489,803,17,154,183,305,171,488,1188.57199556827,16.8344155844156,60939.1034459919,3385.50574699955,3619.91202726432,130,21.4777368556217,1,1
transformers_3.5.0,src/transformers/modeling_t5.py,1291,582,937,18,210,206,379,228,585,1695.05020873585,16.2428571428571,74428.6804067373,4134.92668926318,4582.24065828637,183,12.3980481186576,1,1
transformers_3.5.0,src/transformers/modeling_transfo_xl.py,1111,621,774,21,231,209,382,252,591,1905.99269444546,17.3636363636364,81862.1213676904,4547.89563153835,4714.57243478845,183,12.2830193989173,0,0
transformers_3.5.0,src/transformers/activations_tf.py,67,29,35,4,36,21,42,40,63,194.117300051923,2.33333333333333,782.323429948442,43.4624127749135,335.281469977904,2,78.0114134424784,0,0
transformers_3.5.0,src/transformers/optimization_tf.py,351,133,198,13,45,28,53,58,81,295.23910567067,7.65555555555556,3632.53401507861,201.807445282145,474.496460605333,47,57.7797646336726,0,0
transformers_3.5.0,src/transformers/configuration_ctrl.py,136,40,57,0,0,0,0,0,0,0,0,0,0,0,6,100,0,0
transformers_3.5.0,src/transformers/configuration_bart.py,224,53,97,3,5,3,8,8,11,16.3645279766003,2.4,79.2,4.4,33,12,74.1819504108758,0,0
transformers_3.5.0,src/transformers/convert_electra_original_tf_checkpoint_to_pytorch.py,79,26,47,1,5,3,6,6,9,11.6096404744368,0.6,13.9587975038942,0.775488750216347,23.2646625064904,4,87.0576457325654,0,0
transformers_3.5.0,src/transformers/convert_openai_original_tf_checkpoint_to_pytorch.py,73,27,42,2,10,6,12,12,18,35.2192809488736,1.2,77.435190015577,4.30195500086539,64.5293250129808,3,84.2717362806934,0,0
transformers_3.5.0,src/transformers/convert_tf_hub_seq_to_seq_bert_to_pytorch.py,88,26,58,1,2,1,2,3,3,2,0.5,2.37744375108173,0.13208020839343,4.75488750216347,3,90.7293933592469,0,0
transformers_3.5.0,src/transformers/modeling_tf_albert.py,1324,559,957,13,137,146,265,150,411,1020.53611170143,12.5729927007299,37354.9205831375,2075.27336572986,2971.04448179381,156,16.1536357303317,0,0
transformers_3.5.0,src/transformers/configuration_roberta.py,64,12,15,0,0,0,0,0,0,0,0,0,0,0,2,100,0,0
transformers_3.5.0,src/transformers/modeling_tf_ctrl.py,677,317,491,12,111,108,184,123,292,797.199711173516,9.94594594594595,20162.5632077225,1120.14240042903,2027.21423555906,84,29.6798089138851,0,0
transformers_3.5.0,src/transformers/tokenization_layoutlm.py,60,18,23,0,0,0,0,0,0,0,0,0,0,0,1,100,0,0
transformers_3.5.0,src/transformers/tokenization_bart_fast.py,151,29,63,1,4,3,6,5,9,8,0.75,15.6730146404897,0.870723035582761,20.8973528539863,9,81.0224102137815,0,0
transformers_3.5.0,src/transformers/modeling_openai.py,841,403,598,15,127,142,240,142,382,946.166314154193,14.1732283464567,38709.9694438694,2150.55385799275,2731.20339965079,99,29.3991273455305,0,0
transformers_3.5.0,src/transformers/configuration_encoder_decoder.py,118,33,34,2,5,3,6,7,9,13.6096404744368,1.2,30.3194331582221,1.68441295323456,25.2661942985184,5,68.0917789240025,0,0
transformers_3.5.0,src/transformers/modeling_tf_xlm.py,1230,541,889,17,168,170,316,185,486,1311.39619532809,15.9880952380952,58520.4478156676,3251.13598975931,3660.25138981093,163,16.8002717693742,0,0
transformers_3.5.0,src/transformers/convert_roberta_original_pytorch_checkpoint_to_pytorch.py,172,101,118,4,9,10,17,13,27,36.5293250129808,3.77777777777778,377.444851250391,20.9691584027995,99.9118723898095,14,66.395872970618,0,0
transformers_3.5.0,src/transformers/tokenization_gpt2.py,306,155,192,12,52,36,70,64,106,339.442415351991,8.07692307692308,5136.92307692308,285.384615384615,636,44,54.0792852288488,0,0
transformers_3.5.0,src/transformers/tokenization_utils.py,838,320,500,18,167,103,209,185,312,1308.13726686913,11.2634730538922,26466.807787402,1470.37821041122,2349.79101568109,98,37.3779479331059,1,1
transformers_3.5.0,src/transformers/convert_prophetnet_original_pytorch_checkpoint_to_pytorch.py,162,101,119,8,36,31,57,44,88,210.117300051923,6.33333333333333,3042.72322212052,169.040179006696,480.429982440082,26,55.9609417767758,0,0
transformers_3.5.0,src/transformers/tokenization_squeezebert.py,61,18,26,0,0,0,0,0,0,0,0,0,0,0,1,100,0,0
transformers_3.5.0,src/transformers/convert_mbart_original_checkpoint_to_pytorch.py,36,21,28,1,2,1,2,3,3,2,0.5,2.37744375108173,0.13208020839343,4.75488750216347,2,77.3063049936403,0,0
transformers_3.5.0,src/transformers/tokenization_transfo_xl.py,798,475,519,19,154,116,229,173,345,1199.79575002244,14.1266233766234,36234.0365563778,2013.00203090988,2564.94673853467,151,23.3746921337208,0,0
transformers_3.5.0,src/transformers/configuration_blenderbot.py,181,12,74,1,2,1,2,3,3,2,0.5,2.37744375108173,0.13208020839343,4.75488750216347,3,91.3954134079825,0,0
transformers_3.5.0,src/transformers/tokenization_xlm_roberta_fast.py,241,60,109,7,55,34,67,62,101,337.626268698259,4.26363636363636,2564.03931842469,142.446628801372,601.373827349074,16,67.4275105412235,0,0
transformers_3.5.0,src/transformers/convert_pytorch_checkpoint_to_tf2.py,448,95,387,11,39,31,56,50,87,244.184434340638,7.8974358974359,3877.76334515907,215.431296953281,491.015488510401,26,49.9839604957103,0,0
transformers_3.5.0,src/transformers/modeling_electra.py,1332,588,999,16,128,161,275,144,436,960,17.1875,53729.6254795583,2984.9791933088,3126.08730062885,153,14.4147296332984,2,1
transformers_3.5.0,src/transformers/modeling_flax_utils.py,193,99,125,8,20,13,24,28,37,110.438561897747,4.8,853.78623415743,47.4325685643017,177.872132116131,21,63.8987652035394,0,0
transformers_3.5.0,src/transformers/modeling_deberta.py,1051,584,749,19,206,224,378,225,602,1664.12973135517,17.4320388349515,81998.5025782114,4555.47236545619,4703.89627711266,168,11.9720418210511,0,0
transformers_3.5.0,src/transformers/tokenization_mobilebert_fast.py,53,19,19,0,0,0,0,0,0,0,0,0,0,0,1,100,0,0
transformers_3.5.0,src/transformers/tokenization_phobert.py,359,169,194,13,87,60,113,100,173,608.641800474674,8.44252873563218,9703.73379598149,539.096321998972,1149.38712083103,46,52.9042753519632,0,0
transformers_3.5.0,src/transformers/modeling_transfo_xl_utilities.py,249,168,152,15,59,63,113,74,176,405.679298846476,14.364406779661,15698.3400680884,872.130003782688,1092.8637923507,35,52.6015738605023,0,0
transformers_3.5.0,src/transformers/configuration_utils.py,564,192,198,10,26,15,29,36,44,155.430713620542,5.57692307692308,1268.62005804623,70.4788921136794,227.476700063462,48,45.4618057819571,2,1
transformers_3.5.0,src/transformers/modeling_retribert.py,212,80,127,8,22,16,32,30,48,122.107495610021,5.81818181818182,1370.36071906449,76.1311510591382,235.530748589209,16,68.1797998727943,1,1
transformers_3.5.0,src/transformers/convert_gpt2_original_tf_checkpoint_to_pytorch.py,67,27,36,2,10,6,12,12,18,35.2192809488736,1.2,77.435190015577,4.30195500086539,64.5293250129808,3,84.7776686898792,0,0
transformers_3.5.0,src/transformers/optimization.py,534,205,229,18,120,106,195,138,301,903.885521498984,14.625,31292.6132242946,1738.47851246081,2139.66586149023,45,46.8636875166234,0,0
transformers_3.5.0,src/transformers/configuration_xlnet.py,221,59,88,5,9,8,15,14,23,40.1389654874176,4.16666666666667,364.871513363854,20.2706396313252,87.5691632073249,11,69.5846594940575,0,0
transformers_3.5.0,src/transformers/trainer_pt_utils.py,362,215,196,18,96,62,121,114,183,707.215050095193,11.34375,14184.4390859672,788.024393664843,1250.41887259215,67,46.9425622816367,0,0
transformers_3.5.0,src/transformers/modeling_utils.py,1700,721,859,20,272,253,437,292,690,2286.22845471784,16.0661764705882,90789.6249720254,5043.86805400141,5650.97894562721,202,13.0701407337177,1,1
transformers_3.5.0,src/transformers/configuration_electra.py,157,28,53,0,0,0,0,0,0,0,0,0,0,0,2,100,0,0
transformers_3.5.0,src/transformers/tokenization_squeezebert_fast.py,68,20,33,0,0,0,0,0,0,0,0,0,0,0,1,100,0,0
transformers_3.5.0,src/transformers/tokenization_electra_fast.py,75,17,43,0,0,0,0,0,0,0,0,0,0,0,1,100,0,0
transformers_3.5.0,src/transformers/configuration_gpt2.py,188,44,71,0,0,0,0,0,0,0,0,0,0,0,6,100,0,0
transformers_3.5.0,src/transformers/modeling_tf_xlm_roberta.py,162,32,89,0,0,0,0,0,0,0,0,0,0,0,1,100,0,0
transformers_3.5.0,src/transformers/configuration_xlm.py,242,60,103,1,2,1,2,3,3,2,0.5,2.37744375108173,0.13208020839343,4.75488750216347,8,79.6920071187559,0,0
transformers_3.5.0,src/transformers/tokenization_distilbert.py,71,19,36,0,0,0,0,0,0,0,0,0,0,0,1,100,0,0
transformers_3.5.0,src/transformers/trainer_utils.py,181,86,79,5,12,7,12,17,19,54.6291904830907,2.5,194.154484959391,10.7863602755217,77.6617939837565,10,72.0200634154684,3,1
transformers_3.5.0,src/transformers/tokenization_longformer.py,56,13,25,0,0,0,0,0,0,0,0,0,0,0,3,100,0,0
transformers_3.5.0,src/transformers/modeling_dpr.py,652,228,405,8,29,54,98,37,152,164.8814488587,13.5172413793103,10703.450666815,594.63614815639,791.8369115756,58,47.3304877624517,0,0
transformers_3.5.0,src/transformers/tokenization_mobilebert.py,48,17,14,0,0,0,0,0,0,0,0,0,0,0,1,100,0,0
transformers_3.5.0,src/transformers/modeling_tf_t5.py,1413,663,1039,16,261,237,445,277,682,2159.28346510474,13.639846743295,75477.0761677937,4193.17089821076,5533.57215724555,210,6.47218784468688,0,0
transformers_3.5.0,src/transformers/tokenization_pegasus.py,158,82,90,6,36,22,44,42,66,201.62707505625,3.66666666666667,1304.94081631246,72.4967120173589,355.892949903398,26,65.9131663518912,0,0
transformers_3.5.0,src/transformers/tokenization_openai_fast.py,76,27,28,0,0,0,0,0,0,0,0,0,0,0,4,100,0,0
transformers_3.5.0,src/transformers/convert_albert_original_tf_checkpoint_to_pytorch.py,61,20,30,1,2,1,2,3,3,2,0.5,2.37744375108173,0.13208020839343,4.75488750216347,2,95.8316665485003,0,0
transformers_3.5.0,src/transformers/modeling_albert.py,1315,581,944,17,166,187,326,183,513,1293.74341390485,16.6927710843374,64359.8806097413,3575.5489227634,3855.55401703971,151,15.5588256776453,1,1
transformers_3.5.0,src/transformers/__init__.py,877,230,818,2,4,3,4,6,7,10,1,18.0947375050481,1.00526319472489,18.0947375050481,11,49.6737908123144,1,1
transformers_3.5.0,src/transformers/file_utils.py,1326,614,878,16,197,134,243,213,377,1565.54420843291,9.86802030456853,28775.0043865385,1598.61135480769,2915.98552682514,140,18.2881394216789,1,1
transformers_3.5.0,src/transformers/trainer.py,1579,785,964,19,352,270,505,371,775,3058.43055251576,13.6292613636364,90155.3616618954,5008.63120343863,6614.83841688112,319,0,6,1
transformers_3.5.0,src/transformers/configuration_prophetnet.py,164,36,71,1,2,1,2,3,3,2,0.5,2.37744375108173,0.13208020839343,4.75488750216347,4,84.6554012906149,0,0
transformers_3.5.0,src/transformers/configuration_retribert.py,107,25,42,0,0,0,0,0,0,0,0,0,0,0,2,100,0,0
transformers_3.5.0,src/transformers/configuration_mobilebert.py,158,37,61,0,0,0,0,0,0,0,0,0,0,0,3,100,0,0
transformers_3.5.0,src/transformers/tokenization_marian.py,277,145,184,8,41,27,53,49,80,243.659632189341,5.17073170731707,2322.57265746814,129.031814303786,449.176787529217,47,52.7699288929983,0,0
transformers_3.5.0,src/transformers/modeling_tf_transfo_xl.py,962,468,684,18,147,124,229,165,353,1133.41048471691,14.0204081632653,36457.4319693667,2025.41288718704,2600.31174162877,118,24.6770350004183,0,0
transformers_3.5.0,src/transformers/convert_blenderbot_original_pytorch_checkpoint_to_pytorch.py,114,60,76,3,10,5,10,13,15,37.9741684510371,1.5,83.2598936581746,4.62554964767637,55.5065957721164,12,72.5411890301915,0,0
transformers_3.5.0,src/transformers/modeling_tf_gpt2.py,810,383,581,15,135,133,229,150,362,1013.97346453599,12.7222222222222,33291.9228780404,1849.55127100225,2616.83236595951,107,28.0341359734883,0,0
transformers_3.5.0,src/transformers/convert_bart_original_pytorch_checkpoint_to_pytorch.py,143,82,99,4,13,8,15,17,23,56.1057163358342,2.30769230769231,216.949950804826,12.0527750447125,94.0116453487578,13,66.9184483713126,0,0
transformers_3.5.0,src/transformers/modeling_tf_lxmert.py,1376,637,976,15,136,131,237,151,368,1022.49830534417,13.0698529411765,34814.5978535832,1934.14432519907,2663.73294407163,167,15.586809280946,0,0
transformers_3.5.0,src/transformers/modeling_flax_auto.py,184,31,51,1,1,1,1,2,2,0,0.5,1,0.055555555555556,2,13,73.0443879071567,0,0
transformers_3.5.0,src/transformers/tokenization_funnel_fast.py,153,33,96,3,20,12,24,23,36,91.1934493999107,1.8,293.126814752494,16.2848230418052,162.848230418052,6,78.6463694035905,0,0
transformers_3.5.0,src/transformers/tokenization_rag.py,102,48,72,1,6,4,8,7,12,15.5097750043269,0.666666666666667,22.4588393764608,1.24771329869227,33.6882590646913,12,75.2471008196921,0,0
transformers_3.5.0,src/transformers/modeling_tf_bart.py,1222,615,904,20,186,173,320,206,493,1488.72210076384,17.2043010752688,65194.7485574422,3621.93047541345,3789.44475990133,209,9.56248925114664,0,0
transformers_3.5.0,src/transformers/modeling_tf_utils.py,1096,456,496,15,125,95,169,140,264,929.326394516889,10.14,19084.805465041,1060.26697028006,1882.13071647347,127,30.005374556882,0,0
transformers_3.5.0,src/transformers/modeling_ctrl.py,599,271,434,13,101,106,176,114,282,720.585076093766,11.3267326732673,21825.1978385115,1212.51099102842,1926.87498399446,67,34.5799550906354,0,0
transformers_3.5.0,src/transformers/configuration_t5.py,129,35,63,1,2,1,2,3,3,2,0.5,2.37744375108173,0.13208020839343,4.75488750216347,7,88.299503578206,0,0
transformers_3.5.0,src/transformers/tokenization_herbert_fast.py,164,48,64,5,46,29,58,51,87,265.693490453059,3.15217391304348,1555.60099323849,86.4222774021382,493.50100475152,12,67.5477268041202,0,0
transformers_3.5.0,src/transformers/configuration_xlm_roberta.py,40,9,13,0,0,0,0,0,0,0,0,0,0,0,1,100,0,0
transformers_3.5.0,src/transformers/modeling_tf_transfo_xl_utilities.py,184,111,142,12,43,38,73,55,111,276.348934460844,10.1860465116279,6536.70108260795,363.150060144886,641.730928201237,24,53.7886172680671,0,0
transformers_3.5.0,src/transformers/tokenization_xlm_roberta.py,284,97,129,8,68,41,81,76,122,437.947473205023,4.76470588235294,3631.88351104997,201.771306169443,762.247156640118,28,61.14859365618,0,0
transformers_3.5.0,src/transformers/configuration_openai.py,173,41,59,0,0,0,0,0,0,0,0,0,0,0,6,100,0,0
transformers_3.5.0,src/transformers/modeling_tf_marian.py,52,21,25,3,7,4,8,10,12,24.4063719565667,1.71428571428571,68.3368065233972,3.79648925129984,39.8631371386484,4,88.645725603881,0,0
transformers_3.5.0,src/transformers/convert_xlm_original_pytorch_checkpoint_to_pytorch.py,79,39,42,7,26,17,32,33,49,141.862917126072,4.30769230769231,1064.75518950151,59.1530660834171,247.175311848564,9,75.8971003499922,0,0
transformers_3.5.0,src/transformers/modeling_rag.py,1493,466,880,15,142,164,297,157,461,1073.86744990379,15.6866197183099,52751.2811131687,2930.62672850937,3362.82016523904,131,28.3913545722345,0,0
transformers_3.5.0,src/transformers/modeling_mmbt.py,407,129,291,7,29,36,63,36,99,160.532933313103,7.60344827586207,3891.61647651672,216.20091536204,511.822575142789,30,52.5861944673831,0,0
transformers_3.5.0,src/transformers/modelcard.py,216,100,101,4,11,7,14,15,21,46.0537478050103,2.54545454545455,208.841060928892,11.6022811627162,82.0447025077789,26,68.4680819260831,0,0
transformers_3.5.0,src/transformers/tokenization_herbert.py,81,34,38,0,0,0,0,0,0,0,0,0,0,0,6,100,0,0
transformers_3.5.0,src/transformers/tokenization_t5_fast.py,236,71,136,8,29,21,41,37,62,164.8814488587,5.6551724137931,1826.54213178328,101.474562876849,322.986108668995,19,68.6279396734034,0,0
transformers_3.5.0,src/transformers/generation_beam_search.py,357,137,240,17,64,45,84,81,129,453.486868301256,11.15625,9124.03475571393,506.890819761885,817.840650372117,42,53.6526040753164,0,0
transformers_3.5.0,src/transformers/modeling_tf_distilbert.py,1086,471,787,13,113,119,218,126,337,818.785939088751,12.5398230088496,29485.4292441504,1638.0794024528,2351.34333421947,135,24.3874820469348,0,0
transformers_3.5.0,src/transformers/tokenization_lxmert_fast.py,69,17,23,0,0,0,0,0,0,0,0,0,0,0,1,100,0,0
transformers_3.5.0,src/transformers/convert_transfo_xl_original_tf_checkpoint_to_pytorch.py,125,54,88,2,10,6,12,12,18,35.2192809488736,1.2,77.435190015577,4.30195500086539,64.5293250129808,5,73.6607821320052,0,0
transformers_3.5.0,src/transformers/tokenization_bert_generation.py,139,67,74,3,8,5,8,11,13,28.7548875021635,1.5,67.4589165634273,3.74771758685707,44.9726110422849,16,75.1696401631667,0,0
transformers_3.5.0,src/transformers/modeling_longformer.py,2023,779,1247,16,229,287,497,245,784,1859.1776674742,17.3624454148472,108034.763306776,6001.93129482091,6222.32414417802,169,15.2480904578947,1,1
transformers_3.5.0,src/transformers/tokenization_deberta.py,674,354,371,17,188,120,236,205,356,1489.74957241665,10.6702127659574,29171.2404273427,1620.6244681857,2733.89491542394,129,31.9023308506395,0,0
transformers_3.5.0,src/transformers/configuration_mbart.py,104,9,9,0,0,0,0,0,0,0,0,0,0,0,1,100,0,0
transformers_3.5.0,src/transformers/tokenization_roberta.py,264,60,117,9,61,37,73,70,110,390.304302604317,5.38524590163934,3630.84658716896,201.713699287164,674.221131863946,24,64.9836890136189,0,0
transformers_3.5.0,src/transformers/modeling_tf_bert.py,1480,622,1057,14,133,151,272,147,423,991.655532830465,14.3157894736842,43598.1842793417,2422.12134885232,3045.46140186578,178,12.1728598455575,0,0
transformers_3.5.0,src/transformers/pipelines.py,2900,1086,1574,20,352,307,561,372,868,3064.15849165808,15.9375,118128.588203166,6562.69934462032,7411.98984804177,410,0,0,0
transformers_3.5.0,src/transformers/convert_reformer_trax_checkpoint_to_pytorch.py,219,90,151,6,18,19,31,24,50,90.5684250302886,5.16666666666667,1184.44864601963,65.8027025566462,229.248125036058,12,62.8223488005354,0,0
transformers_3.5.0,src/transformers/convert_t5_original_tf_checkpoint_to_pytorch.py,61,20,30,1,2,1,2,3,3,2,0.5,2.37744375108173,0.13208020839343,4.75488750216347,2,95.8316665485003,0,0
transformers_3.5.0,src/transformers/convert_slow_tokenizers_checkpoints_to_fast.py,130,62,85,9,17,13,24,26,37,98.0161933142366,6.35294117647059,1104.87983021717,61.3822127898425,173.91626957122,15,67.0403170795318,0,0
transformers_3.5.0,src/transformers/modeling_prophetnet.py,2073,835,1285,15,264,314,552,279,866,2182.32340644476,15.6818181818182,110329.260197055,6129.40334428082,7035.48905604408,208,8.80370925884779,1,1
transformers_3.5.0,src/transformers/modeling_camembert.py,160,37,86,0,0,0,0,0,0,0,0,0,0,0,1,100,0,0
transformers_3.5.0,src/transformers/modeling_encoder_decoder.py,457,115,271,8,39,34,66,47,100,230.130686535628,6.76923076923077,3760.02937652025,208.890520917791,555.458885167764,46,57.6851560901259,1,1
transformers_3.5.0,src/transformers/convert_xlnet_original_tf_checkpoint_to_pytorch.py,114,39,79,3,6,4,8,9,12,20.2646625064904,2,76.0782000346155,4.22656666858975,38.0391000173078,5,77.9856094274419,0,0
transformers_3.5.0,src/transformers/modeling_marian.py,63,14,17,4,8,4,8,12,12,32,2,86.0391000173078,4.77995000096154,43.0195500086539,4,69.1519577362733,0,0
transformers_3.5.0,src/transformers/modeling_tf_outputs.py,556,201,110,0,0,0,0,0,0,0,0,0,0,0,1,100,0,0
transformers_3.5.0,src/transformers/modeling_tf_funnel.py,1689,839,1226,17,264,257,474,281,731,2193.20691581189,15.2613636363636,90748.1222116983,5041.56234509435,5946.2656400815,245,0,0,0
transformers_3.5.0,src/transformers/configuration_layoutlm.py,127,12,46,0,0,0,0,0,0,0,0,0,0,0,2,100,0,0
transformers_3.5.0,src/transformers/modeling_flaubert.py,432,159,287,13,53,54,98,66,152,351.685500427684,12.0188679245283,11042.3097398635,613.461652214636,918.747906142485,45,50.5724269691772,0,0
transformers_3.5.0,src/transformers/tokenization_layoutlm_fast.py,66,20,29,0,0,0,0,0,0,0,0,0,0,0,1,100,0,0
transformers_3.5.0,src/transformers/modeling_xlm.py,1271,531,910,19,164,193,336,183,529,1287.34915151279,19.4634146341463,77382.7453934854,4299.04141074919,3975.80521445226,144,20.3232120614962,0,0
transformers_3.5.0,src/transformers/convert_bert_original_tf_checkpoint_to_pytorch.py,61,20,30,1,2,1,2,3,3,2,0.5,2.37744375108173,0.13208020839343,4.75488750216347,2,95.8316665485003,0,0
transformers_3.5.0,src/transformers/hf_argparser.py,173,110,108,8,39,28,56,47,84,230.130686535628,5.74358974358974,2679.8754829017,148.881971272317,466.585463540922,52,58.4212779820984,0,0
transformers_3.5.0,src/transformers/tokenization_xlnet.py,323,130,160,11,66,45,83,77,128,436.983759682668,6.91666666666667,5548.19501736189,308.233056520105,802.148677208947,38,57.5773586020321,0,0
transformers_3.5.0,src/transformers/modeling_tf_flaubert.py,805,382,550,15,120,102,192,135,294,887.43023040715,12,24967.0054263953,1387.05585702196,2080.58378553294,97,31.86773611021,0,0
transformers_3.5.0,src/transformers/tokenization_prophetnet.py,288,103,146,7,53,33,65,60,98,323.231268546253,4.29245283018868,2484.794826964,138.044157053556,578.875278369635,30,61.7181940814911,0,0
transformers_3.5.0,src/transformers/hf_api.py,309,170,164,2,9,5,10,11,15,30.5293250129808,1.11111111111111,57.657193643955,3.20317742466416,51.8914742795595,37,63.5975092589048,0,0
transformers_3.5.0,src/transformers/integrations.py,533,326,356,13,85,58,105,98,163,592.903945907539,8.02941176470588,8657.29333392008,480.960740773338,1078.19770459078,117,32.9117661541231,2,1
transformers_3.5.0,src/transformers/generation_utils.py,1215,332,558,19,174,185,343,193,528,1375.78279103311,18.7270114942529,75073.1679490534,4170.73155272519,4008.81731567755,139,28.8282811179268,1,1
transformers_3.5.0,src/transformers/modeling_bert.py,1672,699,1194,17,151,194,329,168,523,1162.48598393934,18.5198675496689,71601.1787872505,3977.84326595836,3866.18201211329,186,10.1836035430288,2,1
transformers_3.5.0,src/transformers/configuration_dpr.py,114,25,47,0,0,0,0,0,0,0,0,0,0,0,2,100,0,0
transformers_3.5.0,src/transformers/configuration_pegasus.py,144,10,46,0,0,0,0,0,0,0,0,0,0,0,1,100,0,0
transformers_3.5.0,src/transformers/training_args.py,469,201,245,12,46,29,55,58,84,297.103399987276,7.17391304347826,3530.07028662905,196.115015923836,492.070403590716,39,54.5511225702445,3,1
transformers_3.5.0,src/transformers/convert_pegasus_tf_to_pytorch.py,132,76,93,8,30,17,34,38,51,171.206717868256,4.53333333333333,1213.32084110816,67.4067133948976,267.644303185623,21,63.1177563168072,0,0
transformers_3.5.0,src/transformers/tokenization_longformer_fast.py,60,16,29,0,0,0,0,0,0,0,0,0,0,0,4,100,0,0
transformers_3.5.0,src/transformers/tokenization_reformer.py,154,69,72,4,10,6,10,14,16,41.2192809488736,2,121.835357505843,6.76863097254685,60.9176787529217,17,74.2372042748179,0,0
transformers_3.5.0,src/transformers/modeling_pegasus.py,59,10,17,0,0,0,0,0,0,0,0,0,0,0,1,100,0,0
transformers_3.5.0,src/transformers/tokenization_auto.py,348,146,242,6,22,15,28,28,43,113.617270614347,3.81818181818182,789.28027174873,43.8489039860406,206.716261648477,22,60.3465461413351,1,1
transformers_3.5.0,src/transformers/configuration_lxmert.py,183,43,75,0,0,0,0,0,0,0,0,0,0,0,2,100,0,0
transformers_3.5.0,src/transformers/modeling_xlm_roberta.py,163,36,89,0,0,0,0,0,0,0,0,0,0,0,1,100,0,0
transformers_3.5.0,src/transformers/retrieval_rag.py,617,265,349,14,78,47,89,92,136,543.564341980062,7.98717948717949,7086.26099247178,393.681166248432,887.204426023754,82,44.563694868643,0,0
transformers_3.5.0,src/transformers/modeling_blenderbot.py,56,17,23,5,9,5,9,14,14,40.1389654874176,2.5,133.257422272016,7.40319012622312,53.3029689088064,4,87.3566563078312,0,0
transformers_3.5.0,src/transformers/tokenization_camembert.py,271,99,128,9,68,41,81,77,122,442.476798218004,5.36029411764706,4098.20192173767,227.677884540982,764.547957964778,28,61.082451150849,0,0
transformers_3.5.0,src/transformers/tokenization_bart.py,156,29,61,1,4,3,6,5,9,8,0.75,15.6730146404897,0.870723035582761,20.8973528539863,8,79.029865150731,0,0
transformers_3.5.0,src/transformers/tokenization_pegasus_fast.py,119,54,70,5,21,13,26,26,39,103.848306352791,3.0952380952381,567.410223118461,31.5227901732478,183.317149007503,15,73.2648160374016,0,0
transformers_3.5.0,src/transformers/tokenization_retribert_fast.py,61,21,26,0,0,0,0,0,0,0,0,0,0,0,1,100,0,0
transformers_3.5.0,src/transformers/modeling_tf_auto.py,1414,269,839,2,50,30,50,52,80,284.192809488736,1,456.035177451287,25.3352876361826,456.035177451287,81,46.3076878807394,1,1
transformers_3.5.0,src/transformers/configuration_funnel.py,182,48,89,4,10,5,10,14,15,41.2192809488736,2,114.220647661728,6.34559153676267,57.1103238308641,10,76.9513762120441,0,0
transformers_3.5.0,src/transformers/tokenization_bertweet.py,765,279,413,17,111,75,141,128,216,823.667029466118,10.7972972972973,16325.5135135135,906.972972972973,1512,66,44.7479393235736,0,0
transformers_3.5.0,src/transformers/tokenization_distilbert_fast.py,81,21,46,0,0,0,0,0,0,0,0,0,0,0,1,100,0,0
transformers_3.5.0,src/transformers/convert_marian_to_pytorch.py,618,358,485,12,124,79,142,136,221,905.339892496627,6.87096774193548,10762.1980105218,597.899889473436,1566.32928791633,82,26.1387726922771,0,0
transformers_3.5.0,src/transformers/activations.py,84,36,43,5,42,24,48,47,72,238.086972231145,2.85714285714286,1142.6582780594,63.4810154477444,399.93039732079,4,75.4901731757756,1,1
transformers_3.5.0,src/transformers/configuration_fsmt.py,217,56,92,1,2,1,2,3,3,2,0.5,2.37744375108173,0.13208020839343,4.75488750216347,7,80.4869469957943,0,0
transformers_3.5.0,src/transformers/convert_bert_original_tf2_checkpoint_to_pytorch.py,226,157,173,11,43,40,79,54,119,271.3831322572,10.1046511627907,6919.98455216542,384.443586231412,684.831612757453,40,50.7875919535364,0,0
transformers_3.5.0,src/transformers/convert_dialogpt_original_pytorch_checkpoint_to_pytorch.py,32,20,23,1,2,1,2,3,3,2,0.5,2.37744375108173,0.13208020839343,4.75488750216347,3,66.4745247817074,0,0
transformers_3.5.0,src/transformers/tokenization_blenderbot.py,269,150,158,10,41,31,56,51,87,252.878913138215,6.82926829268293,3370.25076415672,187.236153564262,493.50100475152,34,57.2577750735533,0,0
transformers_3.5.0,src/transformers/tokenization_gpt2_fast.py,188,49,103,4,12,7,12,16,19,51.0195500086539,2,152,8.44444444444444,76,10,77.7827975127328,0,0
transformers_3.5.0,src/transformers/modeling_bart.py,1373,638,1016,19,163,178,315,182,493,1278.55331189509,18.3588957055215,67952.5656574953,3775.14253652752,3701.34275761796,191,10.2513580260549,1,1
transformers_3.5.0,src/transformers/tokenization_openai.py,233,154,152,11,40,30,56,51,86,250.930871600505,7.7,3756.28006145352,208.682225636307,487.828579409549,37,53.8387926033316,0,0
transformers_3.5.0,src/transformers/configuration_reformer.py,227,39,79,0,0,0,0,0,0,0,0,0,0,0,3,100,0,0
transformers_3.5.0,src/transformers/modeling_flax_bert.py,429,230,272,9,41,36,63,50,99,248.188957202322,6.91463414634146,3863.49487195884,214.638603997713,558.741762787698,37,48.9534937321792,0,0
transformers_3.5.0,src/transformers/training_args_tf.py,223,84,90,4,13,7,14,17,21,56.1057163358342,2.15384615384615,184.879088511938,10.2710604728855,85.8367196662571,22,64.4927957560019,0,0
transformers_3.5.0,src/transformers/configuration_camembert.py,37,9,10,0,0,0,0,0,0,0,0,0,0,0,1,100,0,0
transformers_3.5.0,src/transformers/testing_utils.py,957,451,465,15,67,49,74,82,123,465.031334694799,8.28358208955224,6477.58638201871,359.86591011215,781.978896568024,99,37.7674847620252,0,0
transformers_3.5.0,src/transformers/configuration_longformer.py,71,13,16,0,0,0,0,0,0,0,0,0,0,0,2,100,0,0
transformers_3.5.0,src/transformers/tokenization_retribert.py,56,19,21,0,0,0,0,0,0,0,0,0,0,0,1,100,0,0
transformers_3.5.0,src/transformers/convert_slow_tokenizer.py,628,258,456,11,42,34,61,53,95,264.531079561718,7.98809523809524,4346.74154019204,241.48564112178,544.152443183504,70,38.9207495230543,0,0
transformers_3.5.0,src/transformers/configuration_deberta.py,138,33,55,1,2,1,2,3,3,2,0.5,2.37744375108173,0.13208020839343,4.75488750216347,4,82.9889245123736,0,0
transformers_3.5.0,src/transformers/modeling_fsmt.py,1246,520,808,19,158,145,264,177,409,1234.70798096741,15.873417721519,48481.3967108844,2693.41092838247,3054.25066998395,154,22.4393587656378,1,1
transformers_3.5.0,src/transformers/configuration_distilbert.py,137,33,55,0,0,0,0,0,0,0,0,0,0,0,5,100,0,0
transformers_3.5.0,src/transformers/configuration_squeezebert.py,149,31,55,0,0,0,0,0,0,0,0,0,0,0,2,100,0,0
transformers_3.5.0,src/transformers/generation_tf_utils.py,1109,450,678,19,262,269,496,281,765,2185.46744915824,17.9847328244275,111916.045297611,6217.55807208948,6222.83613496901,188,18.7265803445719,1,1
transformers_3.5.0,src/transformers/tokenization_roberta_fast.py,203,33,90,3,25,16,32,28,48,120.851292246532,1.92,443.045829616829,24.6136572009349,230.753036258765,6,76.2309614759011,0,0
transformers_3.5.0,src/transformers/configuration_albert.py,144,25,53,0,0,0,0,0,0,0,0,0,0,0,2,100,0,0
transformers_3.5.0,src/transformers/convert_marian_tatoeba_to_pytorch.py,1254,183,1186,10,52,33,59,62,92,329.64214629221,5.67307692307692,3107.63245892115,172.646247717842,547.786060555593,41,34.7871594672455,0,0
transformers_3.5.0,src/transformers/tokenization_ctrl.py,260,128,181,10,37,28,51,47,79,225.969055477145,6.89189189189189,3024.24844370395,168.013802427997,438.812519282533,31,54.6981427225606,0,0
transformers_3.5.0,src/transformers/tokenization_mbart_fast.py,247,84,140,5,50,34,68,55,102,293.802449963173,3.4,2004.97554865035,111.387530480575,589.698690779515,18,65.1225122861322,0,0
transformers_3.5.0,src/transformers/tokenization_flaubert.py,148,57,77,3,5,3,7,8,10,16.3645279766003,2.1,63,3.5,30,12,78.8453140177484,0,0
transformers_3.5.0,src/transformers/modeling_tf_blenderbot.py,47,20,21,3,7,4,8,10,12,24.4063719565667,1.71428571428571,68.3368065233972,3.79648925129984,39.8631371386484,4,88.8999493563643,0,0
transformers_3.5.0,src/transformers/modeling_tf_electra.py,1360,572,990,15,140,147,272,155,419,1056.70298130642,14.5714285714286,44423.8578332301,2467.99210184611,3048.69612580991,174,12.3636319236747,0,0
transformers_3.5.0,src/transformers/tokenization_mbart.py,232,82,131,5,47,29,58,52,87,272.675316503286,3.08510638297872,1530.02227753936,85.0012376410755,495.938255478275,21,65.6783635355342,0,0
transformers_3.5.0,src/transformers/modeling_tf_xlnet.py,1729,752,1187,17,226,240,445,243,685,1836.84731380709,16.7367256637168,90855.2577743313,5047.51432079618,5428.49656496996,224,5.7953885839144,0,0
transformers_3.5.0,src/transformers/trainer_callback.py,477,248,225,11,55,34,67,66,101,356.028532048867,6.7,4090.24150056987,227.235638920548,610.483806055204,87,45.3734197706079,0,0
transformers_3.5.0,src/transformers/modeling_tf_longformer.py,1971,696,1294,16,232,233,426,248,659,1887.0515908696,14.6896551724138,77000.4602413845,4277.80334674358,5241.81536854495,142,18.6250373902704,0,0
transformers_3.5.0,src/transformers/tokenization_reformer_fast.py,130,37,58,3,7,4,7,10,11,24.4063719565667,1.5,54.8118135656415,3.04510075364675,36.541209043761,7,81.8883178869824,0,0
transformers_3.5.0,src/transformers/tokenization_xlnet_fast.py,262,70,115,7,49,31,61,56,92,294.772266816048,4.35714285714286,2327.91970161338,129.328872311854,534.2766528293,16,65.5411395617567,0,0
transformers_3.5.0,src/transformers/configuration_transfo_xl.py,204,63,94,4,11,6,11,15,17,46.0537478050103,2,132.83428025069,7.37968223614942,66.4171401253448,10,73.3115525277202,0,0
transformers_3.5.0,src/transformers/tokenization_dpr_fast.py,389,122,271,13,49,41,74,62,115,323.226498697479,9.81632653061224,6721.55854916429,373.419919398016,684.732575694491,31,55.5358445243223,0,0
transformers_3.5.0,src/transformers/modeling_tf_roberta.py,1263,531,898,14,132,140,256,146,396,983.162992664122,13.5757575757576,38652.496828539,2147.36093491883,2847.17052531649,154,17.6147174392953,0,0
transformers_3.5.0,src/transformers/convert_graph_to_onnx.py,488,195,265,9,38,23,39,47,62,227.950570523837,4.61842105263158,1590.51266566064,88.3618147589245,344.384508804014,33,56.3917502032705,0,0
transformers_3.5.0,src/transformers/convert_mobilebert_original_tf_checkpoint_to_pytorch.py,42,19,30,1,2,1,2,3,3,2,0.5,2.37744375108173,0.13208020839343,4.75488750216347,2,87.1670334014441,0,0
transformers_3.5.0,src/transformers/modeling_tf_openai.py,723,343,513,15,118,117,202,133,319,870.755238758825,12.8389830508475,28895.865863061,1605.32588128116,2250.63509692488,94,31.7506081343388,0,0
transformers_3.5.0,src/transformers/modeling_layoutlm.py,913,419,685,12,105,109,189,117,298,748.015329363597,10.8,22111.5818135072,1228.42121186151,2047.36868643585,105,24.5089847036986,2,1
transformers_3.5.0,src/transformers/modeling_xlm_prophetnet.py,166,22,25,0,0,0,0,0,0,0,0,0,0,0,1,100,0,0
transformers_3.5.0,src/transformers/tokenization_t5.py,306,123,178,13,64,39,75,77,114,432.105716335834,7.6171875,5441.82284373624,302.32349131868,714.413665639219,38,58.1618279584555,0,0
transformers_3.5.0,src/transformers/trainer_tf.py,795,378,455,18,132,106,206,150,312,1004.91867378128,14.0454545454545,31677.9978324239,1759.888768468,2255.39143143471,120,32.0190991890242,1,1
transformers_3.5.0,src/transformers/generation_logits_process.py,374,179,187,13,84,68,108,97,176,585.06037984925,8.35714285714286,9707.52894616552,539.307163675862,1161.58466022493,70,49.2098481929495,0,0
transformers_3.5.0,src/transformers/tokenization_bert.py,558,241,332,17,139,86,176,156,262,1059.01967740982,10.7625899280576,20543.3666941546,1141.29814967526,1908.77538134191,88,42.0083121283152,0,0
transformers_3.5.0,src/transformers/convert_dpr_original_checkpoint_to_pytorch.py,125,94,99,6,14,10,17,20,27,68.8127439131334,3.64285714285714,425.092499047136,23.6162499470631,116.692058561959,23,52.5203983860844,0,0
transformers_3.5.0,src/transformers/modeling_auto.py,1636,301,1002,2,55,33,55,57,88,319.974784243856,1,513.294321246497,28.516351180361,513.294321246497,89,43.479505232267,1,1
transformers_3.5.0,src/transformers/tokenization_lxmert.py,65,15,18,0,0,0,0,0,0,0,0,0,0,0,1,100,0,0
transformers_3.5.0,src/transformers/convert_fsmt_original_pytorch_checkpoint_to_pytorch.py,279,123,187,5,16,9,16,21,25,75.6096404744368,2.5,274.519838923673,15.2511021624263,109.807935569469,18,64.0675059495665,0,0
transformers_3.5.0,src/transformers/tokenization_camembert_fast.py,236,62,103,7,55,34,67,62,101,337.626268698259,4.26363636363636,2564.03931842469,142.446628801372,601.373827349074,16,66.1208730995656,0,0
transformers_3.5.0,src/transformers/modeling_tf_mobilebert.py,1567,693,1133,15,152,163,293,167,456,1160.28834097755,14.4572368421053,48677.0705481352,2704.28169711862,3366.96915736817,197,8.28775865039545,0,0
transformers_3.5.0,src/transformers/configuration_mmbt.py,42,10,8,0,0,0,0,0,0,0,0,0,0,0,3,100,0,0
transformers_3.5.0,src/transformers/tokenization_albert_fast.py,255,63,124,7,53,33,65,60,98,323.231268546253,4.29245283018868,2484.794826964,138.044157053556,578.875278369635,16,67.566950334001,0,0
transformers_3.5.0,src/transformers/configuration_flaubert.py,141,14,15,0,0,0,0,0,0,0,0,0,0,0,2,100,0,0
transformers_3.5.0,src/transformers/tokenization_utils_fast.py,540,198,342,11,58,36,70,69,106,377.816645522409,6.63793103448276,4298.08419105374,238.782455058541,647.503592418486,74,47.8455264237146,1,1
transformers_3.5.0,src/transformers/tokenization_xlm_prophetnet.py,305,119,148,8,54,33,65,62,98,334.763925116827,4.81481481481482,2809.49855534551,156.083253074751,583.511238417914,33,59.9910658477775,0,0
transformers_3.5.0,src/transformers/modeling_bert_generation.py,518,232,340,8,61,58,104,69,162,385.774977591336,6.81967213114754,6748.61770805237,374.923206002909,989.580961998064,66,43.9715588676516,1,1
transformers_3.5.0,src/transformers/tokenization_xlm.py,981,310,739,14,115,78,152,129,230,840.53432476741,9.25217391304348,14919.8915995407,828.882866641149,1612.58226874735,73,37.2968300291107,0,0
transformers_3.5.0,src/transformers/configuration_xlm_prophetnet.py,35,9,8,0,0,0,0,0,0,0,0,0,0,0,1,100,0,0
transformers_3.5.0,src/transformers/modeling_funnel.py,1563,804,1146,19,263,275,491,282,766,2194.9463169393,17.7357414448669,110580.509349735,6143.36163054084,6234.89633593748,213,3.33550010412668,1,1
transformers_3.5.0,src/transformers/modeling_tf_camembert.py,162,32,89,0,0,0,0,0,0,0,0,0,0,0,1,100,0,0
transformers_3.5.0,src/transformers/modeling_tf_mbart.py,36,11,13,0,0,0,0,0,0,0,0,0,0,0,1,100,0,0
transformers_3.5.0,src/transformers/configuration_rag.py,184,48,137,2,5,3,6,7,9,13.6096404744368,1.2,30.3194331582221,1.68441295323456,25.2661942985184,5,75.7852264958928,0,0
transformers_3.5.0,src/transformers/modeling_xlnet.py,2029,850,1332,18,248,302,529,266,831,2047.69933500191,19.1975806451613,128507.447299496,7139.30262774977,6693.93970390149,226,5.51211188707898,1,1
transformers_3.5.0,src/transformers/modeling_roberta.py,1352,556,962,14,118,160,270,132,430,865.454848733504,16.0169491525424,48516.7720407001,2695.37622448334,3029.08947132414,143,19.1151681340239,2,1
transformers_3.5.0,src/transformers/tokenization_utils_base.py,3068,1045,1764,18,447,304,576,465,880,4010.50521649491,11.5973154362416,90433.0415619653,5024.05786455363,7797.75647727595,388,0,1,1
transformers_3.5.0,src/transformers/modeling_outputs.py,813,289,157,0,0,0,0,0,0,0,0,0,0,0,1,100,1,1
transformers_3.5.0,src/transformers/configuration_bert.py,142,24,62,0,0,0,0,0,0,0,0,0,0,0,2,100,0,0
transformers_3.5.0,src/transformers/modeling_squeezebert.py,1030,422,722,12,79,117,193,91,310,541.018229114645,14.6582278481013,29571.7483536522,1642.87490853624,2017.4163384616,108,27.8354104156187,0,0
transformers_3.5.0,src/transformers/tokenization_dpr.py,386,118,268,13,49,41,74,62,115,323.226498697479,9.81632653061224,6721.55854916429,373.419919398016,684.732575694491,31,55.9377698283388,0,0
transformers_3.5.0,src/transformers/modeling_flax_roberta.py,442,230,276,9,44,39,69,53,108,268.744316233022,7.05681818181818,4365.45646643914,242.525359246619,618.615409092826,37,49.649209683717,0,0
transformers_3.5.0,src/transformers/tokenization_electra.py,66,15,33,0,0,0,0,0,0,0,0,0,0,0,1,100,0,0
transformers_3.5.0,src/transformers/utils/logging.py,241,106,98,4,9,5,9,13,14,36.5293250129808,2,103.612312107951,5.75623956155281,51.8061560539753,10,71.0213834164732,0,0
transformers_3.5.0,src/transformers/utils/hp_naming.py,148,110,113,9,40,22,44,49,66,241.406448808475,4.95,1834.32570607244,101.906983670691,370.570849711604,34,44.0213144494374,0,0
transformers_3.5.0,src/transformers/utils/sentencepiece_model_pb2.py,1169,52,1136,4,7,4,7,11,11,27.6514844544032,2,76.1074956100206,4.2281942005567,38.0537478050103,3,57.018403412176,0,0
transformers_3.5.0,src/transformers/utils/dummy_tokenizers_objects.py,252,166,166,0,0,0,0,0,0,0,0,0,0,0,55,100,0,0
transformers_3.5.0,src/transformers/utils/__init__.py,0,0,0,0,0,0,0,0,0,0,0,0,0,0,1,100,0,0
transformers_3.5.0,src/transformers/utils/dummy_sentencepiece_objects.py,101,67,67,0,0,0,0,0,0,0,0,0,0,0,23,100,0,0
transformers_3.5.0,src/transformers/utils/notebook.py,347,194,209,18,106,72,143,124,215,788.218218209661,12.1415094339623,18153.4046232604,1008.52247907002,1495.15220673318,65,47.6657847622269,0,0
transformers_3.5.0,src/transformers/utils/dummy_flax_objects.py,20,13,13,0,0,0,0,0,0,0,0,0,0,0,5,100,0,0
transformers_3.5.0,src/transformers/utils/dummy_pt_objects.py,2057,1295,1295,0,0,0,0,0,0,0,0,0,0,0,405,100,0,0
transformers_3.5.0,src/transformers/utils/dummy_tf_objects.py,1345,855,855,0,0,0,0,0,0,0,0,0,0,0,274,100,0,0
transformers_3.5.0,src/transformers/benchmark/benchmark_utils.py,901,482,559,17,150,109,210,167,319,1153.80967187564,11.9,28029.2798646607,1557.18221470338,2355.40166929922,95,31.6429436908374,1,1
transformers_3.5.0,src/transformers/benchmark/benchmark_args_tf.py,136,80,95,4,7,4,7,11,11,27.6514844544032,2,76.1074956100206,4.2281942005567,38.0537478050103,18,69.5581649960805,0,0
transformers_3.5.0,src/transformers/benchmark/__init__.py,0,0,0,0,0,0,0,0,0,0,0,0,0,0,1,100,0,0
transformers_3.5.0,src/transformers/benchmark/benchmark.py,267,152,190,5,22,12,23,27,35,109.717136084457,2.61363636363636,434.964140822908,24.1646744901616,166.421062575721,45,52.245229963489,1,1
transformers_3.5.0,src/transformers/benchmark/benchmark_args.py,115,63,76,4,8,5,8,12,13,32,2,93.2090250187501,5.17827916770834,46.604512509375,16,72.4644323608165,1,1
transformers_3.5.0,src/transformers/benchmark/benchmark_tf.py,294,174,218,10,44,23,45,54,68,273.434272168915,5.11363636363636,2001.13133597957,111.173963109976,391.332350147116,49,46.9733196791143,0,0
transformers_3.5.0,src/transformers/benchmark/benchmark_args_utils.py,145,77,106,2,3,2,3,5,5,6.75488750216347,1,11.6096404744368,0.6449800263576,11.6096404744368,7,74.4906077778744,0,0
transformers_3.5.0,src/transformers/commands/download.py,32,20,24,0,0,0,0,0,0,0,0,0,0,0,4,100,0,0
transformers_3.5.0,src/transformers/commands/user.py,355,260,294,8,35,33,64,43,97,203.524905593074,7.31428571428571,3849.85732539321,213.880962521845,526.347681206104,64,33.6309339783683,0,0
transformers_3.5.0,src/transformers/commands/__init__.py,13,10,10,0,0,0,0,0,0,0,0,0,0,0,3,100,0,0
transformers_3.5.0,src/transformers/commands/train.py,146,68,109,3,10,7,12,13,19,37.9741684510371,1.8,126.555038360425,7.03083546446807,70.3083546446807,14,63.0967971441654,0,0
transformers_3.5.0,src/transformers/commands/transformers_cli.py,37,24,24,2,3,2,3,5,5,6.75488750216347,1,11.6096404744368,0.6449800263576,11.6096404744368,3,83.9211334715397,0,0
transformers_3.5.0,src/transformers/commands/env.py,58,36,43,1,2,1,2,3,3,2,0.5,2.37744375108173,0.13208020839343,4.75488750216347,8,72.8694814517335,0,0
transformers_3.5.0,src/transformers/commands/run.py,97,48,80,4,6,4,6,10,10,23.5097750043269,2,66.4385618977473,3.69103121654151,33.2192809488736,14,60.1988305526695,0,0
transformers_3.5.0,src/transformers/commands/serving.py,216,99,138,3,4,3,4,7,7,12.7548875021635,1.5,29.4772266816048,1.6376237045336,19.6514844544032,16,71.1473344726104,0,0
transformers_3.5.0,src/transformers/commands/convert.py,159,80,128,2,12,10,20,14,30,45.0195500086539,1.66666666666667,190.36774610288,10.5759858946045,114.220647661728,20,56.6570110238156,0,0
transformers_3.5.0,src/transformers/data/test_generation_utils.py,87,41,70,2,3,2,3,5,5,6.75488750216347,1,11.6096404744368,0.6449800263576,11.6096404744368,9,68.3139742226796,0,0
transformers_3.5.0,src/transformers/data/__init__.py,23,2,19,0,0,0,0,0,0,0,0,0,0,0,1,100,0,0
transformers_3.5.0,src/transformers/data/data_collator.py,617,318,338,23,126,101,181,149,282,983.179195350301,16.5198412698413,33631.1840924321,1868.39911624623,2035.80552277033,103,37.5724901584703,0,0
transformers_3.5.0,src/transformers/data/processors/utils.py,352,196,219,12,77,53,104,89,157,525.562113642161,8.1038961038961,8239.1513346093,457.730629700516,1016.69014866172,65,46.941631102746,0,0
transformers_3.5.0,src/transformers/data/processors/__init__.py,8,4,4,0,0,0,0,0,0,0,0,0,0,0,1,100,0,0
transformers_3.5.0,src/transformers/data/processors/glue.py,644,389,423,7,43,47,89,50,136,252.980868906593,7.24418604651163,5560.37961915387,308.909978841882,767.564441809363,118,23.4235480303005,0,0
transformers_3.5.0,src/transformers/data/processors/squad.py,825,376,581,16,176,135,254,192,389,1376.85996488016,11.5454545454545,34065.4456748297,1892.52475971276,2950.55041278053,97,30.190993720039,0,0
transformers_3.5.0,src/transformers/data/processors/xnli.py,91,55,53,4,13,7,14,17,21,56.1057163358342,2.15384615384615,184.879088511938,10.2710604728855,85.8367196662571,18,73.7356906775561,0,0
transformers_3.5.0,src/transformers/data/datasets/__init__.py,13,3,9,0,0,0,0,0,0,0,0,0,0,0,1,100,0,0
transformers_3.5.0,src/transformers/data/datasets/glue.py,152,81,117,7,22,13,25,29,38,117.758980064424,3.97727272727273,734.217582218145,40.7898656787858,184.603277814848,16,58.9759106545834,0,0
transformers_3.5.0,src/transformers/data/datasets/language_modeling.py,511,274,339,14,111,84,157,125,241,807.483130073668,9.9009009009009,16621.1771157776,923.398728654312,1678.75401260356,90,38.153824966499,0,0
transformers_3.5.0,src/transformers/data/datasets/squad.py,211,117,170,10,26,16,31,36,47,155.430713620542,5.96153846153846,1448.57321675028,80.4762898194599,242.986475067789,20,51.3431890928468,0,0
transformers_3.5.0,src/transformers/data/metrics/__init__.py,102,69,70,3,28,19,38,31,57,139.360825319776,2.03571428571429,574.863707587391,31.936872643744,282.389189692052,16,64.5138069170747,0,0
transformers_3.5.0,src/transformers/data/metrics/squad_metrics.py,765,471,529,19,170,135,249,189,384,1340.30708189884,13.9147058823529,40406.9295913298,2244.82942174054,2903.90109090089,128,22.7272436837698,0,0
transformers_3.5.0,docs/source/conf.py,198,33,65,0,0,0,0,0,0,0,0,0,0,0,1,100,0,0
transformers_3.5.0,tests/test_modeling_tf_xlnet.py,794,171,704,3,18,14,25,21,39,79.8135375281251,2.08333333333333,356.875790600774,19.8264328111541,171.300379488372,33,45.0719228519521,0,0
transformers_3.5.0,tests/test_modeling_mbart.py,175,102,145,3,6,3,6,9,9,20.2646625064904,1.5,42.7939875194712,2.37744375108173,28.5293250129808,19,50.4845115851825,0,0
transformers_3.5.0,tests/test_modeling_tf_mobilebert.py,292,153,237,0,0,0,0,0,0,0,0,0,0,0,15,100,0,0
transformers_3.5.0,tests/test_modeling_tf_openai.py,243,117,189,0,0,0,0,0,0,0,0,0,0,0,22,100,0,0
transformers_3.5.0,tests/test_modeling_tf_bart.py,389,206,299,7,43,29,47,50,76,252.980868906593,3.82558139534884,1640.91837405962,91.162131892201,428.933070422879,40,42.7658673081258,0,0
transformers_3.5.0,tests/test_modeling_tf_auto.py,202,109,152,1,2,1,2,3,3,2,0.5,2.37744375108173,0.13208020839343,4.75488750216347,24,67.5518683956541,0,0
transformers_3.5.0,tests/test_file_utils.py,63,38,38,0,0,0,0,0,0,0,0,0,0,0,7,100,0,0
transformers_3.5.0,tests/test_tokenization_dpr.py,89,50,57,2,26,13,26,28,39,124.211432671668,1,187.486841960247,10.4159356644581,187.486841960247,3,71.6404531367886,0,0
transformers_3.5.0,tests/test_pipelines_feature_extraction.py,12,7,9,0,0,0,0,0,0,0,0,0,0,0,1,100,0,0
transformers_3.5.0,tests/test_modeling_bart.py,718,390,592,11,52,37,58,63,95,334.476613148347,6.13461538461539,3483.48977080125,193.527209488958,567.841592732492,69,29.5674474385061,0,0
transformers_3.5.0,tests/test_modeling_openai.py,269,130,213,2,4,2,4,6,6,10,1,15.5097750043269,0.861654166907052,15.5097750043269,25,61.2441675661064,0,0
transformers_3.5.0,tests/test_tokenization_prophetnet.py,191,94,132,2,13,7,14,15,21,50.1057163358342,1.07692307692308,88.3558334699157,4.90865741499532,82.0447025077789,22,58.8645654651855,0,0
transformers_3.5.0,tests/test_modeling_distilbert.py,250,129,204,1,1,4,4,2,8,0,2,16,0.888888888888889,8,24,59.5120124868983,0,0
transformers_3.5.0,tests/test_modeling_tf_pegasus.py,141,77,92,1,2,1,2,3,3,2,0.5,2.37744375108173,0.13208020839343,4.75488750216347,16,77.112442793764,0,0
transformers_3.5.0,tests/test_pipelines_sentiment_analysis.py,12,7,9,0,0,0,0,0,0,0,0,0,0,0,1,100,0,0
transformers_3.5.0,tests/test_tokenization_xlm_prophetnet.py,125,33,92,2,13,22,42,15,64,50.1057163358342,3.23076923076923,807.824763153515,44.8791535085286,250.040998118945,7,70.8509869277703,0,0
transformers_3.5.0,tests/test_tokenization_xlm_roberta.py,231,57,183,2,13,21,41,15,62,50.1057163358342,3.15384615384615,763.947376464373,42.4415209146874,242.227216927728,10,64.5497969270142,0,0
transformers_3.5.0,tests/test_modeling_gpt2.py,550,271,422,5,25,33,45,30,78,127.706045218805,4.5,1722.31859905859,95.6843666143661,382.737466457464,39,41.5565938919701,0,0
transformers_3.5.0,tests/test_skip_decorators.py,120,48,48,2,4,2,4,6,6,10,1,15.5097750043269,0.861654166907052,15.5097750043269,11,79.4504276353346,0,0
transformers_3.5.0,tests/test_onnx.py,177,115,112,2,4,3,6,6,9,10,1.5,34.8969937597356,1.93872187554087,23.2646625064904,24,67.4079879031253,0,0
transformers_3.5.0,tests/test_modeling_fsmt.py,520,284,402,9,42,29,46,51,75,255.006656769689,4.92857142857143,2096.77151033589,116.487306129772,425.431900647862,51,40.0741239690681,0,0
transformers_3.5.0,tests/test_modeling_blenderbot.py,215,118,155,4,18,10,20,22,30,83.0586500259616,2.22222222222222,297.295441242486,16.5164134023604,133.782948559119,24,56.0870106695227,0,0
transformers_3.5.0,tests/test_tokenization_phobert.py,66,37,36,1,4,2,4,5,6,8,0.5,6.96578428466209,0.38698801581456,13.9315685693242,6,85.0860775106629,0,0
transformers_3.5.0,tests/test_modeling_tf_electra.py,250,142,196,0,0,0,0,0,0,0,0,0,0,0,27,100,0,0
transformers_3.5.0,tests/test_tokenization_bert_generation.py,211,55,168,2,15,21,42,17,63,60.6033589341278,2.8,721.02844519656,40.0571358442533,257.510158998771,8,61.0484974873328,0,0
transformers_3.5.0,tests/test_doc_samples.py,114,63,72,5,10,9,18,15,27,44.8289214233104,4.5,474.687207366435,26.3715115203575,105.48604608143,25,70.6891589129412,0,0
transformers_3.5.0,tests/test_modeling_tf_lxmert.py,756,345,627,7,44,43,62,51,105,259.866475674444,4.93181818181818,2937.41389583683,163.189660879824,595.604660907007,54,30.54968690291,0,0
transformers_3.5.0,tests/test_modeling_tf_funnel.py,394,180,324,2,5,3,5,7,8,13.6096404744368,1,22.4588393764608,1.24771329869227,22.4588393764608,32,51.1009017614987,0,0
transformers_3.5.0,tests/test_modeling_tf_mbart.py,134,75,85,0,0,0,0,0,0,0,0,0,0,0,15,100,0,0
transformers_3.5.0,tests/test_trainer.py,729,467,552,13,102,83,160,115,243,728.693101216927,10.1960784313725,16960.7082909281,942.261571718226,1663.45408237948,70,28.6399492774568,0,0
transformers_3.5.0,tests/test_modeling_deberta.py,260,137,209,1,7,7,7,8,14,19.6514844544032,0.5,21,1.16666666666667,42,14,56.4317663495484,0,0
transformers_3.5.0,tests/test_pipelines_common.py,274,127,164,5,14,9,14,19,23,64.9126093832433,2.5,244.255832023006,13.5697684457226,97.7023328092025,47,62.979718310108,0,0
transformers_3.5.0,tests/test_modeling_bert.py,480,204,412,2,3,7,8,5,15,6.75488750216347,2.66666666666667,92.8771237954945,5.1598402108608,34.8289214233104,41,44.9171100256522,0,0
transformers_3.5.0,tests/test_optimization_tf.py,86,70,71,2,5,11,12,7,23,13.6096404744368,2.4,154.96599169758,8.60922176097665,64.5691632073249,7,46.1357572830041,0,0
transformers_3.5.0,tests/test_modeling_flax_roberta.py,42,29,29,1,2,1,2,3,3,2,0.5,2.37744375108173,0.13208020839343,4.75488750216347,6,73.5261132860422,0,0
transformers_3.5.0,tests/test_cli.py,33,12,12,1,4,3,6,5,9,8,0.75,15.6730146404897,0.870723035582761,20.8973528539863,5,88.0197488851218,0,0
transformers_3.5.0,tests/test_tokenization_bart.py,185,111,150,5,15,10,18,20,28,70.2129994085646,3,363.041959970538,20.168997776141,121.013986656846,20,51.5733708026023,0,0
transformers_3.5.0,tests/test_modeling_xlnet.py,967,228,851,4,26,24,42,30,66,130.211432671668,3.23076923076923,1046.30005623283,58.127780901824,323.854779310162,37,39.6923937041009,0,0
transformers_3.5.0,tests/test_data_collator.py,230,178,181,6,33,25,43,39,68,181.974780943156,3.90909090909091,1404.95600799575,78.0531115553193,359.407350882633,26,41.1059623919533,0,0
transformers_3.5.0,tests/test_modeling_tf_bert.py,330,165,270,1,2,1,2,3,3,2,0.5,2.37744375108173,0.13208020839343,4.75488750216347,32,55.8724999387987,0,0
transformers_3.5.0,tests/test_tokenization_gpt2.py,175,81,116,2,7,4,7,9,11,21.6514844544032,1,34.8691750158654,1.9371763897703,34.8691750158654,11,70.9737358154139,0,0
transformers_3.5.0,tests/test_tokenization_blenderbot.py,102,66,64,4,18,10,19,22,29,83.0586500259616,2.11111111111111,273.016313541017,15.1675729745009,129.323516940482,17,68.8559411910282,0,0
transformers_3.5.0,tests/test_tokenization_layoutlm.py,74,32,45,1,2,1,2,3,3,2,0.5,2.37744375108173,0.13208020839343,4.75488750216347,7,88.2410911079749,0,0
transformers_3.5.0,tests/test_trainer_tpu.py,119,70,79,4,16,10,20,20,30,72,2.5,324.144607116552,18.0080337286973,129.657842846621,15,63.3615043324716,0,0
transformers_3.5.0,tests/test_configuration_common.py,81,51,51,0,0,0,0,0,0,0,0,0,0,0,11,100,0,0
transformers_3.5.0,tests/test_modeling_reformer.py,1145,556,993,9,100,98,117,109,215,692.914943990453,5.265,7661.41545103936,425.634191724409,1455.15962982704,73,20.240208586287,0,0
transformers_3.5.0,tests/test_tokenization_xlnet.py,182,46,145,2,40,42,84,42,126,214.877123795494,2.1,1426.80719006726,79.2670661148478,679.431995270124,8,60.8979330729842,0,0
transformers_3.5.0,tests/test_modeling_tf_gpt2.py,401,195,299,5,20,23,34,25,57,98.0482023721841,4.25,1124.97416197293,62.4985645540515,264.699802817159,29,49.864205789039,0,0
transformers_3.5.0,tests/test_pipelines_dialog.py,29,20,20,0,0,0,0,0,0,0,0,0,0,0,3,100,0,0
transformers_3.5.0,tests/test_generation_utils.py,513,187,426,9,62,54,72,71,126,397.689496256967,5.2258064516129,4049.31090978482,224.961717210268,774.86813705759,33,43.301182617875,0,0
transformers_3.5.0,tests/test_tokenization_reformer.py,326,88,261,3,13,20,39,16,59,52.8606038379977,4.5,1062,59,236,12,56.541033725063,0,0
transformers_3.5.0,tests/test_flax_auto.py,64,50,50,0,0,0,0,0,0,0,0,0,0,0,10,100,0,0
transformers_3.5.0,tests/test_benchmark.py,250,125,229,0,0,0,0,0,0,0,0,0,0,0,18,100,0,0
transformers_3.5.0,tests/test_pipelines_summarization.py,30,21,23,2,3,2,3,5,5,6.75488750216347,1,11.6096404744368,0.6449800263576,11.6096404744368,3,80.0727832287482,0,0
transformers_3.5.0,tests/test_modeling_tf_xlm.py,366,150,305,2,4,2,4,6,6,10,1,15.5097750043269,0.861654166907052,15.5097750043269,27,55.0193931407762,0,0
transformers_3.5.0,tests/test_modeling_marian.py,329,189,253,3,8,5,8,11,13,28.7548875021635,1.5,67.4589165634273,3.74771758685707,44.9726110422849,37,50.2276914818893,0,0
transformers_3.5.0,tests/test_tokenization_utils.py,226,159,162,0,0,0,0,0,0,0,0,0,0,0,21,100,0,0
transformers_3.5.0,tests/__init__.py,0,0,0,0,0,0,0,0,0,0,0,0,0,0,1,100,0,0
transformers_3.5.0,tests/test_modeling_xlm.py,442,182,373,5,9,11,16,14,27,40.1389654874176,4.44444444444444,456.882590646912,25.3823661470507,102.798582895555,32,45.8041462590325,0,0
transformers_3.5.0,tests/test_tokenization_distilbert.py,43,17,19,2,15,8,16,17,24,60.6033589341278,1.06666666666667,104.639048736009,5.81328048533382,98.0991081900082,4,87.2856935820907,0,0
transformers_3.5.0,tests/test_tokenization_ctrl.py,65,37,36,1,4,2,4,5,6,8,0.5,6.96578428466209,0.38698801581456,13.9315685693242,5,85.2205804346395,0,0
transformers_3.5.0,tests/test_optimization.py,165,79,124,4,13,12,15,17,27,56.1057163358342,2.30769230769231,254.680377031752,14.1489098350973,110.361496713759,17,63.6344937822264,0,0
transformers_3.5.0,tests/test_modeling_tf_flaubert.py,370,159,304,3,10,8,10,13,18,37.9741684510371,1.5,99.9118723898095,5.55065957721164,66.6079149265397,29,50.1287872986474,0,0
transformers_3.5.0,tests/test_pipelines_text_generation.py,29,21,20,0,0,0,0,0,0,0,0,0,0,0,2,100,0,0
transformers_3.5.0,tests/test_tokenization_auto.py,120,64,82,3,8,4,8,11,12,28.7548875021635,1.5,62.2697691354714,3.4594316186373,41.5131794236476,23,70.7394299681044,0,0
transformers_3.5.0,tests/test_tokenization_deberta.py,74,41,44,7,19,12,23,26,35,100.362107209831,4.23684210526316,697.025731887501,38.7236517715279,164.515390134938,14,75.1614140122641,0,0
transformers_3.5.0,tests/test_modeling_roberta.py,453,207,354,2,24,27,41,26,68,112.039100017308,1.70833333333333,546.034413924057,30.3352452180032,319.629900833594,35,45.1796987674236,0,0
transformers_3.5.0,tests/conftest.py,37,17,19,0,0,0,0,0,0,0,0,0,0,0,2,100,0,0
transformers_3.5.0,tests/test_modeling_dpr.py,229,116,183,1,4,2,4,5,6,8,0.5,6.96578428466209,0.38698801581456,13.9315685693242,24,60.0739797497494,0,0
transformers_3.5.0,tests/test_modeling_longformer.py,703,350,567,9,106,108,145,115,253,741.68889319668,6.15566037735849,10661.0435031606,592.280194620034,1731.90898288893,39,32.0441731396997,0,0
transformers_3.5.0,tests/test_modeling_tf_blenderbot.py,132,68,86,1,2,1,2,3,3,2,0.5,2.37744375108173,0.13208020839343,4.75488750216347,14,78.7356834740894,0,0
transformers_3.5.0,tests/test_modeling_layoutlm.py,239,128,185,2,6,3,6,8,9,17.5097750043269,1,27,1.5,27,28,57.4269700232302,0,0
transformers_3.5.0,tests/test_tokenization_funnel.py,83,39,53,3,14,8,16,17,24,58.0578564109699,1.71428571428571,168.1698997543,9.34277220857221,98.0991081900082,9,75.7144056765841,0,0
transformers_3.5.0,tests/test_model_output.py,103,81,73,0,0,0,0,0,0,0,0,0,0,0,7,100,0,0
transformers_3.5.0,tests/test_modeling_tf_common.py,1026,598,790,18,165,123,195,183,318,1290.50181537652,10.6363636363636,25420.829834836,1412.26832415756,2389.99254857433,153,14.2749623541274,0,0
transformers_3.5.0,tests/test_modeling_tf_xlm_roberta.py,57,22,32,1,3,3,3,4,6,4.75488750216347,0.5,6,0.333333333333333,12,3,91.8333281749974,0,0
transformers_3.5.0,tests/test_tokenization_bertweet.py,64,36,35,1,4,2,4,5,6,8,0.5,6.96578428466209,0.38698801581456,13.9315685693242,6,85.4883227030657,0,0
transformers_3.5.0,tests/test_modeling_tf_t5.py,442,226,314,5,26,23,36,31,59,133.821073146105,3.46153846153846,1011.79932339055,56.2110735216973,292.297582312826,31,46.0848755788219,0,0
transformers_3.5.0,tests/test_modeling_ctrl.py,219,111,170,0,0,0,0,0,0,0,0,0,0,0,20,100,0,0
transformers_3.5.0,tests/test_pipelines_ner.py,224,118,179,0,0,0,0,0,0,0,0,0,0,0,31,100,0,0
transformers_3.5.0,tests/test_generation_beam_search.py,239,110,150,6,34,31,49,40,80,188.483511606839,4.32352941176471,1840.76101164339,102.264500646855,425.754247590989,15,61.0535098578718,0,0
transformers_3.5.0,tests/test_trainer_callback.py,230,149,172,8,40,31,54,48,85,236.877123795494,5.4,2563.49778783101,142.41654376839,474.721812561298,39,43.2383742415843,0,0
transformers_3.5.0,tests/test_modeling_tf_distilbert.py,223,127,172,0,0,0,0,0,0,0,0,0,0,0,24,100,0,0
transformers_3.5.0,tests/test_tokenization_camembert.py,66,33,33,1,1,1,1,2,2,0,0.5,1,0.055555555555556,2,5,92.8941169190527,0,0
transformers_3.5.0,tests/test_tokenization_common.py,2539,1413,1843,18,366,303,575,384,878,3191.80479083792,14.1393442622951,106576.679962846,5920.92666460256,7537.59707563318,316,0,0,0
transformers_3.5.0,tests/test_hf_argparser.py,171,139,124,1,2,2,4,3,6,2,1,9.50977500432694,0.528320833573719,9.50977500432694,15,53.6472250312611,0,0
transformers_3.5.0,tests/test_activations_tf.py,25,20,20,0,0,0,0,0,0,0,0,0,0,0,3,100,0,0
transformers_3.5.0,tests/test_modeling_tf_ctrl.py,209,104,159,0,0,0,0,0,0,0,0,0,0,0,20,100,0,0
transformers_3.5.0,tests/test_modeling_squeezebert.py,287,149,237,1,2,5,5,3,10,2,1.25,19.8120312590145,1.10066840327858,15.8496250072116,25,54.9399553917627,0,0
transformers_3.5.0,tests/test_pipelines_fill_mask.py,228,143,180,0,0,0,0,0,0,0,0,0,0,0,47,100,0,0
transformers_3.5.0,tests/test_modeling_encoder_decoder.py,813,320,685,4,28,27,43,32,70,142.605937817613,3.07142857142857,1075,59.7222222222222,350,50,32.9059535429692,0,0
transformers_3.5.0,tests/test_modeling_funnel.py,483,230,403,7,34,24,41,41,65,192.625221056915,4.22058823529412,1469.78136244339,81.6545201357438,348.240880300175,41,38.4889586319282,0,0
transformers_3.5.0,tests/test_pipelines_question_answering.py,159,135,129,0,0,0,0,0,0,0,0,0,0,0,18,100,0,0
transformers_3.5.0,tests/test_tokenization_albert.py,104,55,62,3,16,9,17,19,26,68.7548875021635,1.59375,176.023496338319,9.77908312990659,110.446115349533,9,71.4221650594579,0,0
transformers_3.5.0,tests/test_hf_api.py,141,85,92,2,6,4,6,8,10,17.5097750043269,1,30,1.66666666666667,30,21,70.2277934578386,0,0
transformers_3.5.0,tests/test_modeling_lxmert.py,709,269,616,7,26,32,45,33,77,141.862917126072,6.05769230769231,2352.91883394306,130.717712996837,388.418347190601,42,33.883197746511,0,0
transformers_3.5.0,tests/test_modeling_xlm_prophetnet.py,142,70,104,1,21,21,21,22,42,92.238665878354,0.5,93.6480639913832,5.20267022174351,187.296127982766,7,65.0952507934795,0,0
transformers_3.5.0,tests/test_pipelines_text2text_generation.py,11,8,8,0,0,0,0,0,0,0,0,0,0,0,1,100,0,0
transformers_3.5.0,tests/test_tokenization_openai.py,129,48,85,1,2,1,2,3,3,2,0.5,2.37744375108173,0.13208020839343,4.75488750216347,6,83.200712951406,0,0
transformers_3.5.0,tests/test_modeling_tf_transfo_xl.py,532,104,454,2,8,5,10,10,15,26,1.25,62.2861517791381,3.46034176550767,49.8289214233104,22,57.6529649684476,0,0
transformers_3.5.0,tests/test_tokenization_bert.py,301,142,222,3,19,11,20,22,31,85.4655102575916,1.57894736842105,218.277442385931,12.1265245769962,138.242380177756,33,49.0620426363046,0,0
transformers_3.5.0,tests/test_modeling_tf_longformer.py,624,321,477,10,119,108,150,129,258,853.702594782519,6.30252100840336,11400.6090245748,633.367168031933,1808.8966318992,36,34.712617186933,0,0
transformers_3.5.0,tests/test_modeling_mobilebert.py,458,197,381,8,17,17,25,25,42,93.4868683012558,5.88235294117647,1147.30564688552,63.7392026047511,195.041959970538,36,42.4367753788475,0,0
transformers_3.5.0,tests/test_modeling_tf_roberta.py,263,152,205,1,7,7,7,8,14,19.6514844544032,0.5,21,1.16666666666667,42,26,53.5389668471263,0,0
transformers_3.5.0,tests/test_modeling_flax_bert.py,42,29,29,1,2,1,2,3,3,2,0.5,2.37744375108173,0.13208020839343,4.75488750216347,6,73.5261132860422,0,0
transformers_3.5.0,tests/test_pipelines_translation.py,54,39,39,0,0,0,0,0,0,0,0,0,0,0,5,100,0,0
transformers_3.5.0,tests/test_generation_logits_process.py,283,146,169,8,50,42,75,58,117,306.192809488736,6,4112.30265857956,228.461258809975,685.383776429926,11,57.7142564838235,0,0
transformers_3.5.0,tests/test_tokenization_mbart.py,233,111,196,4,26,31,56,30,87,130.211432671668,4.30769230769231,1838.95161398498,102.163978554721,426.899481817941,23,46.4327905769241,0,0
transformers_3.5.0,tests/test_modeling_xlm_roberta.py,69,30,32,1,11,11,11,12,22,38.0537478050103,0.5,39.4345875079327,2.19081041710737,78.8691750158654,4,81.9179877584145,0,0
transformers_3.5.0,tests/test_utils_check_copies.py,104,41,78,4,12,8,16,16,24,51.0195500086539,2.66666666666667,256,14.2222222222222,96,8,67.8732262224741,0,0
transformers_3.5.0,tests/test_modeling_flaubert.py,402,169,335,5,9,11,16,14,27,40.1389654874176,4.44444444444444,456.882590646912,25.3823661470507,102.798582895555,30,46.0708983257781,0,0
transformers_3.5.0,tests/test_tokenization_pegasus.py,69,52,52,5,31,18,35,36,53,165.18972609643,2.82258064516129,773.404103038346,42.9668946132414,274.006025076443,23,58.2983936599115,0,0
transformers_3.5.0,tests/test_retrieval_rag.py,343,197,313,4,29,21,33,33,54,148.8814488587,2.27586206896552,619.938642806673,34.4410357114819,272.397282445356,21,41.1472875117924,0,0
transformers_3.5.0,tests/test_tokenization_squeezebert.py,46,19,21,2,15,8,16,17,24,60.6033589341278,1.06666666666667,104.639048736009,5.81328048533382,98.0991081900082,5,86.5129404771989,0,0
transformers_3.5.0,tests/test_modeling_rag.py,1042,409,835,6,40,22,46,46,68,228.386898799821,3.45,1295.82763489098,71.9904241606097,375.602213011877,56,31.1340471830332,0,0
transformers_3.5.0,tests/test_modeling_prophetnet.py,1226,555,1015,10,63,68,96,73,164,409.787916129368,7.61904761904762,7734.33316309579,429.685175727544,1015.13122765632,84,22.7270753579912,0,0
transformers_3.5.0,tests/test_tokenization_t5.py,224,102,168,3,13,20,39,16,59,52.8606038379977,4.5,1062,59,236,16,55.3247251618456,0,0
transformers_3.5.0,tests/test_trainer_distributed.py,121,73,87,6,20,13,25,26,38,101.948336902074,3.75,669.812659835106,37.2118144352836,178.616709289362,17,57.5122608441215,0,0
transformers_3.5.0,tests/test_modeling_tf_albert.py,280,142,224,0,0,0,0,0,0,0,0,0,0,0,26,100,0,0
transformers_3.5.0,tests/test_modeling_tf_marian.py,197,122,133,0,0,0,0,0,0,0,0,0,0,0,22,100,0,0
transformers_3.5.0,tests/test_pipelines_zero_shot.py,141,70,118,5,10,6,11,15,17,44.8289214233104,2.75,182.647135344698,10.1470630747055,66.4171401253448,17,54.1906263792258,0,0
transformers_3.5.0,tests/test_modeling_t5.py,699,322,545,6,51,47,74,57,121,304.803467444873,4.35294117647059,3072.2174815783,170.678748976572,705.779691713934,57,35.2868337149281,0,0
transformers_3.5.0,tests/test_modeling_pegasus.py,113,71,89,4,15,8,15,19,23,66.6033589341278,2,195.404665618405,10.8558147565781,97.7023328092025,19,52.0648634828008,0,0
transformers_3.5.0,tests/test_modeling_common.py,1022,679,768,14,136,142,217,150,359,1017.19791531885,11.1691176470588,28985.4899788228,1610.30499882349,2595.14590988802,130,13.8494218580003,0,0
transformers_3.5.0,tests/test_trainer_utils.py,58,29,33,0,0,0,0,0,0,0,0,0,0,0,5,100,0,0
transformers_3.5.0,tests/test_modeling_albert.py,282,149,230,2,3,7,8,5,15,6.75488750216347,2.66666666666667,92.8771237954945,5.1598402108608,34.8289214233104,29,52.6574323838447,0,0
transformers_3.5.0,tests/test_configuration_auto.py,53,26,24,2,4,2,4,6,6,10,1,15.5097750043269,0.861654166907052,15.5097750043269,8,87.8792635983591,0,0
transformers_3.5.0,tests/test_tokenization_fsmt.py,167,83,112,2,13,7,14,15,21,50.1057163358342,1.07692307692308,88.3558334699157,4.90865741499532,82.0447025077789,14,66.7913635196386,0,0
transformers_3.5.0,tests/test_modeling_auto.py,220,125,174,2,4,3,4,6,7,10,1,18.0947375050481,1.00526319472489,18.0947375050481,30,59.058899584745,0,0
transformers_3.5.0,tests/test_modeling_tf_pytorch.py,243,136,186,0,0,0,0,0,0,0,0,0,0,0,21,100,0,0
transformers_3.5.0,tests/test_modeling_electra.py,341,149,288,2,3,7,8,5,15,6.75488750216347,2.66666666666667,92.8771237954945,5.1598402108608,34.8289214233104,30,51.0798668526411,0,0
transformers_3.5.0,tests/test_tokenization_bert_japanese.py,269,138,185,2,28,18,36,30,54,136.605937817613,1.28571428571429,340.678404209391,18.9265780116329,264.97209216286,37,50.8892184017007,0,0
transformers_3.5.0,tests/test_tokenization_lxmert.py,89,43,57,2,3,2,3,5,5,6.75488750216347,1,11.6096404744368,0.6449800263576,11.6096404744368,7,80.9907862206158,0,0
transformers_3.5.0,tests/test_tokenization_herbert.py,128,63,88,3,18,10,19,21,29,79.8135375281251,1.58333333333333,201.680574995925,11.2044763886625,127.377205260584,9,66.8715537044767,0,0
transformers_3.5.0,tests/test_tokenization_roberta.py,198,108,141,3,14,8,16,17,24,58.0578564109699,1.71428571428571,168.1698997543,9.34277220857221,98.0991081900082,14,61.1624469686062,0,0
transformers_3.5.0,tests/test_modeling_tf_camembert.py,54,21,26,1,5,5,5,6,10,11.6096404744368,0.5,12.9248125036058,0.71804513908921,25.8496250072116,3,89.5175111163942,0,0
transformers_3.5.0,tests/test_pipelines_conversational.py,145,100,109,2,3,2,3,5,5,6.75488750216347,1,11.6096404744368,0.6449800263576,11.6096404744368,7,72.4574465927047,0,0
transformers_3.5.0,tests/test_tokenization_xlm.py,98,43,64,2,17,9,18,19,27,71.4868683012558,1.05882352941176,121.440751266681,6.74670840370452,114.694042862977,7,73.6590373246785,0,0
transformers_3.5.0,tests/test_tokenization_rag.py,156,71,139,2,6,3,7,8,10,17.5097750043269,1.16666666666667,35,1.94444444444444,30,12,54.8528072012897,0,0
transformers_3.5.0,tests/test_tokenization_transfo_xl.py,130,45,90,1,4,2,4,5,6,8,0.5,6.96578428466209,0.38698801581456,13.9315685693242,10,76.9993017472553,0,0
transformers_3.5.0,tests/test_model_card.py,81,38,54,0,0,0,0,0,0,0,0,0,0,0,7,100,0,0
transformers_3.5.0,tests/test_modeling_camembert.py,55,21,28,1,5,5,5,6,10,11.6096404744368,0.5,12.9248125036058,0.71804513908921,25.8496250072116,3,89.8330492203084,0,0
transformers_3.5.0,tests/test_modeling_transfo_xl.py,666,175,568,9,32,30,58,41,88,188.529325012981,8.15625,3845.38295131463,213.632386184146,471.464576406391,42,43.8561428333037,0,0
transformers_3.5.0,tests/test_tokenization_marian.py,94,57,59,3,9,7,13,12,20,33.2842125151443,2.16666666666667,155.34837503125,8.63046527951389,71.6992500144231,11,71.9766795919497,0,0
transformers_3.5.0,tests/test_logging.py,91,52,56,2,4,3,6,6,9,10,1.5,34.8969937597356,1.93872187554087,23.2646625064904,6,76.7688718703721,0,0
transformers_3.5.0,tests/test_benchmark_tf.py,212,106,193,0,0,0,0,0,0,0,0,0,0,0,16,100,0,0
transformers_3.5.0,tests/test_modeling_bert_generation.py,236,95,189,0,0,0,0,0,0,0,0,0,0,0,20,100,0,0
transformers_3.5.0,tests/test_activations.py,31,24,24,1,3,3,3,4,6,4.75488750216347,0.5,6,0.333333333333333,12,4,61.7976686371144,0,0
transformers_3.5.0,utils/check_dummies.py,396,195,298,9,66,63,116,75,179,427.459336890639,7.90909090909091,8818.3084970084,489.906027611578,1114.95854559876,48,39.3295928643355,0,0
transformers_3.5.0,utils/check_repo.py,400,207,295,12,131,84,156,143,240,964.39796321006,7.14503816793893,12277.8129549152,682.100719717514,1718.36912082681,69,39.894431531233,0,0
transformers_3.5.0,utils/download_glue_data.py,154,94,114,4,29,18,33,33,51,148.8814488587,2.27586206896552,585.497607095192,32.5276448386218,257.264100087281,18,58.1457854049459,0,0
transformers_3.5.0,utils/check_copies.py,295,202,198,16,109,88,167,125,255,801.732091400685,12.256880733945,21771.5907348503,1209.53281860279,1776.27499258883,52,44.0107789227748,0,0
transformers_3.5.0,utils/style_doc.py,465,310,317,17,193,128,251,210,379,1534.831076494,11.0544041450777,32319.7509104949,1795.54171724972,2923.69905119546,114,31.2819414081188,0,0
transformers_3.5.0,utils/link_tester.py,82,49,45,6,17,9,18,23,27,84.9966433055827,3.17647058823529,387.961960701831,21.5534422612128,122.136172813539,15,73.713846565063,0,0
transformers_3.5.0,utils/get_modified_files.py,34,10,9,0,0,0,0,0,0,0,0,0,0,0,3,100,0,0
transformers_3.5.0,templates/adding_a_new_model/modeling_tf_xxx.py,842,306,614,10,84,96,175,94,271,570.17394446229,10.4166666666667,18503.0581125483,1027.94767291935,1776.29357880464,101,31.9937534160616,0,0
transformers_3.5.0,templates/adding_a_new_model/configuration_xxx.py,108,24,39,0,0,0,0,0,0,0,0,0,0,0,2,100,0,0
transformers_3.5.0,templates/adding_a_new_model/modeling_xxx.py,808,316,582,12,79,105,174,91,279,541.018229114645,13.2151898734177,23994.4859698546,1333.02699832526,1815.67470461544,86,33.6232029602802,0,0
transformers_3.5.0,templates/adding_a_new_model/tokenization_xxx.py,296,101,135,7,64,39,77,71,116,403.651484454403,4.2109375,3003.95928828055,166.886627126697,713.370665862543,29,60.0287888114207,0,0
transformers_3.5.0,templates/adding_a_new_model/convert_xxx_original_tf_checkpoint_to_pytorch.py,61,20,30,1,2,1,2,3,3,2,0.5,2.37744375108173,0.13208020839343,4.75488750216347,2,95.8316665485003,0,0
transformers_3.5.0,templates/adding_a_new_model/tests/test_tokenization_xxx.py,68,26,39,1,2,1,2,3,3,2,0.5,2.37744375108173,0.13208020839343,4.75488750216347,7,91.1194370192185,0,0
transformers_3.5.0,templates/adding_a_new_model/tests/test_modeling_tf_xxx.py,257,133,207,0,0,0,0,0,0,0,0,0,0,0,13,100,0,0
transformers_3.5.0,templates/adding_a_new_model/tests/test_modeling_xxx.py,307,165,244,2,7,9,12,9,21,21.6514844544032,1.71428571428571,114.117300051923,6.33985000288463,66.5684250302886,32,51.2570119768855,0,0
transformers_3.5.0,templates/adding_a_new_example_script/{{cookiecutter.directory_name}}/run_{{cookiecutter.example_shortcut}}.py,339,144,231,9,40,28,53,49,81,241.406448808475,5.9625,2711.69430308849,150.649683504916,454.791497373332,39,55.5373798161683,0,0
transformers_3.5.0,scripts/pegasus/build_test_sample_spm_no_bos.py,20,2,2,0,0,0,0,0,0,0,0,0,0,0,1,100,0,0
transformers_3.5.0,scripts/fsmt/gen-card-facebook-wmt19.py,152,20,108,1,6,3,6,7,9,15.5097750043269,0.5,12.6330971492592,0.701838730514401,25.2661942985184,2,75.2493001681339,0,0
transformers_3.5.0,scripts/fsmt/gen-card-allenai-wmt19.py,140,19,98,1,6,3,6,7,9,15.5097750043269,0.5,12.6330971492592,0.701838730514401,25.2661942985184,2,76.3589096795664,0,0
transformers_3.5.0,scripts/fsmt/fsmt-make-super-tiny-model.py,74,31,42,1,4,3,6,5,9,8,0.75,15.6730146404897,0.870723035582761,20.8973528539863,1,86.6605961434543,0,0
transformers_3.5.0,scripts/fsmt/gen-card-allenai-wmt16.py,143,19,101,1,6,3,6,7,9,15.5097750043269,0.5,12.6330971492592,0.701838730514401,25.2661942985184,2,76.1630098077222,0,0
transformers_3.5.0,scripts/fsmt/fsmt-make-tiny-model.py,46,15,19,0,0,0,0,0,0,0,0,0,0,0,1,100,0,0
transformers_3.5.0,examples/lightning_base.py,397,177,334,10,35,21,41,45,62,212.744186541947,5.85714285714286,1994.32722441001,110.795956911667,340.49489197244,49,39.0732396806559,0,0
transformers_3.5.0,examples/test_examples.py,275,113,208,6,20,10,20,26,30,101.948336902074,3,423.039574632698,23.5021985907055,141.013191544233,21,56.2632523454169,0,0
transformers_3.5.0,examples/conftest.py,30,14,14,0,0,0,0,0,0,0,0,0,0,0,2,100,0,0
transformers_3.5.0,examples/xla_spawn.py,72,23,36,2,6,3,6,8,9,17.5097750043269,1,27,1.5,27,2,88.928740984031,0,0
transformers_3.5.0,examples/test_xla_examples.py,95,37,63,1,2,1,2,3,3,2,0.5,2.37744375108173,0.13208020839343,4.75488750216347,5,85.656320505584,0,0
transformers_3.5.0,examples/movement-pruning/counts_parameters.py,92,44,61,10,30,21,41,40,62,180.425998817129,6.83333333333333,2254.72353620061,125.262418677812,329.959541883016,10,71.9356720272242,0,0
transformers_3.5.0,examples/movement-pruning/masked_run_glue.py,953,469,789,19,325,280,523,344,803,2792.60679282807,15.2876923076923,103440.96872705,5746.72048483609,6766.29059802579,173,8.77239335979568,0,0
transformers_3.5.0,examples/movement-pruning/masked_run_squad.py,1133,512,919,20,327,281,522,347,803,2817.91757383562,15.9633027522936,108172.924332655,6009.60690736972,6776.34985762034,183,6.51518304092847,0,0
transformers_3.5.0,examples/movement-pruning/bertarize.py,132,76,98,9,32,29,54,41,83,188.529325012981,7.59375,3376.76457441069,187.598031911705,444.676816383301,18,60.6944698825714,0,0
transformers_3.5.0,examples/movement-pruning/emmental/modeling_bert_masked.py,1019,429,667,15,112,133,224,127,357,821.027110204579,15,37424.406497665,2079.13369431472,2494.96043317766,96,32.8414524720457,0,0
transformers_3.5.0,examples/movement-pruning/emmental/__init__.py,10,3,9,0,0,0,0,0,0,0,0,0,0,0,1,100,0,0
transformers_3.5.0,examples/movement-pruning/emmental/configuration_bert_masked.py,71,24,41,0,0,0,0,0,0,0,0,0,0,0,2,100,0,0
transformers_3.5.0,examples/movement-pruning/emmental/modules/__init__.py,3,2,2,0,0,0,0,0,0,0,0,0,0,0,1,100,0,0
transformers_3.5.0,examples/movement-pruning/emmental/modules/masked_nn.py,107,45,50,7,32,21,40,39,61,179.651484454403,4.375,1410.54171715886,78.3634287310479,322.409535350597,14,70.6978537720315,0,0
transformers_3.5.0,examples/movement-pruning/emmental/modules/binarizer.py,144,52,41,5,13,9,18,18,27,59.715356810271,3.46153846153846,389.727605904031,21.6515336613351,112.587975038942,8,51.2244264788087,0,0
transformers_3.5.0,examples/text-classification/run_pl_glue.py,201,129,153,7,27,17,31,34,48,148.033447012817,4.01851851851852,981.315054712288,54.5175030395715,244.198216380016,39,41.609160968229,0,0
transformers_3.5.0,examples/text-classification/run_tf_text_classification.py,292,130,218,8,38,22,45,46,67,223.421245510856,4.73684210526316,1753.0041365802,97.3891186989,370.07865105582,32,50.1553463956398,0,0
transformers_3.5.0,examples/text-classification/run_glue.py,416,203,287,15,69,52,101,84,153,480.091546451822,10.9782608695652,10737.0088189348,596.500489940822,978.02456568515,60,46.8141033598034,1,1
transformers_3.5.0,examples/text-classification/run_tf_glue.py,246,102,180,7,37,23,47,44,70,212.401258982674,4.44594594594595,1699.06365104347,94.3924250579707,382.160213304611,24,55.276824392887,0,0
transformers_3.5.0,examples/text-classification/run_xnli.py,621,326,489,17,153,139,247,170,386,1179.86720823323,13.7222222222222,39245.8972574023,2180.32762541124,2860.02490134915,106,26.5145788092718,0,0
transformers_3.5.0,examples/multiple-choice/run_tf_multiple_choice.py,214,77,147,6,17,8,17,23,25,84.9966433055827,3,339.267146704276,18.8481748169042,113.089048901425,16,67.0958389248492,0,0
transformers_3.5.0,examples/multiple-choice/utils_multiple_choice.py,579,319,405,11,79,49,95,90,144,536.052426911001,6.61392405063291,6182.87375908664,343.492986615925,934.826845871473,73,34.834657098631,0,0
transformers_3.5.0,examples/multiple-choice/run_multiple_choice.py,229,80,154,8,21,12,23,29,35,116.238665878354,4.38095238095238,744.890419252895,41.3828010696053,170.029334829465,18,65.503378499357,0,0
transformers_3.5.0,examples/adversarial/run_hans.py,231,79,156,8,25,14,27,33,41,140.096404744368,4.32,893.463086420769,49.6368381344872,206.820158893697,19,65.3757497162392,0,0
transformers_3.5.0,examples/adversarial/utils_hans.py,340,142,207,6,25,14,27,31,41,131.606179748695,3.24,658.115437871793,36.5619687706551,203.122048725862,31,59.8408147683371,0,0
transformers_3.5.0,examples/longform-qa/eli5_app.py,346,166,311,10,46,31,60,56,91,287.303130927496,6.52173913043478,3446.53889939506,191.474383299725,528.469297907242,34,34.7390149171725,0,0
transformers_3.5.0,examples/longform-qa/eli5_utils.py,687,402,581,19,196,129,254,215,383,1573.19375220201,12.3112244897959,36534.271018065,2029.68172322583,2967.55786139276,105,20.6973772795248,0,0
transformers_3.5.0,examples/text-generation/run_generation.py,295,125,198,9,50,32,60,59,92,310.722134501717,5.4,2922.49706692296,162.360948162387,541.20316054129,32,54.4776813142713,0,0
transformers_3.5.0,examples/text-generation/pplm/run_pplm_discrim_train.py,522,309,397,12,67,45,88,79,133,449.447525769325,7.88059701492537,6607.11491432819,367.0619396849,838.402839507555,52,32.7479085019782,0,0
transformers_3.5.0,examples/text-generation/pplm/run_pplm.py,810,377,631,17,151,133,236,168,369,1162.48598393934,13.2847682119205,36237.7274753958,2013.20708196643,2727.76512900536,83,27.1939504669416,0,0
transformers_3.5.0,examples/text-generation/pplm/pplm_classification_head.py,19,11,10,0,0,0,0,0,0,0,0,0,0,0,3,100,0,0
transformers_3.5.0,examples/bert-loses-patience/run_glue_with_pabee.py,744,369,600,16,174,152,275,190,427,1359.07216827768,12.6436781609195,40868.5193015293,2270.4732945294,3232.32834475731,122,20.8373916128031,0,0
transformers_3.5.0,examples/bert-loses-patience/test_run_glue_with_pabee.py,51,24,41,0,0,0,0,0,0,0,0,0,0,0,3,100,0,0
transformers_3.5.0,examples/bert-loses-patience/pabee/__init__.py,0,0,0,0,0,0,0,0,0,0,0,0,0,0,1,100,0,0
transformers_3.5.0,examples/bert-loses-patience/pabee/modeling_pabee_bert.py,342,139,192,10,43,47,88,53,135,266.548665401064,10.2325581395349,7912.52267444312,439.584593024618,773.269261366032,37,57.0195415544816,0,0
transformers_3.5.0,examples/bert-loses-patience/pabee/modeling_pabee_albert.py,316,141,194,10,52,54,101,62,155,329.64214629221,9.71153846153846,8962.78300376025,497.932389097791,922.900428109966,35,55.583467850231,0,0
transformers_3.5.0,examples/token-classification/tasks.py,163,103,143,7,32,23,46,39,69,179.651484454403,5.03125,1834.8604140419,101.936689668994,364.692753101495,36,41.9556575788578,0,0
transformers_3.5.0,examples/token-classification/utils_ner.py,372,164,243,13,76,57,112,89,169,522.948207357547,9.57894736842105,10483.1899405087,582.39944113937,1094.39894983332,41,52.0239116685642,0,0
transformers_3.5.0,examples/token-classification/run_ner.py,380,171,264,10,61,45,81,71,126,394.99425854021,6.63934426229508,5144.61631980859,285.812017767144,774.86813705759,44,50.8539463505222,0,0
transformers_3.5.0,examples/token-classification/test_ner_examples.py,57,26,48,1,4,2,4,5,6,8,0.5,6.96578428466209,0.38698801581456,13.9315685693242,3,60.7200103399652,0,0
transformers_3.5.0,examples/token-classification/run_pl_ner.py,215,133,166,7,22,14,26,29,40,117.758980064424,4.13636363636364,803.775037375653,44.6541687430918,194.319239805103,39,50.8390162176297,0,0
transformers_3.5.0,examples/token-classification/run_ner_old.py,308,121,220,7,22,13,25,29,38,117.758980064424,3.97727272727273,734.217582218145,40.7898656787858,184.603277814848,26,58.7641485853969,0,0
transformers_3.5.0,examples/token-classification/run_tf_ner.py,299,120,212,10,31,17,34,41,51,186.799366570867,5.48387096774194,1498.38631871093,83.2436843728294,273.235152235522,25,56.7067413642342,0,0
transformers_3.5.0,examples/token-classification/scripts/preprocess.py,41,26,26,5,7,6,11,12,17,31.26112492884,3.92857142857143,239.424281298163,13.3013489610091,60.9443625122597,5,71.8572040458364,0,0
transformers_3.5.0,examples/bertology/run_bertology.py,442,199,318,18,105,83,147,123,230,780.054429380905,12.6,20119.4070364731,1117.74483535962,1596.77833622803,45,44.9287057766637,0,0
transformers_3.5.0,examples/question-answering/run_squad.py,820,372,632,16,167,146,260,183,406,1297.07861684317,12.4550898203593,38005.1389187671,2111.39660659817,3051.37413434332,124,21.6723550282359,0,0
transformers_3.5.0,examples/question-answering/run_squad_trainer.py,165,50,103,6,17,10,19,23,29,84.9966433055827,3.35294117647059,439.849877256603,24.4361042920335,131.183296725653,16,73.7834058888739,0,0
transformers_3.5.0,examples/question-answering/run_tf_squad.py,249,84,182,5,11,5,11,16,16,49.6633882794471,2.5,160,8.88888888888889,64,19,66.1121318606043,0,0
transformers_3.5.0,examples/deebert/test_glue_deebert.py,99,36,87,0,0,0,0,0,0,0,0,0,0,0,6,100,0,0
transformers_3.5.0,examples/deebert/run_glue_deebert.py,724,402,607,18,218,187,338,236,525,1768.52283282733,13.954128440367,57747.5921191896,3208.1995621772,4138.38760091497,145,13.9986756068831,0,0
transformers_3.5.0,examples/deebert/src/modeling_highway_roberta.py,152,76,99,6,17,23,33,23,56,84.9966433055827,5.82352941176471,1475.21338143412,81.9562989685624,253.319469539193,14,67.2719299378174,0,0
transformers_3.5.0,examples/deebert/src/__init__.py,0,0,0,0,0,0,0,0,0,0,0,0,0,0,1,100,0,0
transformers_3.5.0,examples/deebert/src/modeling_highway_bert.py,396,203,253,13,72,63,109,85,172,492.340316439681,9.84027777777778,10848.0721980502,602.670677669454,1102.41524101568,55,48.5790550982671,0,0
transformers_3.5.0,examples/rag/distributed_retriever.py,140,60,62,4,10,6,10,14,16,41.2192809488736,2,121.835357505843,6.76863097254685,60.9176787529217,18,74.1529745194888,0,0
transformers_3.5.0,examples/rag/utils.py,244,155,187,11,49,30,57,60,87,313.174530166655,6.39795918367347,3287.90790918213,182.661550510119,513.899481817941,34,37.3916007859281,0,0
transformers_3.5.0,examples/rag/test_distributed_retriever.py,228,127,198,5,13,8,14,18,22,59.715356810271,2.69230769230769,246.987865470045,13.7215480816691,91.7383500317309,19,53.5969515102241,0,0
transformers_3.5.0,examples/rag/__init__.py,5,3,3,0,0,0,0,0,0,0,0,0,0,0,1,100,0,0
transformers_3.5.0,examples/rag/use_own_knowledge_dataset.py,200,93,134,5,18,10,20,23,30,86.6682905003984,2.77777777777778,376.963496338084,20.9424164632269,135.70685868171,11,63.7812881820944,0,0
transformers_3.5.0,examples/rag/callbacks.py,116,79,89,5,23,15,29,28,44,115.651565463748,3.15217391304348,666.75922614625,37.0421792303472,211.523616570535,21,56.5171960112697,0,0
transformers_3.5.0,examples/rag/parse_dpr_relevance_data.py,47,19,33,2,5,3,6,7,9,13.6096404744368,1.2,30.3194331582221,1.68441295323456,25.2661942985184,4,84.3486848748723,0,0
transformers_3.5.0,examples/rag/eval_rag.py,314,163,266,12,44,31,60,56,91,283.234541228695,8.18181818181818,4323.83971015016,240.213317230564,528.469297907242,38,34.9156636323968,0,0
transformers_3.5.0,examples/rag/finetune.py,499,275,421,15,68,45,83,83,128,472.550832139151,9.15441176470588,7470.04620426063,415.002566903369,816.005047212406,73,27.7289814157819,0,0
transformers_3.5.0,examples/rag/consolidate_rag_checkpoint.py,99,37,74,3,11,8,16,14,24,42.8086353071738,2.18181818181818,199.366948645925,11.0759415914403,91.3765181293825,7,67.3883218084813,0,0
transformers_3.5.0,examples/seq2seq/finetune_trainer.py,303,129,234,8,28,22,39,36,61,158.605937817613,5.57142857142857,1757.03593977589,97.6131077653275,315.365425087981,36,50.8298961105844,0,0
transformers_3.5.0,examples/seq2seq/utils.py,645,432,470,15,102,76,138,117,214,739.19074381522,10.1470588235294,14918.7949190248,828.821939945821,1470.25804999085,112,22.4166753541796,0,0
transformers_3.5.0,examples/seq2seq/run_eval.py,163,89,118,11,29,17,34,40,51,178.93519666371,6.44827586206897,1750.18028417037,97.2322380094651,271.418332839255,25,58.236696887455,0,0
transformers_3.5.0,examples/seq2seq/sentence_splitter.py,22,15,14,0,0,0,0,0,0,0,0,0,0,0,4,100,0,0
transformers_3.5.0,examples/seq2seq/run_distributed_eval.py,248,139,213,13,36,22,44,49,66,234.223016387757,7.94444444444444,2943.97952826441,163.554418236912,370.570849711604,29,47.0916285012811,0,0
transformers_3.5.0,examples/seq2seq/test_calculate_rouge.py,80,38,61,2,10,5,10,12,15,35.2192809488736,1,53.7744375108174,2.98746875060096,53.7744375108174,9,52.2106160784659,0,0
transformers_3.5.0,examples/seq2seq/rouge_cli.py,17,13,11,2,4,2,4,6,6,10,1,15.5097750043269,0.861654166907052,15.5097750043269,5,83.7936324159558,0,0
transformers_3.5.0,examples/seq2seq/test_tatoeba_conversion.py,26,21,21,1,2,1,2,3,3,2,0.5,2.37744375108173,0.13208020839343,4.75488750216347,5,65.7432963258333,0,0
transformers_3.5.0,examples/seq2seq/test_fsmt_bleu_score.py,78,34,52,2,4,2,4,6,6,10,1,15.5097750043269,0.861654166907052,15.5097750043269,5,84.2648468065179,0,0
transformers_3.5.0,examples/seq2seq/__init__.py,5,3,3,0,0,0,0,0,0,0,0,0,0,0,1,100,0,0
transformers_3.5.0,examples/seq2seq/pack_dataset.py,76,52,51,5,23,15,30,28,45,115.651565463748,3.26086956521739,705.427080954105,39.1903933863392,216.330971492592,11,67.9565143296797,0,0
transformers_3.5.0,examples/seq2seq/test_finetune_trainer.py,211,92,165,8,29,17,31,37,48,164.8814488587,4.27586206896552,1069.1953942146,59.3997441230335,250.05376155019,17,53.5863645114092,0,0
transformers_3.5.0,examples/seq2seq/convert_pl_checkpoint_to_hf.py,74,47,44,4,7,4,7,11,11,27.6514844544032,2,76.1074956100206,4.2281942005567,38.0537478050103,14,75.7335882213974,0,0
transformers_3.5.0,examples/seq2seq/seq2seq_trainer.py,226,107,161,12,47,39,68,59,107,304.085226037503,8.68085106382979,5464.09925453065,303.561069696147,629.442806281717,47,52.3363919282133,0,0
transformers_3.5.0,examples/seq2seq/seq2seq_training_args.py,45,27,30,0,0,0,0,0,0,0,0,0,0,0,1,100,0,0
transformers_3.5.0,examples/seq2seq/test_seq2seq_examples_multi_gpu.py,116,60,94,8,23,15,28,31,43,128.041924989311,4.8695652173913,1037.3656274271,57.6314237459498,213.030441346636,12,57.9110781972659,0,0
transformers_3.5.0,examples/seq2seq/download_wmt.py,54,30,29,3,9,5,10,12,15,33.2842125151443,1.66666666666667,89.6240625180289,4.97911458433494,53.7744375108174,7,83.4681210330685,0,0
transformers_3.5.0,examples/seq2seq/save_len_file.py,43,29,33,1,2,1,2,3,3,2,0.5,2.37744375108173,0.13208020839343,4.75488750216347,2,73.4085923522463,0,0
transformers_3.5.0,examples/seq2seq/callbacks.py,115,79,88,5,23,16,31,28,47,115.651565463748,3.3695652173913,761.338708851949,42.2965949362194,225.945681336707,22,55.2950724882326,0,0
transformers_3.5.0,examples/seq2seq/make_student.py,173,88,128,7,18,17,34,25,51,94.7101344803648,6.61111111111111,1565.75351198571,86.9863062214284,236.836665678511,22,62.3834918121495,0,0
transformers_3.5.0,examples/seq2seq/test_datasets.py,223,145,196,13,78,50,95,91,145,538.36708940709,7.91666666666667,7470.40593072809,415.022551707116,943.630222828811,56,41.6678521053426,0,0
transformers_3.5.0,examples/seq2seq/save_randomly_initialized_model.py,26,11,10,1,2,1,2,3,3,2,0.5,2.37744375108173,0.13208020839343,4.75488750216347,2,99.2615118674893,0,0
transformers_3.5.0,examples/seq2seq/distillation.py,281,192,221,13,58,46,75,71,121,387.868614053233,8.4051724137931,6254.45186572039,347.469548095577,744.119401460067,36,43.6929061925176,0,0
transformers_3.5.0,examples/seq2seq/xla_spawn.py,72,23,36,2,6,3,6,8,9,17.5097750043269,1,27,1.5,27,2,88.928740984031,0,0
transformers_3.5.0,examples/seq2seq/run_eval_search.py,138,68,80,5,15,8,16,20,24,70.2129994085646,2.66666666666667,276.603398072791,15.3668554484884,103.726274277297,22,71.606865115315,0,0
transformers_3.5.0,examples/seq2seq/convert_model_to_fp16.py,23,16,15,3,5,3,5,8,8,16.3645279766003,1.5,36,2,24,5,83.4686673406887,0,0
transformers_3.5.0,examples/seq2seq/finetune.py,442,268,377,16,86,58,108,102,166,616.65876890438,10.046511627907,11127.74339822,618.207966567778,1107.62260676727,76,27.2377375062178,0,0
transformers_3.5.0,examples/seq2seq/minify_dataset.py,21,15,13,1,2,1,2,3,3,2,0.5,2.37744375108173,0.13208020839343,4.75488750216347,4,84.9594554657214,0,0
transformers_3.5.0,examples/seq2seq/test_bash_script.py,206,110,154,8,45,28,52,53,80,271.133389334835,4.62222222222222,2118.05769697626,117.669872054237,458.233636365056,31,54.0051031435366,0,0
transformers_3.5.0,examples/seq2seq/test_make_student.py,44,34,34,0,0,0,0,0,0,0,0,0,0,0,7,100,0,0
transformers_3.5.0,examples/seq2seq/test_seq2seq_examples.py,539,294,466,11,69,55,93,80,148,459.541935322704,7.41304347826087,6935.97971940816,385.332206633787,935.64535804333,71,27.9718325086471,0,0
transformers_3.5.0,examples/seq2seq/bertabs/modeling_bertabs.py,1058,559,608,17,161,142,250,178,392,1249.76448567771,13.1987577639752,38678.7947080435,2148.82192822464,2930.48750493883,126,27.3047660763773,0,0
transformers_3.5.0,examples/seq2seq/bertabs/__init__.py,0,0,0,0,0,0,0,0,0,0,0,0,0,0,1,100,0,0
transformers_3.5.0,examples/seq2seq/bertabs/configuration_bertabs.py,97,23,37,0,0,0,0,0,0,0,0,0,0,0,2,100,0,0
transformers_3.5.0,examples/seq2seq/bertabs/utils_summarization.py,167,86,75,10,24,16,27,34,43,143.258380966181,5.625,1230.53007472743,68.3627819293014,218.760902173765,25,66.7815704983386,0,0
transformers_3.5.0,examples/seq2seq/bertabs/test_utils_summarization.py,98,58,62,0,0,0,0,0,0,0,0,0,0,0,12,100,0,0
transformers_3.5.0,examples/seq2seq/bertabs/run_summarization.py,347,136,251,6,27,18,29,33,47,143.891737562741,3.22222222222222,763.945464965064,42.4414147202813,237.086523609847,23,53.9357476070534,0,0
transformers_3.5.0,examples/seq2seq/bertabs/convert_bertabs_original_pytorch_checkpoint.py,185,62,117,3,16,9,18,19,27,68.7548875021635,1.6875,193.546197331273,10.7525665184041,114.694042862977,4,73.315104043426,0,0
transformers_3.5.0,examples/seq2seq/test_data/fsmt/build-eval-data.py,33,20,24,0,0,0,0,0,0,0,0,0,0,0,2,100,0,0
transformers_3.5.0,examples/language-modeling/run_plm.py,376,158,260,13,51,37,68,64,105,337.39940877638,8.66666666666667,5460,303.333333333333,630,40,53.0888349966225,0,0
transformers_3.5.0,examples/language-modeling/run_clm.py,345,147,231,13,48,34,63,61,97,316.18391637045,8.53125,4907.87048237509,272.65947124306,575.2815217436,39,54.8260611745179,0,0
transformers_3.5.0,examples/language-modeling/run_mlm_wwm.py,334,145,227,9,49,31,56,58,87,303.650107374626,5.14285714285714,2621.02806810565,145.612670450314,509.644346576099,41,54.3274246776932,0,0
transformers_3.5.0,examples/language-modeling/run_mlm.py,386,160,264,12,51,37,68,63,105,332.3132424492,8,5020.91513573993,278.939729763329,627.614391967491,41,53.3913651804854,0,0
transformers_3.5.0,examples/lxmert/utils.py,559,367,425,16,111,71,130,127,201,818.180161164862,9.36936936936937,13161.3932155212,731.1885119734,1404.72562204121,94,26.9174600070731,0,0
transformers_3.5.0,examples/lxmert/extracting_data.py,149,101,120,9,28,21,36,37,57,163.135262830594,5.78571428571429,1718.00329922206,95.444627734559,296.93884184085,31,51.958422504243,0,0
transformers_3.5.0,examples/lxmert/modeling_frcnn.py,1922,1048,1339,21,381,301,546,402,847,3358.79824431331,15.0472440944882,110257.79004111,6125.43278006166,7327.44078242855,258,0,0,0
transformers_3.5.0,examples/lxmert/processing_image.py,147,100,100,9,36,28,51,45,79,214.646625064904,6.375,2765.83451563903,153.657473091057,433.856394610044,26,60.4195906638074,0,0
transformers_3.5.0,examples/lxmert/visualizing_image.py,499,171,451,16,105,71,135,121,206,768.995779354943,10.2857142857143,14660.082790751,814.44904393061,1425.28582687857,54,34.3003563606783,0,0
transformers_3.5.0,examples/contrib/run_chinese_ref.py,147,95,106,12,77,52,106,89,158,525.562113642161,8.25974025974026,8451.08442871365,469.504690484092,1023.16588209269,47,53.142017100226,0,0
transformers_3.5.0,examples/contrib/run_swag.py,706,360,510,18,173,143,260,191,403,1361.24933340712,13.5260115606936,41304.433141123,2294.69073006239,3053.70381769841,109,28.1460255132895,0,0
transformers_3.5.0,examples/contrib/run_openai_gpt.py,319,198,230,13,76,50,93,89,143,522.948207357547,7.95394736842105,7365.59293210189,409.199607338994,926.029880628195,34,48.1106071419953,0,0
transformers_3.5.0,examples/contrib/run_transfo_xl.py,144,81,88,10,35,23,45,45,68,212.744186541947,6.42857142857143,2400.7243535384,133.373575196578,373.446010550418,14,66.2181337226675,0,0
transformers_3.5.0,examples/contrib/run_camembert.py,47,27,40,2,6,3,6,8,9,17.5097750043269,1,27,1.5,27,5,73.7975287422288,0,0
transformers_3.5.0,examples/contrib/mm-imdb/run_mmimdb.py,566,300,451,17,130,120,214,147,334,982.394683994955,13.9923076923077,33647.1702647381,1869.28723692989,2404.69056317535,86,29.487624539019,0,0
transformers_3.5.0,examples/contrib/mm-imdb/utils_mmimdb.py,146,71,104,1,2,3,3,3,6,2,0.75,7.1323312532452,0.396240625180289,9.50977500432694,16,72.3447174106491,0,0
transformers_3.5.0,examples/contrib/legacy/run_language_modeling.py,355,142,264,13,40,26,47,53,73,260.982840131329,7.6375,3193.53045043603,177.418358357557,418.138193183114,33,52.1453426593888,0,0
transformers_3.5.0,examples/distillation/utils.py,133,72,78,12,41,42,78,53,120,262.679182197995,11.4146341463415,7845.85396898218,435.880776054565,687.350454547584,15,66.1162866051217,0,0
transformers_3.5.0,examples/distillation/train.py,322,158,249,11,62,52,99,73,151,407.213919048997,8.78225806451613,8208.45613417477,456.025340787487,934.663508390883,40,45.3813463683339,0,0
transformers_3.5.0,examples/distillation/distiller.py,603,362,429,21,182,165,291,203,456,1458.65729039452,16.7884615384615,58682.2739346233,3260.1263297013,3495.39317823644,101,31.4766347474158,0,0
transformers_3.5.0,examples/distillation/grouped_batch_sampler.py,108,61,57,8,22,17,33,30,50,122.107495610021,6,1472.06717868256,81.7815099268086,245.344529780426,14,71.3792163039776,0,0
transformers_3.5.0,examples/distillation/run_squad_w_distillation.py,866,386,688,18,184,165,297,202,462,1459.39404994045,14.5271739130435,51398.5025736345,2855.47236520192,3538.09370503133,126,19.6198786258543,0,0
transformers_3.5.0,examples/distillation/lm_seqs_dataset.py,166,100,91,13,50,32,60,63,92,330.29852582457,7.8,4289.29607310354,238.29422628353,549.909752961992,33,61.9853951624288,0,0
transformers_3.5.0,examples/distillation/scripts/token_counts.py,56,26,33,2,4,2,4,6,6,10,1,15.5097750043269,0.861654166907052,15.5097750043269,4,89.3968683714619,0,0
transformers_3.5.0,examples/distillation/scripts/extract_distilbert.py,92,44,61,2,6,3,6,8,9,17.5097750043269,1,27,1.5,27,9,79.3062688267697,0,0
transformers_3.5.0,examples/distillation/scripts/binarized_data.py,96,62,65,6,16,10,20,22,30,79.5097750043269,3.75,501.686057096696,27.8714476164831,133.782948559119,10,72.2499464344665,0,0
transformers_3.5.0,examples/distillation/scripts/extract.py,102,56,70,2,7,8,16,9,24,21.6514844544032,2.28571428571429,173.89302865055,9.66072381391943,76.0782000346155,20,72.5083336954177,0,0
transformers_3.5.0,examples/benchmarking/plot_csv_file.py,164,99,126,7,14,10,18,21,28,72.9544533632097,4.5,553.431995270124,30.7462219594513,122.984887837805,25,52.191073000325,0,0
transformers_3.5.0,examples/benchmarking/run_benchmark.py,47,26,23,5,12,8,14,17,22,54.6291904830907,2.91666666666667,262.278865646897,14.5710480914943,89.9241825075075,6,83.2393124753182,0,0
transformers_3.5.0,examples/benchmarking/run_benchmark_tf.py,47,27,24,5,12,8,14,17,22,54.6291904830907,2.91666666666667,262.278865646897,14.5710480914943,89.9241825075075,6,83.0909009226682,0,0
transformers_4.13.0,./hubconf.py,161,34,36,0,0,0,0,0,0,0,0,0,0,0,1,100,1,1
transformers_4.13.0,./setup.py,389,74,260,3,54,27,54,57,81,315.518812618991,1.5,708.696136721016,39.372007595612,472.464091147344,10,66.8010814119073,6,1
transformers_4.13.0,src/transformers/generation_flax_logits_process.py,278,118,129,12,52,42,69,64,111,339.442415351991,7.96153846153846,5302.38461538462,294.576923076923,666,31,60.1029884683862,0,0
transformers_4.13.0,src/transformers/feature_extraction_utils.py,493,199,226,9,33,20,36,42,56,194.99433095181,4.90909090909091,1482.39708058936,82.3553933660756,301.969775675611,60,52.2277690919912,0,0
transformers_4.13.0,src/transformers/modeling_flax_outputs.py,593,196,108,0,0,0,0,0,0,0,0,0,0,0,1,100,0,0
transformers_4.13.0,src/transformers/modeling_tf_pytorch_utils.py,448,239,287,13,106,77,143,119,220,761.265284519533,8.7688679245283,13301.1441926306,738.952455146143,1516.85990792775,82,41.2308764465498,1,1
transformers_4.13.0,src/transformers/activations_tf.py,94,38,44,5,38,22,44,43,66,211.030885985293,2.89473684210526,1036.70216102993,57.5945645016626,358.133473810338,3,76.4843679927853,0,0
transformers_4.13.0,src/transformers/optimization_tf.py,351,133,198,12,43,27,51,55,78,276.348934460844,7.11627906976744,3209.05799168387,178.280999537993,450.946057654924,47,57.9345678203759,0,0
transformers_4.13.0,src/transformers/convert_tf_hub_seq_to_seq_bert_to_pytorch.py,88,26,58,1,2,1,2,3,3,2,0.5,2.37744375108173,0.13208020839343,4.75488750216347,3,90.7293933592469,0,0
transformers_4.13.0,src/transformers/debug_utils.py,336,130,132,9,24,16,31,33,47,138.568425030289,5.8125,1378.06541848224,76.5591899156799,237.086523609847,46,57.9462827282061,0,0
transformers_4.13.0,src/transformers/tokenization_utils.py,943,392,542,18,175,112,229,193,341,1379.02059459662,11.7771428571429,30491.3508471374,1693.96393595208,2589.02784970842,148,28.7405683428436,0,0
transformers_4.13.0,src/transformers/convert_pytorch_checkpoint_to_tf2.py,487,95,426,11,39,31,56,50,87,244.184434340638,7.8974358974359,3877.76334515907,215.431296953281,491.015488510401,26,49.3304787195309,0,0
transformers_4.13.0,src/transformers/modeling_flax_utils.py,673,229,329,12,51,34,66,63,100,332.3132424492,7.76470588235294,4641.18205824699,257.843447680389,597.727992349992,61,49.5182933045386,4,1
transformers_4.13.0,src/transformers/configuration_utils.py,868,302,348,11,82,48,93,93,141,559.373012183693,6.23780487804878,5751.38953896741,319.521641053745,922.021392366232,91,36.9383912744475,2,1
transformers_4.13.0,src/transformers/optimization.py,650,245,281,18,131,113,208,149,321,996.437063227368,14.2900763358779,33115.1526257096,1839.73070142831,2317.35309506835,56,43.7294091010753,1,1
transformers_4.13.0,src/transformers/trainer_pt_utils.py,1054,530,558,21,250,191,361,271,552,2083.68473704388,15.162,67642.9321582841,3757.94067546023,4461.34627082734,185,19.3291246176209,3,1
transformers_4.13.0,src/transformers/modeling_utils.py,2361,1039,1210,20,329,301,515,349,816,2837.51806345664,15.6534954407295,107896.725075451,5994.26250419173,6892.81991258708,316,0,4,1
transformers_4.13.0,src/transformers/dependency_versions_table.py,78,2,75,0,0,0,0,0,0,0,0,0,0,0,1,100,5,1
transformers_4.13.0,src/transformers/dependency_versions_check.py,47,19,19,4,7,5,9,11,14,27.6514844544032,2.57142857142857,124.539538270943,6.9188632372746,48.4320426609222,7,84.2136442035513,1,1
transformers_4.13.0,src/transformers/trainer_utils.py,532,274,286,11,83,54,104,94,158,567.182020606805,6.89156626506024,7137.07857902673,396.504365501485,1035.62503856507,70,44.7743414102305,2,1
transformers_4.13.0,src/transformers/__init__.py,3807,714,3670,2,34,24,34,36,58,174.973736602512,1,299.855650083654,16.6586472268697,299.855650083654,63,19.8338725681617,6,1
transformers_4.13.0,src/transformers/file_utils.py,2521,1098,1657,19,397,265,497,416,762,3508.00971602118,11.8929471032746,78847.0884394278,4380.39380219043,6629.73506522351,271,0,6,1
transformers_4.13.0,src/transformers/trainer.py,2879,1471,1879,20,590,474,884,610,1358,5517.13553700478,14.9830508474576,188263.826729227,10459.1014849571,12565.1196572674,597,0,13,1
transformers_4.13.0,src/transformers/modeling_flax_pytorch_utils.py,289,150,177,10,110,85,151,120,236,779.168849436586,6.86363636363636,11187.9069665957,621.550387033094,1630.02618056361,50,49.0889383467679,1,1
transformers_4.13.0,src/transformers/modeling_tf_utils.py,1955,830,1010,16,274,206,378,290,584,2282.86079073118,11.036496350365,52722.0815018679,2929.00452788155,4777.06690856872,255,5.46860963555011,5,1
transformers_4.13.0,src/transformers/modelcard.py,759,454,536,16,214,154,307,230,461,1720.67393508985,11.4766355140187,41508.3615117759,2306.02008398755,3616.77091348536,156,17.71796379451,1,1
transformers_4.13.0,src/transformers/keras_callbacks.py,113,60,74,11,45,28,51,56,79,285.187137139846,6.23333333333333,2859.73514211857,158.874174562143,458.781038842551,28,66.7751616621657,0,0
transformers_4.13.0,src/transformers/generation_beam_search.py,399,153,271,19,76,56,105,95,161,555.553113777141,13.125,13882.9261323543,771.273674019685,1057.74675294128,48,50.7332098478019,0,0
transformers_4.13.0,src/transformers/convert_slow_tokenizers_checkpoints_to_fast.py,124,62,78,9,17,13,24,26,37,98.0161933142366,6.35294117647059,1104.87983021717,61.3822127898425,173.91626957122,15,67.7277898575305,0,0
transformers_4.13.0,src/transformers/modeling_tf_outputs.py,790,274,149,0,0,0,0,0,0,0,0,0,0,0,1,100,0,0
transformers_4.13.0,src/transformers/hf_argparser.py,244,140,146,10,59,43,84,69,127,380.295220861222,7.11864406779661,5522.52024617877,306.806680343265,775.782606010828,68,52.9367496156173,0,0
transformers_4.13.0,src/transformers/deepspeed.py,452,209,218,13,67,43,82,80,125,454.533692096505,7.95522388059702,6286.54416898314,349.252453832397,790.24101186092,54,50.9412562701232,2,1
transformers_4.13.0,src/transformers/integrations.py,892,529,605,12,166,116,209,178,325,1267.27609561224,7.55421686746988,18353.8262637973,1019.65701465541,2429.61336506408,189,15.960397945652,3,1
transformers_4.13.0,src/transformers/generation_utils.py,2599,816,1335,20,358,392,734,378,1126,3123.64461015835,20.5027932960894,197669.172283238,10981.6206824021,9641.08496967293,375,0,2,1
transformers_4.13.0,src/transformers/training_args.py,1289,548,737,15,170,128,238,185,366,1318.19981807754,10.5,28943.0989527642,1607.94994182023,2756.48561454897,164,23.3472152507993,4,1
transformers_4.13.0,src/transformers/feature_extraction_sequence_utils.py,366,132,193,15,82,56,110,97,166,579.922623312811,10.0609756097561,11022.6593138723,612.369961881793,1095.58553180306,66,52.7943737564356,0,0
transformers_4.13.0,src/transformers/image_utils.py,261,129,127,14,76,54,96,90,150,528.145459930519,8.8421052631579,8610.24726460568,478.347070255871,973.777964449451,48,55.3789645930395,0,0
transformers_4.13.0,src/transformers/generation_flax_utils.py,826,348,484,21,167,139,249,188,388,1325.31728272152,15.6556886227545,45889.6488051014,2549.42493361675,2931.18047445092,76,38.6010785656101,0,0
transformers_4.13.0,src/transformers/activations.py,114,43,51,5,47,27,54,52,81,272.675316503286,2.87234042553191,1326.26187910368,73.6812155057599,461.735617169429,5,74.0647508734293,0,0
transformers_4.13.0,src/transformers/training_args_tf.py,295,91,103,4,13,7,14,17,21,56.1057163358342,2.15384615384615,184.879088511938,10.2710604728855,85.8367196662571,23,57.135670238521,0,0
transformers_4.13.0,src/transformers/testing_utils.py,1473,714,714,16,116,90,131,132,221,859.525795434798,9.03448275862069,14064.9830447963,781.387946933129,1556.81110037822,159,23.2399167322273,0,0
transformers_4.13.0,src/transformers/generation_stopping_criteria.py,133,58,74,9,17,13,24,26,37,98.0161933142366,6.35294117647059,1104.87983021717,61.3822127898425,173.91626957122,18,71.1876828992577,2,1
transformers_4.13.0,src/transformers/convert_slow_tokenizer.py,982,425,769,12,53,44,78,65,122,346.599334100503,8.83018867924528,6487.79457835231,360.433032130684,734.728873189471,99,22.8923327086549,2,1
transformers_4.13.0,src/transformers/generation_tf_utils.py,1677,662,960,20,319,315,584,339,899,2739.69318568874,18.307210031348,138333.346407837,7685.18591154648,7556.22217535957,256,6.08228207128029,1,1
transformers_4.13.0,src/transformers/trainer_callback.py,561,283,272,13,79,48,95,92,143,546.104395441825,7.81645569620253,7291.73202056613,405.096223364785,932.869359716153,104,40.7484845265586,0,0
transformers_4.13.0,src/transformers/convert_graph_to_onnx.py,505,194,267,9,38,23,39,47,62,227.950570523837,4.61842105263158,1590.51266566064,88.3618147589245,344.384508804014,33,56.8375492633761,0,0
transformers_4.13.0,src/transformers/trainer_seq2seq.py,216,69,95,8,30,22,40,38,62,171.206717868256,5.33333333333333,1735.31469777868,96.4063720988155,325.371505833502,28,65.3212622660149,1,1
transformers_4.13.0,src/transformers/trainer_tf.py,799,377,445,18,135,110,214,153,324,1030.42875562782,14.2666666666667,33546.5495640625,1863.69719800347,2351.39366103242,120,32.362625338614,0,0
transformers_4.13.0,src/transformers/training_args_seq2seq.py,63,18,27,0,0,0,0,0,0,0,0,0,0,0,1,100,1,1
transformers_4.13.0,src/transformers/generation_logits_process.py,622,303,326,17,146,127,211,163,338,1119.20125389774,12.2842465753425,30512.4729676667,1695.1373870926,2483.8701161301,109,36.5267219985909,0,0
transformers_4.13.0,src/transformers/tokenization_utils_fast.py,732,304,474,12,132,98,197,144,295,972.87957376397,8.95454545454546,18940.0087026736,1052.22270570409,2115.12787542548,131,32.107377992962,2,1
transformers_4.13.0,src/transformers/tokenization_utils_base.py,3503,1200,1959,18,485,340,646,503,986,4402.15150450709,11.9876288659794,106075.804072531,5893.10022625172,8848.77278554825,446,0,4,1
transformers_4.13.0,src/transformers/modeling_outputs.py,814,278,151,0,0,0,0,0,0,0,0,0,0,0,1,100,0,0
transformers_4.13.0,src/transformers/models/__init__.py,115,1,97,0,0,0,0,0,0,0,0,0,0,0,1,100,0,0
transformers_4.13.0,src/transformers/models/fnet/modeling_fnet.py,1201,554,816,13,92,131,223,105,354,648.273416293079,15.7554347826087,37448.193508276,2080.45519490422,2376.84291325381,147,20.1629125510817,0,0
transformers_4.13.0,src/transformers/models/fnet/configuration_fnet.py,123,23,42,0,0,0,0,0,0,0,0,0,0,0,2,100,0,0
transformers_4.13.0,src/transformers/models/fnet/tokenization_fnet.py,309,120,151,10,70,46,85,80,131,462.269092135021,6.07142857142857,5028.19066689791,279.343925938773,828.172580430244,38,58.0855494978541,0,0
transformers_4.13.0,src/transformers/models/fnet/tokenization_fnet_fast.py,205,57,97,5,32,22,42,37,64,171.609640474437,3.28125,1093.98520678208,60.7769559323378,333.405015400253,13,70.4213070525056,0,0
transformers_4.13.0,src/transformers/models/fnet/convert_fnet_original_flax_checkpoint_to_pytorch.py,155,54,107,1,2,1,2,3,3,2,0.5,2.37744375108173,0.13208020839343,4.75488750216347,3,81.6940695977546,0,0
transformers_4.13.0,src/transformers/models/fnet/__init__.py,73,18,44,0,0,0,0,0,0,0,0,0,0,0,6,100,0,0
transformers_4.13.0,src/transformers/models/gpt_neo/configuration_gpt_neo.py,281,128,159,8,18,11,21,26,32,99.0586500259616,4.66666666666667,701.932331242403,38.996240624578,150.414070980515,20,64.9771339078045,0,0
transformers_4.13.0,src/transformers/models/gpt_neo/__init__.py,65,17,36,0,0,0,0,0,0,0,0,0,0,0,6,100,0,0
transformers_4.13.0,src/transformers/models/gpt_neo/modeling_flax_gpt_neo.py,680,315,512,15,88,63,112,103,175,627.03334137421,9.54545454545455,11169.4951988174,620.527511045412,1170.13759225706,60,33.5857663278804,0,0
transformers_4.13.0,src/transformers/models/gpt_neo/modeling_gpt_neo.py,931,454,704,16,145,154,262,161,416,1105.08681805217,14.4551724137931,44083.3816485224,2449.07675825124,3049.66142129568,123,20.6539327489223,0,0
transformers_4.13.0,src/transformers/models/gpt_neo/convert_gpt_neo_mesh_tf_to_pytorch.py,70,21,40,1,2,1,2,3,3,2,0.5,2.37744375108173,0.13208020839343,4.75488750216347,2,94.9099480116508,0,0
transformers_4.13.0,src/transformers/models/mbart50/__init__.py,42,15,15,0,0,0,0,0,0,0,0,0,0,0,6,100,0,0
transformers_4.13.0,src/transformers/models/mbart50/tokenization_mbart50_fast.py,278,102,152,7,44,30,57,51,87,259.866475674444,4.53409090909091,2237.5784192711,124.309912181728,493.50100475152,25,63.0685680619522,0,0
transformers_4.13.0,src/transformers/models/mbart50/tokenization_mbart50.py,351,143,174,10,68,40,78,78,118,447.166754153897,5.73529411764706,4253.7383840006,236.318799111144,741.677461825745,41,56.5414430509626,0,0
transformers_4.13.0,src/transformers/models/roberta/configuration_roberta.py,82,24,30,0,0,0,0,0,0,0,0,0,0,0,4,100,0,0
transformers_4.13.0,src/transformers/models/roberta/convert_roberta_original_pytorch_checkpoint_to_pytorch.py,178,101,124,4,9,10,17,13,27,36.5293250129808,3.77777777777778,377.444851250391,20.9691584027995,99.9118723898095,14,66.0276282077029,0,0
transformers_4.13.0,src/transformers/models/roberta/__init__.py,119,26,86,0,0,0,0,0,0,0,0,0,0,0,10,100,0,0
transformers_4.13.0,src/transformers/models/roberta/tokenization_roberta.py,253,53,107,7,57,34,67,64,101,352.126215261793,4.1140350877193,2493.10526315789,138.505847953216,606,21,65.721548544887,0,0
transformers_4.13.0,src/transformers/models/roberta/tokenization_roberta_fast.py,230,46,101,4,29,18,36,33,54,148.8814488587,2.48275862068966,676.296701243644,37.5720389579802,272.397282445356,11,71.6675444549282,0,0
transformers_4.13.0,src/transformers/models/roberta/modeling_tf_roberta.py,1837,642,1365,12,148,154,265,160,419,1110.01864812174,10.7432432432432,32959.0656492899,1831.05920273833,3067.8878717578,179,11.7668304674208,1,1
transformers_4.13.0,src/transformers/models/roberta/modeling_roberta.py,1581,678,1120,15,176,217,374,191,591,1371.46332381429,15.9375,71372.2757205705,3965.12642892058,4478.26043736913,195,9.6432845341785,2,1
transformers_4.13.0,src/transformers/models/roberta/modeling_flax_roberta.py,1023,428,776,12,78,80,132,90,212,533.280923079909,10.1538461538462,13974.4628498223,776.359047212349,1376.27285642189,84,26.5762082601234,1,1
transformers_4.13.0,src/transformers/models/albert/tokenization_albert.py,343,119,166,10,70,46,85,80,131,462.269092135021,6.07142857142857,5028.19066689791,279.343925938773,828.172580430244,38,58.1388554829296,0,0
transformers_4.13.0,src/transformers/models/albert/modeling_tf_albert.py,1564,520,1189,10,111,112,189,121,301,787.399442113735,8.51351351351351,17730.0545362754,985.003029793079,2082.57783441965,133,19.2029808386747,1,1
transformers_4.13.0,src/transformers/models/albert/convert_albert_original_tf_checkpoint_to_pytorch.py,61,20,30,1,2,1,2,3,3,2,0.5,2.37744375108173,0.13208020839343,4.75488750216347,2,95.8316665485003,0,0
transformers_4.13.0,src/transformers/models/albert/modeling_albert.py,1368,630,989,17,199,213,378,216,591,1589.17516778944,16.1457286432161,73998.1107777421,4111.00615431901,4583.13851377861,170,11.6051791003072,1,1
transformers_4.13.0,src/transformers/models/albert/__init__.py,132,29,99,0,0,0,0,0,0,0,0,0,0,0,12,100,0,0
transformers_4.13.0,src/transformers/models/albert/modeling_flax_albert.py,1120,443,869,12,83,83,136,95,219,572.147822810449,9.83132530120482,14145.2948991708,785.849716620598,1438.79837822448,86,24.2892228094785,0,0
transformers_4.13.0,src/transformers/models/albert/configuration_albert.py,173,38,71,0,0,0,0,0,0,0,0,0,0,0,4,100,0,0
transformers_4.13.0,src/transformers/models/albert/tokenization_albert_fast.py,241,58,123,5,33,23,43,38,66,178.074646413266,3.25757575757576,1128.30441539037,62.6835786327984,346.363215887277,14,70.8150664839239,0,0
transformers_4.13.0,src/transformers/models/vit/modeling_tf_vit.py,860,312,567,15,81,59,107,96,166,572.131209167782,9.90740740740741,10829.824438686,601.656913260335,1093.10377511971,76,38.1316280929357,0,0
transformers_4.13.0,src/transformers/models/vit/__init__.py,76,25,44,0,0,0,0,0,0,0,0,0,0,0,10,100,0,0
transformers_4.13.0,src/transformers/models/vit/feature_extraction_vit.py,148,41,60,5,20,11,21,25,32,98.0482023721841,2.625,390.083919941077,21.6713288856154,148.603398072791,20,72.317067380973,0,0
transformers_4.13.0,src/transformers/models/vit/convert_vit_timm_to_pytorch.py,250,161,182,4,17,20,29,21,49,77.4868683012558,3.41176470588235,734.292124443367,40.7940069135204,215.223553716159,28,54.8203280607518,0,0
transformers_4.13.0,src/transformers/models/vit/modeling_flax_vit.py,622,278,465,12,55,40,73,67,113,360.99433425251,7.96363636363636,5458.81851622758,303.267695345977,685.468078521728,58,34.7681386709653,0,0
transformers_4.13.0,src/transformers/models/vit/convert_dino_to_pytorch.py,219,124,150,5,11,10,16,16,26,49.6633882794471,3.63636363636364,378.181818181818,21.010101010101,104,21,62.2265837826217,0,0
transformers_4.13.0,src/transformers/models/vit/configuration_vit.py,118,24,41,0,0,0,0,0,0,0,0,0,0,0,2,100,0,0
transformers_4.13.0,src/transformers/models/vit/modeling_vit.py,683,322,420,15,98,81,142,113,223,706.844923657418,10.8673469387755,16528.1469661102,918.23038700612,1520.89990861859,80,38.098993118207,0,0
transformers_4.13.0,src/transformers/models/trocr/configuration_trocr.py,150,31,64,0,0,0,0,0,0,0,0,0,0,0,2,100,0,0
transformers_4.13.0,src/transformers/models/trocr/__init__.py,50,14,23,0,0,0,0,0,0,0,0,0,0,0,4,100,0,0
transformers_4.13.0,src/transformers/models/trocr/processing_trocr.py,141,41,37,2,4,3,4,6,7,10,1,18.0947375050481,1.00526319472489,18.0947375050481,11,56.7470627750721,0,0
transformers_4.13.0,src/transformers/models/trocr/modeling_trocr.py,971,389,562,17,146,143,256,163,399,1119.20125389774,14.9041095890411,43700.9736505419,2427.83186947455,2932.1425335382,123,31.1263680399128,0,0
transformers_4.13.0,src/transformers/models/qdqbert/__init__.py,67,13,40,0,0,0,0,0,0,0,0,0,0,0,4,100,0,0
transformers_4.13.0,src/transformers/models/qdqbert/modeling_qdqbert.py,1750,783,1254,16,194,230,397,210,627,1538.3830913843,16.3711340206186,79184.4239180179,4399.1346621121,4836.83193957666,220,4.01536701386894,0,0
transformers_4.13.0,src/transformers/models/qdqbert/configuration_qdqbert.py,122,24,44,0,0,0,0,0,0,0,0,0,0,0,2,100,0,0
transformers_4.13.0,src/transformers/models/phobert/tokenization_phobert.py,356,166,191,12,85,58,109,97,167,587.817779580359,7.69411764705882,8480.3444799764,471.130248887578,1102.18544464525,44,53.4991580906393,0,0
transformers_4.13.0,src/transformers/models/phobert/__init__.py,35,9,10,0,0,0,0,0,0,0,0,0,0,0,2,100,0,0
transformers_4.13.0,src/transformers/models/bort/convert_bort_original_gluonnlp_checkpoint_to_pytorch.py,319,105,207,3,10,5,10,13,15,37.9741684510371,1.5,83.2598936581746,4.62554964767637,55.5065957721164,6,69.6035940930104,0,0
transformers_4.13.0,src/transformers/models/segformer/modeling_segformer.py,778,371,499,14,101,93,163,115,256,725.782328666738,11.2970297029703,19797.428335848,1099.85712976933,1752.44545304176,89,34.7422748968243,0,0
transformers_4.13.0,src/transformers/models/segformer/__init__.py,63,17,34,0,0,0,0,0,0,0,0,0,0,0,6,100,0,0
transformers_4.13.0,src/transformers/models/segformer/configuration_segformer.py,150,32,57,0,0,0,0,0,0,0,0,0,0,0,2,100,0,0
transformers_4.13.0,src/transformers/models/segformer/convert_segformer_original_to_pytorch.py,388,201,314,7,450,440,492,457,932,3985.85302050207,3.82666666666667,31513.361242298,1750.74229123878,8235.19893091412,56,34.5148431800765,0,0
transformers_4.13.0,src/transformers/models/segformer/feature_extraction_segformer.py,211,71,104,6,33,25,47,39,72,181.974780943156,4.27272727272727,1625.98191896635,90.3323288314639,380.548959758082,38,65.2791759656716,0,0
transformers_4.13.0,src/transformers/models/ibert/__init__.py,58,13,32,0,0,0,0,0,0,0,0,0,0,0,4,100,0,0
transformers_4.13.0,src/transformers/models/ibert/quant_modules.py,826,402,467,16,240,212,387,256,599,1961.65374294604,12.9,61816.8,3434.26666666667,4792,71,36.6136818386495,0,0
transformers_4.13.0,src/transformers/models/ibert/modeling_ibert.py,1384,574,1048,14,117,148,254,131,402,857.135641100065,15.1965811965812,42967.3614605718,2387.07563669843,2827.43604661806,133,17.317097523212,0,0
transformers_4.13.0,src/transformers/models/ibert/configuration_ibert.py,125,26,48,0,0,0,0,0,0,0,0,0,0,0,2,100,0,0
transformers_4.13.0,src/transformers/models/reformer/modeling_reformer.py,2598,1107,1771,20,446,498,831,466,1329,4011.6399172622,18.6322869955157,219497.720044171,12194.3177802317,11780.5033862455,298,0,0,0
transformers_4.13.0,src/transformers/models/reformer/__init__.py,73,21,42,0,0,0,0,0,0,0,0,0,0,0,8,100,0,0
transformers_4.13.0,src/transformers/models/reformer/convert_reformer_trax_checkpoint_to_pytorch.py,220,91,152,6,18,19,31,24,50,90.5684250302886,5.16666666666667,1184.44864601963,65.8027025566462,229.248125036058,12,62.6641226394524,0,0
transformers_4.13.0,src/transformers/models/reformer/tokenization_reformer.py,169,68,80,5,12,7,12,17,19,54.6291904830907,2.5,194.154484959391,10.7863602755217,77.6617939837565,18,73.6047353830525,0,0
transformers_4.13.0,src/transformers/models/reformer/configuration_reformer.py,236,43,85,0,0,0,0,0,0,0,0,0,0,0,3,100,0,0
transformers_4.13.0,src/transformers/models/reformer/tokenization_reformer_fast.py,126,40,64,3,9,6,9,12,15,33.2842125151443,1.5,80.661656266226,4.48120312590145,53.7744375108174,9,80.9603501927975,0,0
transformers_4.13.0,src/transformers/models/imagegpt/feature_extraction_imagegpt.py,176,61,67,10,29,17,30,39,47,174.100729807573,5.17241379310345,1284.89950493031,71.3833058294614,248.413904286526,19,66.2308919119852,0,0
transformers_4.13.0,src/transformers/models/imagegpt/__init__.py,61,17,32,0,0,0,0,0,0,0,0,0,0,0,6,100,0,0
transformers_4.13.0,src/transformers/models/imagegpt/configuration_imagegpt.py,142,31,56,0,0,0,0,0,0,0,0,0,0,0,2,100,0,0
transformers_4.13.0,src/transformers/models/imagegpt/convert_imagegpt_original_tf2_to_pytorch.py,73,28,42,2,8,5,10,10,15,26,1.25,62.2861517791381,3.46034176550767,49.8289214233104,2,85.0592111265792,0,0
transformers_4.13.0,src/transformers/models/imagegpt/modeling_imagegpt.py,1159,561,799,19,252,244,421,271,665,2090.98516347741,15.8710317460317,85300.9092676391,4738.93940375773,5374.62911250033,177,14.2679533626653,0,0
transformers_4.13.0,src/transformers/models/flaubert/__init__.py,85,18,56,0,0,0,0,0,0,0,0,0,0,0,6,100,0,0
transformers_4.13.0,src/transformers/models/flaubert/modeling_flaubert.py,450,168,297,13,56,56,101,69,157,373.31759197106,11.7232142857143,11243.0119646849,624.611775815828,959.038339714173,47,50.1647609771232,0,0
transformers_4.13.0,src/transformers/models/flaubert/modeling_tf_flaubert.py,952,383,687,16,116,92,170,132,262,859.525795434798,11.7241379310345,21638.4354535328,1202.13530297404,1845.63125927192,95,30.6760595829666,0,0
transformers_4.13.0,src/transformers/models/flaubert/tokenization_flaubert.py,148,57,77,2,3,2,5,5,7,6.75488750216347,1.66666666666667,27.0891611070192,1.5049533948344,16.2534966642115,12,80.7090710041987,0,0
transformers_4.13.0,src/transformers/models/flaubert/configuration_flaubert.py,141,14,15,0,0,0,0,0,0,0,0,0,0,0,2,100,0,0
transformers_4.13.0,src/transformers/models/speech_encoder_decoder/convert_mbart_wav2vec2_seq2seq_original_to_pytorch.py,353,177,285,9,58,60,114,67,174,368.29222273038,8.8448275862069,9335.71126411451,518.65062578414,1055.49951913965,53,39.2051571008753,0,0
transformers_4.13.0,src/transformers/models/speech_encoder_decoder/modeling_speech_encoder_decoder.py,576,171,374,11,75,65,123,86,188,505.215149592201,9.02,10897.4027204336,605.411262246313,1208.13777388399,69,46.4586437586482,0,0
transformers_4.13.0,src/transformers/models/speech_encoder_decoder/__init__.py,40,13,14,0,0,0,0,0,0,0,0,0,0,0,4,100,0,0
transformers_4.13.0,src/transformers/models/speech_encoder_decoder/configuration_speech_encoder_decoder.py,119,34,35,2,5,3,6,7,9,13.6096404744368,1.2,30.3194331582221,1.68441295323456,25.2661942985184,6,68.7174739876337,0,0
transformers_4.13.0,src/transformers/models/speech_encoder_decoder/convert_speech_to_text_wav2vec2_seq2seq_original_to_pytorch.py,312,154,240,8,53,46,87,61,133,327.57978409185,6.56603773584906,5179.21220625964,287.734011458869,788.788065895864,38,44.0496906558513,0,0
transformers_4.13.0,src/transformers/models/deberta/modeling_deberta.py,1425,749,1029,19,224,264,441,243,705,1829.55812529633,18.703125,104494.224993834,5805.23472187966,5586.99281504208,208,3.43108182593282,1,1
transformers_4.13.0,src/transformers/models/deberta/__init__.py,88,22,56,0,0,0,0,0,0,0,0,0,0,0,8,100,1,1
transformers_4.13.0,src/transformers/models/deberta/tokenization_deberta_fast.py,207,50,100,4,28,18,36,32,54,142.605937817613,2.57142857142857,694.285714285714,38.5714285714286,270,11,72.6976727877009,1,1
transformers_4.13.0,src/transformers/models/deberta/tokenization_deberta.py,220,55,108,7,55,32,63,62,95,337.626268698259,4.00909090909091,2267.73685839689,125.98538102205,565.648649486753,21,68.5195273060279,0,0
transformers_4.13.0,src/transformers/models/deberta/configuration_deberta.py,142,33,59,1,2,1,2,3,3,2,0.5,2.37744375108173,0.13208020839343,4.75488750216347,4,84.514372888151,0,0
transformers_4.13.0,src/transformers/models/deberta/modeling_tf_deberta.py,1555,653,1167,17,214,205,352,231,557,1726.1608033911,13.981308411215,61146.1927779331,3397.01070988517,4373.42421606874,174,7.72897168477595,0,0
transformers_4.13.0,src/transformers/models/longformer/convert_longformer_original_pytorch_lightning_to_pytorch.py,87,32,49,1,2,1,2,3,3,2,0.5,2.37744375108173,0.13208020839343,4.75488750216347,4,90.2397471354111,0,0
transformers_4.13.0,src/transformers/models/longformer/tokenization_longformer.py,60,14,31,0,0,0,0,0,0,0,0,0,0,0,1,100,0,0
transformers_4.13.0,src/transformers/models/longformer/__init__.py,103,22,72,0,0,0,0,0,0,0,0,0,0,0,8,100,0,0
transformers_4.13.0,src/transformers/models/longformer/modeling_longformer.py,2273,852,1365,16,251,308,539,267,847,2064.85743204164,17.1792828685259,117289.998271908,6516.111015106,6827.40945413936,191,11.7836415303214,1,1
transformers_4.13.0,src/transformers/models/longformer/tokenization_longformer_fast.py,70,16,40,0,0,0,0,0,0,0,0,0,0,0,1,100,0,0
transformers_4.13.0,src/transformers/models/longformer/configuration_longformer.py,87,24,30,0,0,0,0,0,0,0,0,0,0,0,4,100,0,0
transformers_4.13.0,src/transformers/models/longformer/modeling_tf_longformer.py,2728,873,1853,15,248,260,465,263,725,2031.24404391007,14.0625,81959.2912580192,4553.29395877884,5828.21626723692,179,10.8324241986217,1,1
transformers_4.13.0,src/transformers/models/mluke/__init__.py,38,11,11,0,0,0,0,0,0,0,0,0,0,0,4,100,0,0
transformers_4.13.0,src/transformers/models/mluke/convert_mluke_original_pytorch_checkpoint_to_pytorch.py,228,132,158,7,42,35,61,49,96,246.128816211111,5.08333333333333,2739.97840392822,152.221022440457,539.01214503506,26,54.6010628505188,0,0
transformers_4.13.0,src/transformers/models/mluke/tokenization_mluke.py,1606,523,1089,18,427,291,573,445,864,3806.22404488391,12.0772833723653,91801.5994902746,5100.08886057081,7601.17955833765,219,10.2468527119218,0,0
transformers_4.13.0,src/transformers/models/retribert/modeling_retribert.py,217,84,131,7,21,16,32,28,48,111.890150332757,5.33333333333333,1230.68286004675,68.371270002597,230.753036258765,17,67.589125193455,0,0
transformers_4.13.0,src/transformers/models/retribert/__init__.py,57,18,28,0,0,0,0,0,0,0,0,0,0,0,6,100,0,0
transformers_4.13.0,src/transformers/models/retribert/configuration_retribert.py,107,25,42,0,0,0,0,0,0,0,0,0,0,0,2,100,0,0
transformers_4.13.0,src/transformers/models/retribert/tokenization_retribert_fast.py,61,21,26,0,0,0,0,0,0,0,0,0,0,0,1,100,0,0
transformers_4.13.0,src/transformers/models/retribert/tokenization_retribert.py,56,19,21,0,0,0,0,0,0,0,0,0,0,0,1,100,0,0
transformers_4.13.0,src/transformers/models/barthez/tokenization_barthez.py,287,96,124,7,62,37,72,69,109,388.81165569839,4.06451612903226,2706.27338352875,150.348521307153,665.829165788821,29,60.8655863597608,0,0
transformers_4.13.0,src/transformers/models/barthez/__init__.py,44,15,15,0,0,0,0,0,0,0,0,0,0,0,6,100,0,0
transformers_4.13.0,src/transformers/models/barthez/tokenization_barthez_fast.py,207,56,96,5,35,24,45,40,69,191.134546067511,3.21428571428571,1180.3276239018,65.5737568834336,367.213038547228,14,70.2743587352702,0,0
transformers_4.13.0,src/transformers/models/t5/modeling_t5.py,1818,826,1341,19,303,285,530,322,815,2578.39233974773,16.6171617161716,112825.497301206,6268.08318340031,6789.69725566341,265,0,3,1
transformers_4.13.0,src/transformers/models/t5/modeling_tf_t5.py,1689,617,1249,15,229,199,365,244,564,1853.78102640833,11.9541484716157,53470.1393551538,2970.56329750854,4472.93585838547,175,12.3752014995159,2,1
transformers_4.13.0,src/transformers/models/t5/__init__.py,103,29,67,0,0,0,0,0,0,0,0,0,0,0,12,100,1,1
transformers_4.13.0,src/transformers/models/t5/configuration_t5.py,225,98,140,5,11,7,13,16,20,49.6633882794471,2.95454545454545,236.363636363636,13.1313131313131,80,19,69.0229647445574,0,0
transformers_4.13.0,src/transformers/models/t5/modeling_flax_t5.py,1655,617,1218,15,195,174,317,210,491,1542.0327701153,12.1923076923077,46180.7373880069,2565.59652155594,3787.69454917407,139,16.0106456710108,0,0
transformers_4.13.0,src/transformers/models/t5/tokenization_t5_fast.py,209,64,107,9,37,27,51,46,78,221.279099541252,6.2027027027027,2672.35898852369,148.464388251316,430.837832572447,19,68.7427860244787,0,0
transformers_4.13.0,src/transformers/models/t5/convert_t5_original_tf_checkpoint_to_pytorch.py,59,19,29,1,2,1,2,3,3,2,0.5,2.37744375108173,0.13208020839343,4.75488750216347,2,96.2791507216953,0,0
transformers_4.13.0,src/transformers/models/t5/tokenization_t5.py,306,120,152,13,77,47,91,90,138,530.648279969342,7.68181818181818,6881.95445057276,382.330802809598,895.875727293495,37,58.1320189093519,0,0
transformers_4.13.0,src/transformers/models/blenderbot/configuration_blenderbot.py,166,34,71,0,0,0,0,0,0,0,0,0,0,0,2,100,0,0
transformers_4.13.0,src/transformers/models/blenderbot/__init__.py,91,26,56,0,0,0,0,0,0,0,0,0,0,0,10,100,0,0
transformers_4.13.0,src/transformers/models/blenderbot/convert_blenderbot_original_pytorch_checkpoint_to_pytorch.py,114,60,76,3,10,5,10,13,15,37.9741684510371,1.5,83.2598936581746,4.62554964767637,55.5065957721164,12,72.5411890301915,0,0
transformers_4.13.0,src/transformers/models/blenderbot/modeling_flax_blenderbot.py,1497,590,1138,14,138,139,249,152,388,1034.27934394419,12.6304347826087,35519.2565978383,1973.29203321324,2812.19587521611,138,15.9273491558641,0,0
transformers_4.13.0,src/transformers/models/blenderbot/modeling_blenderbot.py,1596,575,1014,16,158,187,335,174,522,1217.99735821198,16.9620253164557,65901.1407148895,3661.17448416053,3885.21650483304,188,16.2349102082561,0,0
transformers_4.13.0,src/transformers/models/blenderbot/tokenization_blenderbot.py,110,44,46,3,6,4,7,9,11,20.2646625064904,1.75,61.0210562777645,3.39005868209803,34.8691750158654,8,79.624239971634,0,0
transformers_4.13.0,src/transformers/models/blenderbot/tokenization_blenderbot_fast.py,96,37,40,3,6,4,7,9,11,20.2646625064904,1.75,61.0210562777645,3.39005868209803,34.8691750158654,7,81.038351854687,0,0
transformers_4.13.0,src/transformers/models/blenderbot/modeling_tf_blenderbot.py,1536,509,1083,14,162,145,257,176,402,1242.35866937612,11.1049382716049,33300.2841218226,1850.0157845457,2998.69151069219,158,19.4330330264249,0,0
transformers_4.13.0,src/transformers/models/dpr/modeling_tf_dpr.py,871,247,598,8,46,41,72,54,113,278.083849978623,6.26086956521739,4071.45780153061,226.192100085034,650.302287744472,60,44.0311075164645,0,0
transformers_4.13.0,src/transformers/models/dpr/modeling_dpr.py,670,232,415,8,30,55,100,38,155,171.206717868256,13.3333333333333,10845.7168611167,602.539825617597,813.428764583756,60,47.00648105076,1,1
transformers_4.13.0,src/transformers/models/dpr/__init__.py,116,22,84,0,0,0,0,0,0,0,0,0,0,0,8,100,0,0
transformers_4.13.0,src/transformers/models/dpr/configuration_dpr.py,119,25,47,0,0,0,0,0,0,0,0,0,0,0,2,100,0,0
transformers_4.13.0,src/transformers/models/dpr/tokenization_dpr_fast.py,391,124,273,13,49,41,74,62,115,323.226498697479,9.81632653061224,6721.55854916429,373.419919398016,684.732575694491,32,55.1902284570683,0,0
transformers_4.13.0,src/transformers/models/dpr/convert_dpr_original_checkpoint_to_pytorch.py,139,94,99,6,14,10,17,20,27,68.8127439131334,3.64285714285714,425.092499047136,23.6162499470631,116.692058561959,23,61.9932263144965,0,0
transformers_4.13.0,src/transformers/models/dpr/tokenization_dpr.py,388,120,270,13,49,41,74,62,115,323.226498697479,9.81632653061224,6721.55854916429,373.419919398016,684.732575694491,32,55.5865696780431,0,0
transformers_4.13.0,src/transformers/models/sew/__init__.py,52,13,26,0,0,0,0,0,0,0,0,0,0,0,4,100,0,0
transformers_4.13.0,src/transformers/models/sew/modeling_sew.py,1135,536,782,19,162,173,296,181,469,1269.76632322274,17.358024691358,61055.5972319146,3391.97762399526,3517.42772104202,137,19.5657092660052,0,0
transformers_4.13.0,src/transformers/models/sew/convert_sew_original_pytorch_checkpoint_to_pytorch.py,300,180,238,10,65,54,102,75,156,424.673188795723,7.84615384615385,7624.07407716696,423.55967095372,971.695715717357,51,40.2512536723409,0,0
transformers_4.13.0,src/transformers/models/sew/configuration_sew.py,244,48,97,2,7,4,9,9,13,21.6514844544032,1.28571428571429,52.9830321669644,2.94350178705358,41.2090250187501,5,71.5167692253117,0,0
transformers_4.13.0,src/transformers/models/clip/modeling_flax_clip.py,1139,431,834,15,89,97,170,104,267,634.943634290137,14.3258426966292,25629.1819218897,1423.84344010498,1789.01740474367,100,24.2685864741472,0,0
transformers_4.13.0,src/transformers/models/clip/__init__.py,95,28,62,0,0,0,0,0,0,0,0,0,0,0,10,100,0,0
transformers_4.13.0,src/transformers/models/clip/tokenization_clip.py,371,187,218,14,89,58,113,103,171,629.643244264816,8.8876404494382,10162.0533461498,564.558519230543,1143.39159014833,51,50.5746461261168,0,0
transformers_4.13.0,src/transformers/models/clip/processing_clip.py,171,45,40,4,9,11,20,13,31,36.5293250129808,4.44444444444444,509.838361166106,28.324353398117,114.713631262374,16,42.9651739818463,0,0
transformers_4.13.0,src/transformers/models/clip/tokenization_clip_fast.py,168,45,78,3,8,5,8,11,13,28.7548875021635,1.5,67.4589165634273,3.74771758685707,44.9726110422849,9,79.5080459949761,0,0
transformers_4.13.0,src/transformers/models/clip/configuration_clip.py,283,69,105,1,3,2,4,4,6,4.75488750216347,0.666666666666667,8,0.444444444444444,12,8,72.4237609448667,0,0
transformers_4.13.0,src/transformers/models/clip/modeling_clip.py,1037,408,656,14,118,119,208,132,327,865.454848733504,12.3389830508475,28423.0557030169,1579.0586501676,2303.51687703021,89,33.560948688335,0,0
transformers_4.13.0,src/transformers/models/clip/feature_extraction_clip.py,209,72,90,10,46,30,57,56,87,287.303130927496,6.19565217391304,3130.29054983518,173.905030546399,505.239878219012,33,62.6811699671132,0,0
transformers_4.13.0,src/transformers/models/clip/convert_clip_original_pytorch_to_hf.py,148,75,75,2,4,2,4,6,6,10,1,15.5097750043269,0.861654166907052,15.5097750043269,6,78.0359973581544,0,0
transformers_4.13.0,src/transformers/models/squeezebert/tokenization_squeezebert.py,61,18,26,0,0,0,0,0,0,0,0,0,0,0,1,100,0,0
transformers_4.13.0,src/transformers/models/squeezebert/tokenization_squeezebert_fast.py,68,20,33,0,0,0,0,0,0,0,0,0,0,0,1,100,0,0
transformers_4.13.0,src/transformers/models/squeezebert/__init__.py,69,18,40,0,0,0,0,0,0,0,0,0,0,0,6,100,0,0
transformers_4.13.0,src/transformers/models/squeezebert/configuration_squeezebert.py,149,31,55,0,0,0,0,0,0,0,0,0,0,0,2,100,0,0
transformers_4.13.0,src/transformers/models/squeezebert/modeling_squeezebert.py,1107,475,774,13,87,124,209,100,333,608.641800474674,15.6149425287356,34546.5630466481,1919.25350259156,2212.40411119498,124,24.0710733227177,1,1
transformers_4.13.0,src/transformers/models/herbert/__init__.py,41,13,14,0,0,0,0,0,0,0,0,0,0,0,4,100,0,0
transformers_4.13.0,src/transformers/models/herbert/tokenization_herbert_fast.py,175,45,74,3,44,27,54,47,81,244.969878722205,1.84090909090909,828.264942178568,46.0147190099204,449.921696985889,10,70.7663990533407,0,0
transformers_4.13.0,src/transformers/models/herbert/tokenization_herbert.py,103,27,61,0,0,0,0,0,0,0,0,0,0,0,6,100,1,1
transformers_4.13.0,src/transformers/models/big_bird/tokenization_big_bird.py,270,96,124,5,56,33,64,61,97,336.821516109663,2.85714285714286,1643.661490696,91.3145272608889,575.2815217436,31,61.7121330184841,0,0
transformers_4.13.0,src/transformers/models/big_bird/__init__.py,108,25,77,0,0,0,0,0,0,0,0,0,0,0,10,100,0,0
transformers_4.13.0,src/transformers/models/big_bird/modeling_flax_big_bird.py,2081,865,1443,20,251,317,553,271,870,2087.29599393939,22.0318725099602,154916.443238477,8606.46906880425,7031.46966597787,171,10.1340315074294,0,0
transformers_4.13.0,src/transformers/models/big_bird/tokenization_big_bird_fast.py,247,74,116,7,55,35,67,62,102,337.626268698259,4.26363636363636,2589.42584632989,143.856991462771,607.328023659461,25,64.6715182618267,0,0
transformers_4.13.0,src/transformers/models/big_bird/modeling_big_bird.py,3065,1342,2141,22,454,585,1021,476,1606,4105.3605088401,24.7378854625551,353382.606760654,19632.3670422585,14285.0773278726,338,0,0,0
transformers_4.13.0,src/transformers/models/big_bird/configuration_big_bird.py,159,31,66,0,0,0,0,0,0,0,0,0,0,0,2,100,0,0
transformers_4.13.0,src/transformers/models/big_bird/convert_bigbird_original_tf_checkpoint_to_pytorch.py,69,23,37,1,2,1,2,3,3,2,0.5,2.37744375108173,0.13208020839343,4.75488750216347,3,94.1600795786851,0,0
transformers_4.13.0,src/transformers/models/openai/convert_openai_original_tf_checkpoint_to_pytorch.py,74,28,43,2,10,6,12,12,18,35.2192809488736,1.2,77.435190015577,4.30195500086539,64.5293250129808,3,83.8249494823163,0,0
transformers_4.13.0,src/transformers/models/openai/modeling_openai.py,856,411,603,17,129,143,244,146,387,973.935184250855,16.077519379845,44735.0884053515,2485.28268918619,2782.46210428657,105,28.5409222331904,1,1
transformers_4.13.0,src/transformers/models/openai/tokenization_openai_fast.py,76,27,28,0,0,0,0,0,0,0,0,0,0,0,4,100,0,0
transformers_4.13.0,src/transformers/models/openai/__init__.py,87,22,56,0,0,0,0,0,0,0,0,0,0,0,8,100,0,0
transformers_4.13.0,src/transformers/models/openai/configuration_openai.py,161,30,51,0,0,0,0,0,0,0,0,0,0,0,2,100,0,0
transformers_4.13.0,src/transformers/models/openai/tokenization_openai.py,233,154,152,11,40,30,56,51,86,250.930871600505,7.7,3756.28006145352,208.682225636307,487.828579409549,37,53.8387926033316,0,0
transformers_4.13.0,src/transformers/models/openai/modeling_tf_openai.py,974,360,732,14,108,106,173,122,279,782.830819142461,11.212962962963,21682.2341991207,1204.56856661782,1933.67571718005,86,30.4744362545024,0,0
transformers_4.13.0,src/transformers/models/mbart/modeling_mbart.py,1861,677,1239,17,197,240,428,214,668,1571.03107673416,18.4670050761421,95498.4223699507,5305.4679094417,5171.29994691597,222,8.05431178987506,1,1
transformers_4.13.0,src/transformers/models/mbart/convert_mbart_original_checkpoint_to_pytorch.py,83,36,54,2,4,2,4,6,6,10,1,15.5097750043269,0.861654166907052,15.5097750043269,6,82.3436322371481,0,0
transformers_4.13.0,src/transformers/models/mbart/__init__.py,103,29,69,0,0,0,0,0,0,0,0,0,0,0,12,100,0,0
transformers_4.13.0,src/transformers/models/mbart/modeling_flax_mbart.py,1763,691,1344,14,165,167,296,179,463,1268.74613425937,12.5575757575758,43512.0841969551,2417.33801094195,3465.00670487335,156,10.6380926078917,0,0
transformers_4.13.0,src/transformers/models/mbart/configuration_mbart.py,194,50,96,0,0,0,0,0,0,0,0,0,0,0,5,100,0,0
transformers_4.13.0,src/transformers/models/mbart/tokenization_mbart_fast.py,251,89,152,5,34,24,48,39,72,184.583377076948,3.52941176470588,1343.11397561676,74.61744308982,380.548959758082,19,64.4595186007124,0,0
transformers_4.13.0,src/transformers/models/mbart/tokenization_mbart.py,248,93,140,6,51,30,60,57,90,304.803467444873,3.52941176470588,1852.80035744057,102.933353191143,524.960101274827,24,63.7048663773317,0,0
transformers_4.13.0,src/transformers/models/mbart/modeling_tf_mbart.py,1526,501,1069,14,174,156,276,188,432,1348.37513718649,11.1034482758621,36237.018193923,2013.16767744016,3263.58238392474,159,19.3629695697238,0,0
transformers_4.13.0,src/transformers/models/pegasus/modeling_tf_pegasus.py,1553,520,1085,17,175,154,275,192,429,1373.44881287191,13.3571428571429,43463.4604782395,2414.63669323553,3253.94891280938,162,18.6959439052641,1,1
transformers_4.13.0,src/transformers/models/pegasus/modeling_flax_pegasus.py,1522,602,1154,16,150,146,265,166,411,1148.32280357438,14.1333333333333,42840.129048808,2380.00716937822,3031.14120628359,140,15.3040753176634,0,0
transformers_4.13.0,src/transformers/models/pegasus/tokenization_pegasus.py,288,119,151,10,51,36,70,61,106,322.51297338942,6.86274509803922,4314.32069065849,239.684482814361,628.658157781666,42,58.7108155991576,0,0
transformers_4.13.0,src/transformers/models/pegasus/__init__.py,95,29,61,0,0,0,0,0,0,0,0,0,0,0,12,100,0,0
transformers_4.13.0,src/transformers/models/pegasus/configuration_pegasus.py,169,40,73,0,0,0,0,0,0,0,0,0,0,0,4,100,0,0
transformers_4.13.0,src/transformers/models/pegasus/convert_pegasus_tf_to_pytorch.py,132,76,93,8,30,17,34,38,51,171.206717868256,4.53333333333333,1213.32084110816,67.4067133948976,267.644303185623,21,63.1177563168072,0,0
transformers_4.13.0,src/transformers/models/pegasus/modeling_pegasus.py,1705,614,1035,18,167,194,349,185,543,1308.13726686913,18.8083832335329,76917.6380715125,4273.20211508403,4089.54013306036,199,15.067644892086,1,1
transformers_4.13.0,src/transformers/models/pegasus/tokenization_pegasus_fast.py,212,69,111,10,40,27,51,50,78,246.096404744368,6.375,2806.40749036548,155.911527242527,440.220782802429,26,67.0968047753468,0,0
transformers_4.13.0,src/transformers/models/layoutlm/modeling_tf_layoutlm.py,1451,481,1006,11,106,100,175,117,275,751.213315988709,9.08018867924528,17155.657185988,953.092065888225,1889.35029788544,131,24.4241549594414,0,0
transformers_4.13.0,src/transformers/models/layoutlm/tokenization_layoutlm.py,60,18,23,0,0,0,0,0,0,0,0,0,0,0,1,100,0,0
transformers_4.13.0,src/transformers/models/layoutlm/__init__.py,86,24,56,0,0,0,0,0,0,0,0,0,0,0,8,100,0,0
transformers_4.13.0,src/transformers/models/layoutlm/configuration_layoutlm.py,188,37,86,4,8,5,8,12,13,32,2,93.2090250187501,5.17827916770834,46.604512509375,7,80.7502928044224,0,0
transformers_4.13.0,src/transformers/models/layoutlm/tokenization_layoutlm_fast.py,66,20,29,0,0,0,0,0,0,0,0,0,0,0,1,100,0,0
transformers_4.13.0,src/transformers/models/layoutlm/modeling_layoutlm.py,1218,526,830,14,154,165,288,168,453,1172.38809617582,13.0909090909091,43837.7863747913,2435.43257637729,3348.71979251878,146,20.4940432758321,1,1
transformers_4.13.0,src/transformers/models/convbert/__init__.py,98,22,66,0,0,0,0,0,0,0,0,0,0,0,8,100,0,0
transformers_4.13.0,src/transformers/models/convbert/convert_convbert_original_tf1_checkpoint_to_pytorch_and_tf2.py,55,19,29,1,2,1,2,3,3,2,0.5,2.37744375108173,0.13208020839343,4.75488750216347,2,96.2398813938571,0,0
transformers_4.13.0,src/transformers/models/convbert/modeling_tf_convbert.py,1445,533,1125,14,109,117,201,123,318,791.035060309491,12.9082568807339,28497.8118813387,1583.21177118548,2207.71961269788,138,14.9510750151152,0,0
transformers_4.13.0,src/transformers/models/convbert/modeling_convbert.py,1364,651,1079,16,129,175,297,145,472,968.4483159496,18.4186046511628,62419.1240852498,3467.72911584721,3388.91709048705,161,8.962529576191,0,0
transformers_4.13.0,src/transformers/models/convbert/tokenization_convbert_fast.py,61,20,28,0,0,0,0,0,0,0,0,0,0,0,1,100,0,0
transformers_4.13.0,src/transformers/models/convbert/tokenization_convbert.py,56,18,26,0,0,0,0,0,0,0,0,0,0,0,1,100,0,0
transformers_4.13.0,src/transformers/models/convbert/configuration_convbert.py,139,28,60,0,0,0,0,0,0,0,0,0,0,0,2,100,0,0
transformers_4.13.0,src/transformers/models/gpt2/modeling_gpt2.py,1546,727,1127,18,225,261,439,243,700,1833.1594180498,17.56,97411.7952943223,5411.76640524013,5547.36875252405,200,6.65738330265034,2,1
transformers_4.13.0,src/transformers/models/gpt2/tokenization_gpt2.py,309,161,194,13,54,38,73,67,111,358.869641452662,8.78703703703704,5916.62749290399,328.701527383555,673.335900140813,47,53.0779900027401,0,0
transformers_4.13.0,src/transformers/models/gpt2/modeling_flax_gpt2.py,770,360,589,12,100,82,147,112,229,707.405168986127,8.82,13749.3593244735,763.853295804084,1558.88427715119,77,29.3543895942631,0,0
transformers_4.13.0,src/transformers/models/gpt2/convert_gpt2_original_tf_checkpoint_to_pytorch.py,68,28,37,2,10,6,12,12,18,35.2192809488736,1.2,77.435190015577,4.30195500086539,64.5293250129808,3,84.3659101116296,0,0
transformers_4.13.0,src/transformers/models/gpt2/configuration_gpt2.py,251,79,118,3,7,5,9,10,14,24.4063719565667,1.92857142857143,89.6920585619588,4.98289214233104,46.5069933284231,12,73.3473162576107,0,0
transformers_4.13.0,src/transformers/models/gpt2/__init__.py,94,26,62,0,0,0,0,0,0,0,0,0,0,0,10,100,0,0
transformers_4.13.0,src/transformers/models/gpt2/modeling_tf_gpt2.py,1299,449,965,14,144,140,234,158,374,1085.7721691165,11.375,31072.1092479324,1726.2282915518,2731.61399981824,120,24.0895266724714,0,0
transformers_4.13.0,src/transformers/models/gpt2/tokenization_gpt2_fast.py,187,52,98,6,12,8,13,18,21,58.5293250129808,3.25,284.597381348438,15.8109656304688,87.5684250302886,12,76.5769434084144,0,0
transformers_4.13.0,src/transformers/models/vision_text_dual_encoder/configuration_vision_text_dual_encoder.py,129,41,37,2,6,4,8,8,12,17.5097750043269,1.33333333333333,48,2.66666666666667,36,8,66.3750462800914,0,0
transformers_4.13.0,src/transformers/models/vision_text_dual_encoder/__init__.py,52,18,20,0,0,0,0,0,0,0,0,0,0,0,6,100,0,0
transformers_4.13.0,src/transformers/models/vision_text_dual_encoder/processing_vision_text_dual_encoder.py,185,48,47,4,9,11,20,13,31,36.5293250129808,4.44444444444444,509.838361166106,28.324353398117,114.713631262374,16,47.6232677834244,0,0
transformers_4.13.0,src/transformers/models/vision_text_dual_encoder/modeling_flax_vision_text_dual_encoder.py,568,158,371,10,49,40,71,59,111,308.340063310519,7.24489795918367,4730.72549714497,262.81808317472,652.973378479164,40,52.0434284236363,0,0
transformers_4.13.0,src/transformers/models/vision_text_dual_encoder/modeling_vision_text_dual_encoder.py,519,129,297,11,40,30,56,51,86,250.930871600505,7.7,3756.28006145352,208.682225636307,487.828579409549,32,59.3249863014574,0,0
transformers_4.13.0,src/transformers/models/rag/__init__.py,66,19,37,0,0,0,0,0,0,0,0,0,0,0,6,100,0,0
transformers_4.13.0,src/transformers/models/rag/tokenization_rag.py,126,56,90,1,6,4,8,7,12,15.5097750043269,0.666666666666667,22.4588393764608,1.24771329869227,33.6882590646913,14,73.5177201102175,0,0
transformers_4.13.0,src/transformers/models/rag/modeling_rag.py,1680,507,985,15,155,181,329,170,510,1186.40264175163,15.9193548387097,60155.8889600586,3341.99383111437,3778.78937743023,143,25.7190343922188,1,1
transformers_4.13.0,src/transformers/models/rag/modeling_tf_rag.py,1877,574,1147,16,190,193,350,206,543,1502.27256558288,14.7368421052632,61508.1863238388,3417.12146243549,4173.76978626049,153,22.4271199017118,1,1
transformers_4.13.0,src/transformers/models/rag/retrieval_rag.py,644,280,370,14,74,45,85,88,130,512.802517965349,8.04054054054054,6751.85183380534,375.102879655852,839.726110422849,86,43.5388930621365,0,0
transformers_4.13.0,src/transformers/models/rag/configuration_rag.py,197,51,148,3,7,4,8,10,12,24.4063719565667,1.71428571428571,68.3368065233972,3.79648925129984,39.8631371386484,6,73.0570844089796,0,0
transformers_4.13.0,src/transformers/models/megatron_bert/convert_megatron_bert_checkpoint.py,264,117,128,8,47,41,82,55,123,285.065676028849,6.97872340425532,4962.62077196679,275.701153998155,711.107244763533,20,61.4645652537063,0,0
transformers_4.13.0,src/transformers/models/megatron_bert/__init__.py,63,13,38,0,0,0,0,0,0,0,0,0,0,0,4,100,0,0
transformers_4.13.0,src/transformers/models/megatron_bert/modeling_megatron_bert.py,1854,787,1288,16,199,241,416,215,657,1583.68829948819,16.7236180904523,85132.6264967636,4729.59036093131,5090.56270218028,224,4.47582992080128,0,0
transformers_4.13.0,src/transformers/models/megatron_bert/configuration_megatron_bert.py,128,24,42,0,0,0,0,0,0,0,0,0,0,0,2,100,0,0
transformers_4.13.0,src/transformers/models/luke/tokenization_luke.py,1373,446,1006,18,361,250,493,379,743,3142.06231473223,12.2908587257618,78226.1308951587,4345.89616084215,6364.57815036112,193,13.3807941780563,0,0
transformers_4.13.0,src/transformers/models/luke/__init__.py,59,14,32,0,0,0,0,0,0,0,0,0,0,0,4,100,0,0
transformers_4.13.0,src/transformers/models/luke/modeling_luke.py,1621,666,1001,12,111,161,271,123,432,797.199711173516,14.6486486486487,43933.7328740041,2440.76293744467,2999.16626630655,144,21.9332503088672,0,0
transformers_4.13.0,src/transformers/models/luke/configuration_luke.py,130,27,47,0,0,0,0,0,0,0,0,0,0,0,2,100,0,0
transformers_4.13.0,src/transformers/models/luke/convert_luke_original_pytorch_checkpoint_to_pytorch.py,165,85,109,7,42,36,56,49,92,246.128816211111,4.66666666666667,2410.58209307346,133.92122739297,516.553305658599,19,61.725062590883,0,0
transformers_4.13.0,src/transformers/models/vision_encoder_decoder/configuration_vision_encoder_decoder.py,120,34,36,2,5,3,6,7,9,13.6096404744368,1.2,30.3194331582221,1.68441295323456,25.2661942985184,6,69.6982943964845,0,0
transformers_4.13.0,src/transformers/models/vision_encoder_decoder/__init__.py,46,17,18,0,0,0,0,0,0,0,0,0,0,0,6,100,0,0
transformers_4.13.0,src/transformers/models/vision_encoder_decoder/convert_trocr_unilm_to_pytorch.py,238,116,163,8,52,45,65,60,110,320.422865343337,5,3248.78982758469,180.488323754705,649.757965516937,22,57.1282003791488,0,0
transformers_4.13.0,src/transformers/models/vision_encoder_decoder/modeling_vision_encoder_decoder.py,549,161,341,11,69,60,113,80,173,459.541935322704,9.00724637681159,9851.16735939481,547.287075521934,1093.69356041551,65,48.9574736101596,0,0
transformers_4.13.0,src/transformers/models/vision_encoder_decoder/modeling_flax_vision_encoder_decoder.py,847,241,547,11,79,66,123,90,189,536.052426911001,8.56329113924051,10506.8177103426,583.712095019035,1226.96023520631,69,43.3213624411453,0,0
transformers_4.13.0,src/transformers/models/deberta_v2/tokenization_deberta_v2.py,541,283,310,16,152,93,188,168,281,1165.68498204343,9.89473684210526,20553.7549900293,1141.87527722385,2077.24119580083,109,37.2023451455333,0,0
transformers_4.13.0,src/transformers/models/deberta_v2/modeling_tf_deberta_v2.py,1681,681,1266,19,244,250,429,263,679,2015.81053312077,16.702868852459,91171.3735141167,5065.07630633982,5458.42599372947,184,6.14703047763443,0,0
transformers_4.13.0,src/transformers/models/deberta_v2/__init__.py,81,18,52,0,0,0,0,0,0,0,0,0,0,0,6,100,0,0
transformers_4.13.0,src/transformers/models/deberta_v2/modeling_deberta_v2.py,1537,787,1110,21,257,312,524,278,836,2149.68417502118,21.408560311284,145309.20592162,8072.73366231221,6787.43473679685,220,1.35970362594455,0,0
transformers_4.13.0,src/transformers/models/deberta_v2/configuration_deberta_v2.py,138,33,57,1,2,1,2,3,3,2,0.5,2.37744375108173,0.13208020839343,4.75488750216347,4,84.4106805477943,0,0
transformers_4.13.0,src/transformers/models/bigbird_pegasus/convert_bigbird_pegasus_tf_to_pytorch.py,171,78,133,7,24,19,37,31,56,129.690584471711,5.39583333333333,1496.9929851219,83.1662769512167,277.434993381665,32,56.5661720107043,0,0
transformers_4.13.0,src/transformers/models/bigbird_pegasus/__init__.py,57,13,30,0,0,0,0,0,0,0,0,0,0,0,4,100,0,0
transformers_4.13.0,src/transformers/models/bigbird_pegasus/configuration_bigbird_pegasus.py,185,38,81,0,0,0,0,0,0,0,0,0,0,0,2,100,0,0
transformers_4.13.0,src/transformers/models/bigbird_pegasus/modeling_bigbird_pegasus.py,3061,1189,2052,20,443,588,1033,463,1621,3980.92372152762,23.3182844243792,334704.630331616,18594.7016850898,14353.7416492648,328,0,0,0
transformers_4.13.0,src/transformers/models/deit/feature_extraction_deit.py,160,45,66,5,25,14,28,30,42,127.706045218805,2.8,577.050334043562,32.058351891309,206.089405015558,24,69.9252082258931,0,0
transformers_4.13.0,src/transformers/models/deit/__init__.py,59,17,30,0,0,0,0,0,0,0,0,0,0,0,6,100,0,0
transformers_4.13.0,src/transformers/models/deit/convert_deit_timm_to_pytorch.py,219,124,152,4,12,11,17,16,28,51.0195500086539,2.83333333333333,317.333333333333,17.6296296296296,112,17,62.6497930502229,0,0
transformers_4.13.0,src/transformers/models/deit/configuration_deit.py,119,24,41,0,0,0,0,0,0,0,0,0,0,0,2,100,0,0
transformers_4.13.0,src/transformers/models/deit/modeling_deit.py,779,342,460,15,79,70,122,94,192,556.602038040119,11.5822784810127,14576.0780944649,809.782116359161,1258.48105952211,80,39.498516574335,0,0
transformers_4.13.0,src/transformers/models/splinter/__init__.py,61,18,32,0,0,0,0,0,0,0,0,0,0,0,6,100,0,0
transformers_4.13.0,src/transformers/models/splinter/modeling_splinter.py,942,439,675,14,130,135,241,144,376,966.210784602506,12.9769230769231,34984.3805193452,1943.57669551918,2695.89180054231,122,24.8084036336734,0,0
transformers_4.13.0,src/transformers/models/splinter/tokenization_splinter.py,531,251,300,17,161,102,208,178,310,1249.76448567771,10.9813664596273,25449.068191578,1413.83712175434,2317.47736359958,89,41.2639191443678,0,0
transformers_4.13.0,src/transformers/models/splinter/configuration_splinter.py,126,25,46,0,0,0,0,0,0,0,0,0,0,0,2,100,0,0
transformers_4.13.0,src/transformers/models/splinter/tokenization_splinter_fast.py,216,61,103,6,56,38,76,62,114,340.721650639553,4.07142857142857,2763.59768749242,153.53320486069,678.778379384104,12,67.6380332170768,0,0
transformers_4.13.0,src/transformers/models/visual_bert/modeling_visual_bert.py,1587,589,1010,13,130,196,323,143,519,961.013532029533,16.15,60012.9675641759,3334.05375356533,3715.97322378798,145,21.0366753416111,0,0
transformers_4.13.0,src/transformers/models/visual_bert/__init__.py,61,13,34,0,0,0,0,0,0,0,0,0,0,0,4,100,0,0
transformers_4.13.0,src/transformers/models/visual_bert/configuration_visual_bert.py,145,26,55,0,0,0,0,0,0,0,0,0,0,0,2,100,0,0
transformers_4.13.0,src/transformers/models/visual_bert/convert_visual_bert_original_pytorch_checkpoint_to_pytorch.py,150,84,102,3,18,19,36,21,55,79.8135375281251,3,724.732374758496,40.2629097088053,241.577458252832,20,63.33234655745,0,0
transformers_4.13.0,src/transformers/models/distilbert/modeling_distilbert.py,1134,483,731,15,117,135,233,132,368,862.436031125386,14.9358974358974,38718.8800878379,2151.04889376877,2592.33703592391,129,28.1336588521774,0,0
transformers_4.13.0,src/transformers/models/distilbert/tokenization_distilbert.py,71,19,36,0,0,0,0,0,0,0,0,0,0,0,1,100,0,0
transformers_4.13.0,src/transformers/models/distilbert/modeling_flax_distilbert.py,898,389,701,13,75,73,124,88,197,515.267118123025,10.7466666666667,13675.2196169396,759.734423163309,1272.50802887155,75,28.0901878980631,0,0
transformers_4.13.0,src/transformers/models/distilbert/__init__.py,123,26,90,0,0,0,0,0,0,0,0,0,0,0,10,100,0,0
transformers_4.13.0,src/transformers/models/distilbert/modeling_tf_distilbert.py,1177,437,890,12,91,86,149,103,235,635.228862266735,9.82417582417583,15436.9988544607,857.611047470038,1571.32762388806,109,27.6612584641184,0,0
transformers_4.13.0,src/transformers/models/distilbert/tokenization_distilbert_fast.py,81,21,46,0,0,0,0,0,0,0,0,0,0,0,1,100,0,0
transformers_4.13.0,src/transformers/models/distilbert/configuration_distilbert.py,148,38,66,0,0,0,0,0,0,0,0,0,0,0,4,100,0,0
transformers_4.13.0,src/transformers/models/xlnet/configuration_xlnet.py,238,59,99,5,10,10,19,15,29,44.8289214233104,4.75,538.174179545073,29.8985655302819,113.299827272647,8,70.3146630143284,0,0
transformers_4.13.0,src/transformers/models/xlnet/__init__.py,107,25,74,0,0,0,0,0,0,0,0,0,0,0,10,100,0,0
transformers_4.13.0,src/transformers/models/xlnet/convert_xlnet_original_tf_checkpoint_to_pytorch.py,113,40,78,3,6,4,8,9,12,20.2646625064904,2,76.0782000346155,4.22656666858975,38.0391000173078,5,77.8468066631608,0,0
transformers_4.13.0,src/transformers/models/xlnet/tokenization_xlnet.py,342,128,160,10,66,44,81,76,125,432.149292826532,6.13636363636364,4792.44439951639,266.246911084244,780.990939180448,38,57.4039481805307,0,0
transformers_4.13.0,src/transformers/models/xlnet/modeling_tf_xlnet.py,1924,710,1362,16,204,193,350,220,543,1629.17476976219,13.7254901960784,57994.0162178573,3221.88978988096,4225.27832444389,192,10.5055283836715,1,1
transformers_4.13.0,src/transformers/models/xlnet/tokenization_xlnet_fast.py,242,65,110,5,33,23,43,38,66,178.074646413266,3.25757575757576,1128.30441539037,62.6835786327984,346.363215887277,14,68.5997320904784,0,0
transformers_4.13.0,src/transformers/models/xlnet/modeling_xlnet.py,2085,875,1371,18,248,297,521,266,818,2047.69933500191,18.9072580645161,124584.102500699,6921.33902781659,6589.22103223997,228,5.11732703374366,0,0
transformers_4.13.0,src/transformers/models/xlm_prophetnet/__init__.py,63,17,35,0,0,0,0,0,0,0,0,0,0,0,6,100,0,0
transformers_4.13.0,src/transformers/models/xlm_prophetnet/modeling_xlm_prophetnet.py,166,22,25,0,0,0,0,0,0,0,0,0,0,0,1,100,0,0
transformers_4.13.0,src/transformers/models/xlm_prophetnet/tokenization_xlm_prophetnet.py,326,119,150,7,55,33,64,62,97,337.626268698259,4.07272727272727,2352.23231694702,130.679573163723,577.557042107527,33,59.5844396275311,0,0
transformers_4.13.0,src/transformers/models/xlm_prophetnet/configuration_xlm_prophetnet.py,35,9,8,0,0,0,0,0,0,0,0,0,0,0,1,100,0,0
transformers_4.13.0,src/transformers/models/wav2vec2_with_lm/__init__.py,35,9,10,0,0,0,0,0,0,0,0,0,0,0,2,100,0,0
transformers_4.13.0,src/transformers/models/wav2vec2_with_lm/processing_wav2vec2_with_lm.py,374,113,161,5,23,16,29,28,45,115.651565463748,3.15217391304348,681.912844922301,37.8840469401279,216.330971492592,35,60.5791658371251,0,0
transformers_4.13.0,src/transformers/models/funnel/convert_funnel_original_tf_checkpoint_to_pytorch.py,66,21,35,1,2,1,2,3,3,2,0.5,2.37744375108173,0.13208020839343,4.75488750216347,3,95.1469205263313,0,0
transformers_4.13.0,src/transformers/models/funnel/tokenization_funnel.py,137,31,80,3,20,12,24,23,36,91.1934493999107,1.8,293.126814752494,16.2848230418052,162.848230418052,6,80.0321990958868,0,0
transformers_4.13.0,src/transformers/models/funnel/__init__.py,102,22,71,0,0,0,0,0,0,0,0,0,0,0,8,100,0,0
transformers_4.13.0,src/transformers/models/funnel/tokenization_funnel_fast.py,153,33,96,3,20,12,24,23,36,91.1934493999107,1.8,293.126814752494,16.2848230418052,162.848230418052,6,78.6463694035905,0,0
transformers_4.13.0,src/transformers/models/funnel/modeling_tf_funnel.py,1835,786,1366,15,239,210,376,254,586,1946.91052604153,11.7991631799163,55236.2394083044,3068.67996712802,4681.36922644849,208,3.91034478235735,0,0
transformers_4.13.0,src/transformers/models/funnel/configuration_funnel.py,188,50,95,4,10,5,10,14,15,41.2192809488736,2,114.220647661728,6.34559153676267,57.1103238308641,10,77.1679734778729,0,0
transformers_4.13.0,src/transformers/models/funnel/modeling_funnel.py,1590,822,1164,20,275,284,511,295,795,2314.84270921105,18.5818181818182,121202.400163473,6733.46667574852,6522.63405967812,223,1.80940262217857,0,0
transformers_4.13.0,src/transformers/models/bart/configuration_bart.py,209,54,107,2,4,2,4,6,6,10,1,15.5097750043269,0.861654166907052,15.5097750043269,7,81.2318745466752,0,0
transformers_4.13.0,src/transformers/models/bart/tokenization_bart_fast.py,75,16,44,0,0,0,0,0,0,0,0,0,0,0,1,100,0,0
transformers_4.13.0,src/transformers/models/bart/__init__.py,89,26,58,0,0,0,0,0,0,0,0,0,0,0,10,100,0,0
transformers_4.13.0,src/transformers/models/bart/convert_bart_original_pytorch_checkpoint_to_pytorch.py,150,87,104,4,13,8,15,17,23,56.1057163358342,2.30769230769231,216.949950804826,12.0527750447125,94.0116453487578,13,65.9619092932222,0,0
transformers_4.13.0,src/transformers/models/bart/modeling_tf_bart.py,1514,503,1074,14,173,152,271,187,423,1339.49365228996,10.9653179190751,35004.9830540006,1944.72128077781,3192.33635653247,160,18.4378132516307,1,1
transformers_4.13.0,src/transformers/models/bart/modeling_flax_bart.py,1736,680,1332,14,158,160,284,172,444,1207.30032712079,12.5822784810127,41487.0630605216,2304.83683669564,3297.26155108773,154,10.6701770752155,0,0
transformers_4.13.0,src/transformers/models/bart/tokenization_bart.py,65,14,34,0,0,0,0,0,0,0,0,0,0,0,1,100,0,0
transformers_4.13.0,src/transformers/models/bart/modeling_bart.py,1858,680,1245,17,196,239,427,213,666,1561.96999774784,18.5178571428571,95391.3450273574,5299.51916818652,5151.31660707041,223,7.57332825047104,1,1
transformers_4.13.0,src/transformers/models/gptj/modeling_flax_gptj.py,714,340,531,15,101,75,131,116,206,731.082718692059,9.72772277227723,13742.7828070183,763.487933723237,1412.74408499628,59,31.9992645057398,0,0
transformers_4.13.0,src/transformers/models/gptj/__init__.py,64,17,36,0,0,0,0,0,0,0,0,0,0,0,6,100,0,0
transformers_4.13.0,src/transformers/models/gptj/configuration_gptj.py,136,30,57,0,0,0,0,0,0,0,0,0,0,0,2,100,0,0
transformers_4.13.0,src/transformers/models/gptj/modeling_gptj.py,1079,519,806,16,173,186,315,189,501,1350.19068338115,14.5664739884393,55187.7589909109,3065.98661060616,3788.68345453476,138,17.4131982784859,0,0
transformers_4.13.0,src/transformers/models/prophetnet/convert_prophetnet_original_pytorch_checkpoint_to_pytorch.py,160,99,117,8,36,31,57,44,88,210.117300051923,6.33333333333333,3042.72322212052,169.040179006696,480.429982440082,26,56.2894471244228,0,0
transformers_4.13.0,src/transformers/models/prophetnet/__init__.py,59,14,32,0,0,0,0,0,0,0,0,0,0,0,4,100,0,0
transformers_4.13.0,src/transformers/models/prophetnet/configuration_prophetnet.py,176,40,79,1,2,1,2,3,3,2,0.5,2.37744375108173,0.13208020839343,4.75488750216347,4,85.0407647436326,0,0
transformers_4.13.0,src/transformers/models/prophetnet/modeling_prophetnet.py,2321,885,1451,15,297,347,612,312,959,2498.25613781196,15.4545454545455,122797.193067374,6822.06628152077,7945.7007278889,238,3.51897174360089,0,0
transformers_4.13.0,src/transformers/models/prophetnet/tokenization_prophetnet.py,285,100,143,6,51,31,61,57,92,304.803467444873,3.58823529411765,1925.53992702897,106.974440390498,536.625881303156,28,62.4276223479291,0,0
transformers_4.13.0,src/transformers/models/rembert/modeling_rembert.py,1540,684,1118,16,167,202,346,183,548,1297.07861684317,16.5748502994012,68265.2366437059,3792.51314687255,4118.60351137966,198,8.47537612244497,0,0
transformers_4.13.0,src/transformers/models/rembert/tokenization_rembert_fast.py,239,65,105,7,53,33,65,60,98,323.231268546253,4.29245283018868,2484.794826964,138.044157053556,578.875278369635,17,65.6336530780345,0,0
transformers_4.13.0,src/transformers/models/rembert/tokenization_rembert.py,264,88,118,7,53,33,65,60,98,323.231268546253,4.29245283018868,2484.794826964,138.044157053556,578.875278369635,24,63.201692976952,0,0
transformers_4.13.0,src/transformers/models/rembert/configuration_rembert.py,136,28,51,0,0,0,0,0,0,0,0,0,0,0,2,100,0,0
transformers_4.13.0,src/transformers/models/rembert/__init__.py,113,25,78,0,0,0,0,0,0,0,0,0,0,0,10,100,0,0
transformers_4.13.0,src/transformers/models/rembert/modeling_tf_rembert.py,1768,607,1345,12,135,143,243,147,386,998.389655610516,10.8,30013.9940711538,1667.4441150641,2779.07352510684,175,11.9582179526374,0,0
transformers_4.13.0,src/transformers/models/rembert/convert_rembert_tf_checkpoint_to_pytorch.py,61,20,30,1,2,1,2,3,3,2,0.5,2.37744375108173,0.13208020839343,4.75488750216347,2,95.8316665485003,0,0
transformers_4.13.0,src/transformers/models/roformer/tokenization_utils.py,68,29,34,2,4,2,4,6,6,10,1,15.5097750043269,0.861654166907052,15.5097750043269,9,87.3699243116885,0,0
transformers_4.13.0,src/transformers/models/roformer/convert_roformer_original_tf_checkpoint_to_pytorch.py,61,20,30,1,2,1,2,3,3,2,0.5,2.37744375108173,0.13208020839343,4.75488750216347,2,95.8316665485003,0,0
transformers_4.13.0,src/transformers/models/roformer/modeling_tf_roformer.py,1527,560,1160,11,118,119,201,129,320,850.205627629708,9.36864406779661,21019.4216430384,1167.74564683547,2243.59272173544,144,15.6711608040609,0,0
transformers_4.13.0,src/transformers/models/roformer/__init__.py,102,22,70,0,0,0,0,0,0,0,0,0,0,0,8,100,0,0
transformers_4.13.0,src/transformers/models/roformer/tokenization_roformer.py,327,117,178,7,64,38,75,71,113,403.651484454403,4.1015625,2850.26365519231,158.347980844017,694.921424504029,34,59.6474793709292,0,0
transformers_4.13.0,src/transformers/models/roformer/modeling_roformer.py,1598,731,1163,17,194,227,388,211,615,1543.86995968556,17,80724.0920179336,4484.67177877409,4748.47600105492,205,6.39641467982701,0,0
transformers_4.13.0,src/transformers/models/roformer/configuration_roformer.py,135,26,50,1,2,1,2,3,3,2,0.5,2.37744375108173,0.13208020839343,4.75488750216347,3,82.9918597945863,0,0
transformers_4.13.0,src/transformers/models/roformer/tokenization_roformer_fast.py,206,61,113,5,29,17,34,34,51,152.491089333136,2.93103448275862,760.487979890352,42.2493322161307,259.460604903767,12,71.5936807624212,0,0
transformers_4.13.0,src/transformers/models/canine/convert_canine_original_tf_checkpoint_to_pytorch.py,67,22,33,1,2,1,2,3,3,2,0.5,2.37744375108173,0.13208020839343,4.75488750216347,2,94.9458236569989,0,0
transformers_4.13.0,src/transformers/models/canine/modeling_canine.py,1637,744,1144,19,216,221,384,235,605,1755.76632322274,16.8888888888889,80480.499822902,4471.13887905011,4765.29275267183,191,9.81719123820634,0,0
transformers_4.13.0,src/transformers/models/canine/__init__.py,63,14,36,0,0,0,0,0,0,0,0,0,0,0,4,100,0,0
transformers_4.13.0,src/transformers/models/canine/tokenization_canine.py,245,85,118,4,36,20,40,40,60,194.117300051923,2.22222222222222,709.590412651648,39.4216895917582,319.315685693242,27,65.4710276180451,0,0
transformers_4.13.0,src/transformers/models/canine/configuration_canine.py,138,28,52,0,0,0,0,0,0,0,0,0,0,0,2,100,0,0
transformers_4.13.0,src/transformers/models/hubert/__init__.py,71,18,42,0,0,0,0,0,0,0,0,0,0,0,6,100,0,0
transformers_4.13.0,src/transformers/models/hubert/modeling_tf_hubert.py,1628,686,1151,20,214,191,341,234,532,1743.11249698759,15.9345794392523,66718.6263789283,3706.5903543849,4187.03403081837,186,9.56000825621432,0,0
transformers_4.13.0,src/transformers/models/hubert/convert_hubert_original_pytorch_checkpoint_to_pytorch.py,244,134,191,9,61,53,98,70,151,390.304302604317,7.22950819672131,6691.06697346528,371.725942970293,925.52173555869,45,44.5536989565039,0,0
transformers_4.13.0,src/transformers/models/hubert/modeling_hubert.py,1250,578,847,19,152,174,299,171,473,1182.39560479885,18.6875,65567.789226423,3642.6549570235,3508.64423954103,158,16.7935072745334,0,0
transformers_4.13.0,src/transformers/models/hubert/convert_distilhubert_original_s3prl_checkpoint_to_pytorch.py,218,134,166,8,47,42,81,55,123,285.065676028849,6.8936170212766,4902.10100645499,272.338944803055,711.107244763533,39,46.3833423324959,0,0
transformers_4.13.0,src/transformers/models/hubert/configuration_hubert.py,250,49,99,2,7,4,9,9,13,21.6514844544032,1.28571428571429,52.9830321669644,2.94350178705358,41.2090250187501,5,70.8636272880436,1,1
transformers_4.13.0,src/transformers/models/hubert/convert_hubert_original_s3prl_checkpoint_to_pytorch.py,69,33,35,2,4,2,4,6,6,10,1,15.5097750043269,0.861654166907052,15.5097750043269,4,87.0059392706859,0,0
transformers_4.13.0,src/transformers/models/lxmert/modeling_lxmert.py,1448,708,982,16,148,154,275,164,429,1130.99909811308,14.8648648648649,46919.3079862064,2606.62822145591,3156.38980998116,183,13.6308968333312,0,0
transformers_4.13.0,src/transformers/models/lxmert/convert_lxmert_original_tf_checkpoint_to_pytorch.py,61,20,30,1,2,1,2,3,3,2,0.5,2.37744375108173,0.13208020839343,4.75488750216347,2,95.8316665485003,0,0
transformers_4.13.0,src/transformers/models/lxmert/__init__.py,85,22,54,0,0,0,0,0,0,0,0,0,0,0,8,100,0,0
transformers_4.13.0,src/transformers/models/lxmert/modeling_tf_lxmert.py,1485,624,1090,13,109,110,193,122,303,785.837807736519,11.5091743119266,24169.4204308414,1342.74557949119,2100.01341328155,158,16.0942305742303,0,0
transformers_4.13.0,src/transformers/models/lxmert/tokenization_lxmert_fast.py,54,17,23,0,0,0,0,0,0,0,0,0,0,0,1,100,0,0
transformers_4.13.0,src/transformers/models/lxmert/configuration_lxmert.py,177,41,69,0,0,0,0,0,0,0,0,0,0,0,2,100,0,0
transformers_4.13.0,src/transformers/models/lxmert/tokenization_lxmert.py,50,15,18,0,0,0,0,0,0,0,0,0,0,0,1,100,0,0
transformers_4.13.0,src/transformers/models/blenderbot_small/__init__.py,87,26,56,0,0,0,0,0,0,0,0,0,0,0,10,100,0,0
transformers_4.13.0,src/transformers/models/blenderbot_small/modeling_flax_blenderbot_small.py,1525,587,1156,14,138,138,248,152,386,1034.27934394419,12.5797101449275,35194.2553264384,1955.23640702435,2797.70002018922,138,15.9263648496442,0,0
transformers_4.13.0,src/transformers/models/blenderbot_small/tokenization_blenderbot_small.py,236,139,152,10,39,30,54,49,84,239.349967484501,6.92307692307692,3265.16972473161,181.398318040645,471.635626905678,33,55.4503088162839,0,0
transformers_4.13.0,src/transformers/models/blenderbot_small/modeling_blenderbot_small.py,1571,560,995,16,156,185,331,172,516,1200.52274614251,16.974358974359,65044.9392330308,3613.60773516837,3831.95261342628,184,17.1916378109603,0,0
transformers_4.13.0,src/transformers/models/blenderbot_small/configuration_blenderbot_small.py,164,34,69,0,0,0,0,0,0,0,0,0,0,0,2,100,0,0
transformers_4.13.0,src/transformers/models/blenderbot_small/modeling_tf_blenderbot_small.py,1511,491,1062,14,161,143,253,175,396,1233.58058628526,11,32457.4756031416,1803.19308906342,2950.6796002856,154,20.5854361795135,0,0
transformers_4.13.0,src/transformers/models/blenderbot_small/tokenization_blenderbot_small_fast.py,117,34,67,3,25,16,32,28,48,120.851292246532,1.92,443.045829616829,24.6136572009349,230.753036258765,6,78.0985641451551,0,0
transformers_4.13.0,src/transformers/models/electra/convert_electra_original_tf_checkpoint_to_pytorch.py,79,26,47,1,5,3,6,6,9,11.6096404744368,0.6,13.9587975038942,0.775488750216347,23.2646625064904,4,87.0576457325654,0,0
transformers_4.13.0,src/transformers/models/electra/modeling_electra.py,1489,686,1118,16,177,210,364,193,574,1385.76618236469,16.4519774011299,71698.8747362099,3983.27081867833,4358.07033939188,190,7.26640116011836,1,1
transformers_4.13.0,src/transformers/models/electra/configuration_electra.py,175,31,59,0,0,0,0,0,0,0,0,0,0,0,2,100,0,0
transformers_4.13.0,src/transformers/models/electra/tokenization_electra_fast.py,75,17,43,0,0,0,0,0,0,0,0,0,0,0,1,100,0,0
transformers_4.13.0,src/transformers/models/electra/__init__.py,121,26,88,0,0,0,0,0,0,0,0,0,0,0,10,100,0,0
transformers_4.13.0,src/transformers/models/electra/modeling_flax_electra.py,1153,485,848,12,83,80,133,95,213,572.147822810449,9.6144578313253,13454.2727369933,747.459596499628,1399.37924457449,97,25.2737263512907,0,0
transformers_4.13.0,src/transformers/models/electra/modeling_tf_electra.py,1779,629,1327,12,138,136,235,150,371,1023.99592504404,10.2173913043478,27401.9372839515,1522.32984910841,2681.89173417397,173,12.4504825482923,0,0
transformers_4.13.0,src/transformers/models/electra/tokenization_electra.py,66,15,33,0,0,0,0,0,0,0,0,0,0,0,1,100,0,0
transformers_4.13.0,src/transformers/models/auto/configuration_auto.py,629,174,454,11,63,37,72,74,109,414.622382985505,6.28571428571429,4254.36262022235,236.353478901242,676.830416853556,58,48.2753977916205,2,1
transformers_4.13.0,src/transformers/models/auto/auto_factory.py,620,178,491,10,71,40,74,81,114,469.851326433706,5.2112676056338,3766.40666368554,209.244814649197,722.742900328847,63,38.5383937964424,4,1
transformers_4.13.0,src/transformers/models/auto/dynamic.py,231,83,108,7,34,22,38,41,60,192.625221056915,3.91176470588235,1257.44897049566,69.8582761386476,321.453120277085,16,66.3675752464294,1,1
transformers_4.13.0,src/transformers/models/auto/processing_auto.py,176,47,70,4,13,8,14,17,22,56.1057163358342,2.15384615384615,193.682854631555,10.7601585906419,89.9241825075075,14,72.7395946027431,0,0
transformers_4.13.0,src/transformers/models/auto/__init__.py,243,25,212,0,0,0,0,0,0,0,0,0,0,0,8,100,1,1
transformers_4.13.0,src/transformers/models/auto/modeling_flax_auto.py,302,66,219,0,0,0,0,0,0,0,0,0,0,0,1,100,0,0
transformers_4.13.0,src/transformers/models/auto/feature_extraction_auto.py,178,44,71,5,15,9,15,20,24,70.2129994085646,2.5,259.315685693242,14.4064269829579,103.726274277297,14,72.9428322433657,0,0
transformers_4.13.0,src/transformers/models/auto/tokenization_auto.py,598,144,382,9,51,46,90,60,136,317.823017453527,7.94117647058824,6379.4418432572,354.413435736511,803.337121002759,121,44.3594698297368,2,1
transformers_4.13.0,src/transformers/models/auto/modeling_tf_auto.py,476,81,382,0,0,0,0,0,0,0,0,0,0,0,3,100,1,1
transformers_4.13.0,src/transformers/models/auto/modeling_auto.py,748,113,627,0,0,0,0,0,0,0,0,0,0,0,3,100,1,1
transformers_4.13.0,src/transformers/models/fsmt/tokenization_fsmt.py,516,254,295,13,84,57,110,97,167,585.06037984925,8.51190476190476,9381.69753477802,521.205418598779,1102.18544464525,60,46.9917995535965,0,0
transformers_4.13.0,src/transformers/models/fsmt/__init__.py,43,14,16,0,0,0,0,0,0,0,0,0,0,0,4,100,0,0
transformers_4.13.0,src/transformers/models/fsmt/configuration_fsmt.py,219,49,91,1,2,1,2,3,3,2,0.5,2.37744375108173,0.13208020839343,4.75488750216347,5,80.9052773489254,0,0
transformers_4.13.0,src/transformers/models/fsmt/modeling_fsmt.py,1329,518,863,19,161,155,283,180,438,1260.98824013188,16.6987577639752,54795.8323457967,3044.21290809981,3281.4316561924,151,22.6806751298252,1,1
transformers_4.13.0,src/transformers/models/fsmt/convert_fsmt_original_pytorch_checkpoint_to_pytorch.py,279,123,187,5,16,9,16,21,25,75.6096404744368,2.5,274.519838923673,15.2511021624263,109.807935569469,18,64.0675059495665,0,0
transformers_4.13.0,src/transformers/models/bert/convert_bert_pytorch_checkpoint_to_original_tf.py,113,48,61,4,7,4,7,11,11,27.6514844544032,2,76.1074956100206,4.2281942005567,38.0537478050103,6,80.2857168365976,0,0
transformers_4.13.0,src/transformers/models/bert/tokenization_bert_fast.py,259,48,149,5,29,17,34,34,51,152.491089333136,2.93103448275862,760.487979890352,42.2493322161307,259.460604903767,9,74.3951381894473,0,0
transformers_4.13.0,src/transformers/models/bert/__init__.py,136,26,104,0,0,0,0,0,0,0,0,0,0,0,10,100,0,0
transformers_4.13.0,src/transformers/models/bert/modeling_tf_bert.py,2173,729,1628,12,166,178,303,178,481,1267.27609561224,10.9518072289157,39380.8126781688,2187.82292656493,3595.82778029484,204,6.2359816016733,1,1
transformers_4.13.0,src/transformers/models/bert/convert_bert_original_tf_checkpoint_to_pytorch.py,61,20,30,1,2,1,2,3,3,2,0.5,2.37744375108173,0.13208020839343,4.75488750216347,2,95.8316665485003,0,0
transformers_4.13.0,src/transformers/models/bert/modeling_bert.py,1881,813,1338,16,202,247,426,218,673,1610.95871951586,16.8712871287129,88202.8875067285,4900.16041704047,5227.98805057487,231,2.30396858246834,1,1
transformers_4.13.0,src/transformers/models/bert/convert_bert_original_tf2_checkpoint_to_pytorch.py,240,157,173,11,43,40,79,54,119,271.3831322572,10.1046511627907,6919.98455216542,384.443586231412,684.831612757453,40,53.1050670290195,0,0
transformers_4.13.0,src/transformers/models/bert/modeling_flax_bert.py,1222,502,919,11,78,82,134,89,216,528.315120876266,9.44871794871795,13216.4737992616,734.248544403421,1398.75842108874,97,21.6354998379092,1,1
transformers_4.13.0,src/transformers/models/bert/tokenization_bert.py,555,238,329,17,137,84,172,154,256,1041.91726366685,10.6715328467153,19852.2243223282,1102.90135124046,1860.2973544179,86,42.5064436919505,0,0
transformers_4.13.0,src/transformers/models/bert/configuration_bert.py,175,38,82,0,0,0,0,0,0,0,0,0,0,0,4,100,0,0
transformers_4.13.0,src/transformers/models/xlm/modeling_tf_xlm.py,1431,504,1074,16,154,136,246,170,382,1183.08512726701,12.7792207792208,36170.1446779601,2009.45248210889,2830.3873376046,141,19.7107675247256,0,0
transformers_4.13.0,src/transformers/models/xlm/configuration_xlm.py,229,47,94,1,2,1,2,3,3,2,0.5,2.37744375108173,0.13208020839343,4.75488750216347,3,81.1001262196804,0,0
transformers_4.13.0,src/transformers/models/xlm/__init__.py,89,18,60,0,0,0,0,0,0,0,0,0,0,0,6,100,0,0
transformers_4.13.0,src/transformers/models/xlm/convert_xlm_original_pytorch_checkpoint_to_pytorch.py,79,39,42,7,26,17,32,33,49,141.862917126072,4.30769230769231,1064.75518950151,59.1530660834171,247.175311848564,9,75.8971003499922,0,0
transformers_4.13.0,src/transformers/models/xlm/modeling_xlm.py,1296,548,928,19,174,201,354,193,555,1375.78279103311,19.3275862068966,81442.8466900263,4524.60259389035,4213.81365568378,153,18.7110410170124,1,1
transformers_4.13.0,src/transformers/models/xlm/tokenization_xlm.py,973,307,731,13,111,75,146,124,221,802.285877500696,8.54954954954955,13139.6093511813,729.978297287853,1536.8773845955,71,37.891772539873,0,0
transformers_4.13.0,src/transformers/models/bartpho/tokenization_bartpho.py,304,104,133,6,62,38,74,68,112,384.669946248313,3.58064516129032,2441.26896911046,135.62605383947,681.795838220038,30,60.0887915178248,0,0
transformers_4.13.0,src/transformers/models/bartpho/__init__.py,36,11,11,0,0,0,0,0,0,0,0,0,0,0,4,100,0,0
transformers_4.13.0,src/transformers/models/layoutxlm/__init__.py,54,19,25,0,0,0,0,0,0,0,0,0,0,0,8,100,0,0
transformers_4.13.0,src/transformers/models/layoutxlm/tokenization_layoutxlm_fast.py,694,229,462,15,158,117,227,173,344,1212.60071714611,10.7753164556962,27558.0023278337,1531.00012932409,2557.51211030703,96,39.1631409083258,0,0
transformers_4.13.0,src/transformers/models/layoutxlm/tokenization_layoutxlm.py,1061,375,699,18,250,193,360,268,553,2066.50472119148,12.96,57808.693297308,3211.59407207267,4460.54732232315,129,28.5693267519336,0,0
transformers_4.13.0,src/transformers/models/layoutxlm/processing_layoutxlm.py,207,43,90,4,12,12,23,16,35,51.0195500086539,3.83333333333333,536.666666666667,29.8148148148148,140,19,72.7455351246506,0,0
transformers_4.13.0,src/transformers/models/layoutlmv2/tokenization_layoutlmv2_fast.py,808,233,566,15,152,110,216,167,326,1160.28834097755,10.6578947368421,25654.4862561934,1425.24923645519,2407.08759934654,93,38.686715171311,0,0
transformers_4.13.0,src/transformers/models/layoutlmv2/tokenization_layoutlmv2.py,1493,532,1081,19,333,239,466,352,705,2871.04361899016,13.2942942942943,79285.8323179389,4404.76846210772,5963.89929113929,199,12.3403648026252,0,0
transformers_4.13.0,src/transformers/models/layoutlmv2/__init__.py,71,24,42,0,0,0,0,0,0,0,0,0,0,0,8,100,0,0
transformers_4.13.0,src/transformers/models/layoutlmv2/processing_layoutlmv2.py,207,43,90,4,12,12,23,16,35,51.0195500086539,3.83333333333333,536.666666666667,29.8148148148148,140,19,72.5876078414293,0,0
transformers_4.13.0,src/transformers/models/layoutlmv2/configuration_layoutlmv2.py,224,41,115,2,3,3,4,5,7,6.75488750216347,1.33333333333333,21.6713288856154,1.20396271586752,16.2534966642115,8,83.4251242615713,0,0
transformers_4.13.0,src/transformers/models/layoutlmv2/feature_extraction_layoutlmv2.py,226,78,88,10,38,27,51,48,78,232.64052645973,6.71052631578947,2923.28695103536,162.404830613076,435.62707505625,38,60.270253081797,0,0
transformers_4.13.0,src/transformers/models/layoutlmv2/modeling_layoutlmv2.py,1360,643,1002,17,219,215,373,236,588,1772.16523435391,14.4771689497717,67101.5928554567,3727.86626974759,4634.99411302476,151,13.2117657962214,0,0
transformers_4.13.0,src/transformers/models/camembert/__init__.py,99,25,66,0,0,0,0,0,0,0,0,0,0,0,10,100,0,0
transformers_4.13.0,src/transformers/models/camembert/modeling_camembert.py,160,37,86,0,0,0,0,0,0,0,0,0,0,0,1,100,0,0
transformers_4.13.0,src/transformers/models/camembert/tokenization_camembert.py,287,98,124,8,69,41,80,77,121,445.488187517694,4.63768115942029,3516.66630225662,195.370350125368,758.281171424083,29,59.9248730986728,0,0
transformers_4.13.0,src/transformers/models/camembert/configuration_camembert.py,52,17,22,0,0,0,0,0,0,0,0,0,0,0,2,100,0,0
transformers_4.13.0,src/transformers/models/camembert/tokenization_camembert_fast.py,206,56,92,5,35,24,45,40,69,191.134546067511,3.21428571428571,1180.3276239018,65.5737568834336,367.213038547228,14,69.7329286529425,0,0
transformers_4.13.0,src/transformers/models/camembert/modeling_tf_camembert.py,162,32,89,0,0,0,0,0,0,0,0,0,0,0,1,100,0,0
transformers_4.13.0,src/transformers/models/perceiver/convert_perceiver_haiku_to_pytorch.py,468,287,363,11,97,99,185,108,284,678.245293497162,10.4896907216495,20123.2973350534,1117.96096305852,1918.38805061443,74,35.3993637229935,0,0
transformers_4.13.0,src/transformers/models/perceiver/configuration_perceiver.py,171,36,66,0,0,0,0,0,0,0,0,0,0,0,2,100,0,0
transformers_4.13.0,src/transformers/models/perceiver/__init__.py,72,18,44,0,0,0,0,0,0,0,0,0,0,0,6,100,0,0
transformers_4.13.0,src/transformers/models/perceiver/modeling_perceiver.py,3118,1215,2046,18,307,344,617,325,961,2611.52176755461,18.0879478827362,145044.87310999,8058.04850611055,8018.8683675071,340,0,0,0
transformers_4.13.0,src/transformers/models/perceiver/tokenization_perceiver.py,204,81,103,7,54,31,62,61,93,330.415409571231,4.01851851851852,2216.44833721031,123.136018733906,551.558572393348,31,64.1591254800178,0,0
transformers_4.13.0,src/transformers/models/perceiver/feature_extraction_perceiver.py,189,58,80,11,42,25,49,53,74,264.531079561718,6.41666666666667,2719.80756250843,151.100420139357,423.866113637677,26,66.3135074122574,0,0
transformers_4.13.0,src/transformers/models/wav2vec2/convert_wav2vec2_original_pytorch_checkpoint_to_pytorch.py,260,140,207,10,58,51,94,68,145,372.982178666273,8.10344827586207,7152.76883846915,397.376046581619,882.682111981299,43,44.3315218039184,0,0
transformers_4.13.0,src/transformers/models/wav2vec2/tokenization_wav2vec2.py,592,232,335,12,59,41,77,71,118,390.095489921002,7.83050847457627,5682.36633842233,315.68701880124,725.670160101553,87,45.3862992952626,0,0
transformers_4.13.0,src/transformers/models/wav2vec2/modeling_tf_wav2vec2.py,1620,688,1158,20,214,191,341,234,532,1743.11249698759,15.9345794392523,66718.6263789283,3706.5903543849,4187.03403081837,186,8.76328106735993,0,0
transformers_4.13.0,src/transformers/models/wav2vec2/__init__.py,96,24,64,0,0,0,0,0,0,0,0,0,0,0,8,100,1,1
transformers_4.13.0,src/transformers/models/wav2vec2/convert_wav2vec2_original_s3prl_checkpoint_to_pytorch.py,69,33,35,2,4,2,4,6,6,10,1,15.5097750043269,0.861654166907052,15.5097750043269,4,87.0059392706859,0,0
transformers_4.13.0,src/transformers/models/wav2vec2/feature_extraction_wav2vec2.py,235,60,100,11,37,23,43,48,66,230.803522333281,6.39189189189189,2356.09945064207,130.894413924559,368.607525047596,26,65.8129988648042,0,0
transformers_4.13.0,src/transformers/models/wav2vec2/modeling_flax_wav2vec2.py,1279,536,881,18,122,132,234,140,366,920.608605208634,17.2622950819672,45042.8101010583,2502.37833894768,2609.31758420186,104,23.572411487876,0,0
transformers_4.13.0,src/transformers/models/wav2vec2/modeling_wav2vec2.py,1775,790,1140,19,230,261,444,249,705,1885.17333447263,18.3391304347826,102915.557153789,5717.53095298829,5611.801362108,196,9.41577594107062,0,0
transformers_4.13.0,src/transformers/models/wav2vec2/processing_wav2vec2.py,153,42,37,1,2,2,2,3,4,2,0.5,3.16992500144231,0.176106944524573,6.33985000288463,11,53.3134471842511,0,0
transformers_4.13.0,src/transformers/models/wav2vec2/configuration_wav2vec2.py,307,61,123,2,9,5,11,11,16,30.5293250129808,1.22222222222222,67.6511072089072,3.75839484493929,55.3509058981968,6,67.9512258039845,1,1
transformers_4.13.0,src/transformers/models/tapas/convert_tapas_original_tf_checkpoint_to_pytorch.py,136,58,90,3,12,9,17,15,26,47.7744375108174,2.125,215.855705407371,11.9919836337428,101.579155485821,8,73.1621935747151,0,0
transformers_4.13.0,src/transformers/models/tapas/__init__.py,79,18,50,0,0,0,0,0,0,0,0,0,0,0,6,100,0,0
transformers_4.13.0,src/transformers/models/tapas/tokenization_tapas.py,2779,1211,1815,21,579,396,771,600,1167,5405.96457837412,13.9818652849741,150585.128314849,8365.84046193603,10770.0314118087,439,0,0,0
transformers_4.13.0,src/transformers/models/tapas/modeling_tapas.py,2427,911,1386,21,326,286,519,347,805,2813.92404415768,16.7162576687117,113557.34031136,6308.74112840888,6793.2274413255,221,7.94043604950482,0,0
transformers_4.13.0,src/transformers/models/tapas/modeling_tf_tapas.py,2398,789,1448,16,259,218,392,275,610,2140.35334651082,12.1081081081081,59850.445737374,3325.02476318744,4943.00556313134,176,15.5269446452815,0,0
transformers_4.13.0,src/transformers/models/tapas/configuration_tapas.py,232,48,89,0,0,0,0,0,0,0,0,0,0,0,4,100,0,0
transformers_4.13.0,src/transformers/models/mpnet/configuration_mpnet.py,116,23,40,0,0,0,0,0,0,0,0,0,0,0,2,100,0,0
transformers_4.13.0,src/transformers/models/mpnet/__init__.py,97,22,66,0,0,0,0,0,0,0,0,0,0,0,8,100,0,0
transformers_4.13.0,src/transformers/models/mpnet/modeling_mpnet.py,1085,506,810,16,129,158,273,145,431,968.4483159496,16.9302325581395,52391.295705949,2910.62753921939,3094.54081779644,124,18.3455230791237,0,0
transformers_4.13.0,src/transformers/models/mpnet/tokenization_mpnet_fast.py,209,61,97,6,35,21,42,41,63,195.034680597401,3.6,1215.09279464738,67.5051552581879,337.525776290939,14,69.4095727911187,0,0
transformers_4.13.0,src/transformers/models/mpnet/tokenization_mpnet.py,526,246,290,17,137,85,174,154,259,1041.91726366685,10.7956204379562,20318.4125479207,1128.8006971067,1882.09771403998,93,41.6211469117344,0,0
transformers_4.13.0,src/transformers/models/mpnet/modeling_tf_mpnet.py,1364,514,1025,13,114,111,195,127,306,827.055177950615,11.1184210526316,23777.1605191931,1320.9533621774,2138.53751415228,123,19.8399535879004,0,0
transformers_4.13.0,src/transformers/models/led/modeling_tf_led.py,2556,844,1734,17,288,289,516,305,805,2422.42526871664,15.2291666666667,101173.379938594,5620.74332992189,6643.39567312245,194,8.80125719110236,0,0
transformers_4.13.0,src/transformers/models/led/__init__.py,69,22,38,0,0,0,0,0,0,0,0,0,0,0,8,100,0,0
transformers_4.13.0,src/transformers/models/led/tokenization_led_fast.py,53,14,22,0,0,0,0,0,0,0,0,0,0,0,1,100,0,0
transformers_4.13.0,src/transformers/models/led/tokenization_led.py,51,12,20,0,0,0,0,0,0,0,0,0,0,0,1,100,0,0
transformers_4.13.0,src/transformers/models/led/modeling_led.py,2702,971,1698,18,324,384,681,342,1065,2777.17005096058,18.9166666666667,169588.16122802,9421.56451266778,8965.01292835348,252,0.86119669200315,0,0
transformers_4.13.0,src/transformers/models/led/configuration_led.py,165,35,74,0,0,0,0,0,0,0,0,0,0,0,2,100,0,0
transformers_4.13.0,src/transformers/models/megatron_gpt2/__init__.py,17,0,0,0,0,0,0,0,0,0,0,0,0,0,1,100,0,0
transformers_4.13.0,src/transformers/models/megatron_gpt2/convert_megatron_gpt2_checkpoint.py,347,155,195,12,72,52,103,84,155,487.2541501125,8.58333333333333,8504.44563788857,472.469202104921,990.809200530708,35,55.175408749639,0,0
transformers_4.13.0,src/transformers/models/dialogpt/__init__.py,0,0,0,0,0,0,0,0,0,0,0,0,0,0,1,100,0,0
transformers_4.13.0,src/transformers/models/dialogpt/convert_dialogpt_original_pytorch_checkpoint_to_pytorch.py,46,20,23,1,2,1,2,3,3,2,0.5,2.37744375108173,0.13208020839343,4.75488750216347,3,95.7118246627005,0,0
transformers_4.13.0,src/transformers/models/bert_generation/configuration_bert_generation.py,115,20,37,0,0,0,0,0,0,0,0,0,0,0,2,100,0,0
transformers_4.13.0,src/transformers/models/bert_generation/__init__.py,57,17,28,0,0,0,0,0,0,0,0,0,0,0,6,100,0,0
transformers_4.13.0,src/transformers/models/bert_generation/tokenization_bert_generation.py,165,68,81,4,10,6,10,14,16,41.2192809488736,2,121.835357505843,6.76863097254685,60.9176787529217,17,74.4719783785131,0,0
transformers_4.13.0,src/transformers/models/bert_generation/modeling_bert_generation.py,587,259,383,8,68,67,120,76,187,437.947473205023,7.05882352941176,8247.26431774553,458.181350985863,1168.36244501395,78,41.4488472632416,1,1
transformers_4.13.0,src/transformers/models/bertweet/__init__.py,35,9,10,0,0,0,0,0,0,0,0,0,0,0,2,100,0,0
transformers_4.13.0,src/transformers/models/bertweet/tokenization_bertweet.py,762,276,410,17,109,73,137,126,210,807.218959701941,10.6834862385321,15653.7515494705,869.652863859474,1465.22878393498,64,45.2168436426475,0,0
transformers_4.13.0,src/transformers/models/encoder_decoder/configuration_encoder_decoder.py,118,33,34,2,5,3,6,7,9,13.6096404744368,1.2,30.3194331582221,1.68441295323456,25.2661942985184,5,68.0917789240025,0,0
transformers_4.13.0,src/transformers/models/encoder_decoder/modeling_tf_encoder_decoder.py,707,228,464,11,84,70,130,95,200,575.008411318426,8.51190476190476,11184.3970475158,621.355391528655,1313.97112166619,97,39.346466034619,0,0
transformers_4.13.0,src/transformers/models/encoder_decoder/__init__.py,52,21,22,0,0,0,0,0,0,0,0,0,0,0,8,100,0,0
transformers_4.13.0,src/transformers/models/encoder_decoder/modeling_encoder_decoder.py,576,168,367,11,68,59,111,79,170,452.001221010033,8.97794117647059,9621.1453669053,534.508075939184,1071.64272719011,67,47.5991238419746,0,0
transformers_4.13.0,src/transformers/models/encoder_decoder/modeling_flax_encoder_decoder.py,882,249,593,11,83,70,131,94,201,567.182020606805,8.68072289156627,11436.6124674022,635.367359300122,1317.47235918721,73,40.8888445074606,0,0
transformers_4.13.0,src/transformers/models/byt5/tokenization_byt5.py,245,103,122,12,76,46,91,88,137,517.862041030366,7.18421052631579,6357.61057812246,353.20058767347,884.94213175331,39,59.249974211716,0,0
transformers_4.13.0,src/transformers/models/byt5/__init__.py,34,9,10,0,0,0,0,0,0,0,0,0,0,0,2,100,0,0
transformers_4.13.0,src/transformers/models/byt5/convert_byt5_original_tf_checkpoint_to_pytorch.py,59,19,29,1,2,1,2,3,3,2,0.5,2.37744375108173,0.13208020839343,4.75488750216347,2,96.2791507216953,0,0
transformers_4.13.0,src/transformers/models/bert_japanese/tokenization_bert_japanese.py,349,140,222,7,33,22,42,40,64,186.116490393232,4.45454545454545,1517.23331868789,84.2907399271049,340.603398072791,45,56.0515039990749,0,0
transformers_4.13.0,src/transformers/models/bert_japanese/__init__.py,35,9,10,0,0,0,0,0,0,0,0,0,0,0,2,100,0,0
transformers_4.13.0,src/transformers/models/sew_d/configuration_sew_d.py,280,56,113,2,7,4,9,9,13,21.6514844544032,1.28571428571429,52.9830321669644,2.94350178705358,41.2090250187501,5,70.2440478434164,0,0
transformers_4.13.0,src/transformers/models/sew_d/__init__.py,52,13,26,0,0,0,0,0,0,0,0,0,0,0,4,100,0,0
transformers_4.13.0,src/transformers/models/sew_d/convert_sew_d_original_pytorch_checkpoint_to_pytorch.py,312,189,249,10,66,55,103,76,158,432.149292826532,7.8030303030303,7702.93729952886,427.940961084937,987.172547124087,52,39.6010391222251,0,0
transformers_4.13.0,src/transformers/models/sew_d/modeling_sew_d.py,1666,841,1159,21,294,329,558,315,887,2502.94233526024,19.9285714285714,146702.136138168,8150.11867434268,7361.39751230952,229,0.816135818278033,0,0
transformers_4.13.0,src/transformers/models/speech_to_text_2/modeling_speech_to_text_2.py,938,369,535,16,132,134,239,148,373,993.860023755316,14.4848484848485,38951.5841930742,2163.97689961523,2689.1261053796,116,33.0907601482741,0,0
transformers_4.13.0,src/transformers/models/speech_to_text_2/tokenization_speech_to_text_2.py,264,143,169,11,46,33,62,57,95,292.137597783633,7.41304347826087,4107.74939149711,228.208299527617,554.124551345651,38,53.9547360099891,0,0
transformers_4.13.0,src/transformers/models/speech_to_text_2/configuration_speech_to_text_2.py,142,31,59,0,0,0,0,0,0,0,0,0,0,0,2,100,0,0
transformers_4.13.0,src/transformers/models/speech_to_text_2/__init__.py,56,15,29,0,0,0,0,0,0,0,0,0,0,0,4,100,0,0
transformers_4.13.0,src/transformers/models/speech_to_text_2/processing_speech_to_text_2.py,144,40,36,1,2,2,2,3,4,2,0.5,3.16992500144231,0.176106944524573,6.33985000288463,10,56.3084642504396,0,0
transformers_4.13.0,src/transformers/models/cpm/__init__.py,43,15,15,0,0,0,0,0,0,0,0,0,0,0,6,100,0,0
transformers_4.13.0,src/transformers/models/cpm/tokenization_cpm.py,109,27,29,0,0,0,0,0,0,0,0,0,0,0,6,100,0,0
transformers_4.13.0,src/transformers/models/cpm/tokenization_cpm_fast.py,114,26,34,0,0,0,0,0,0,0,0,0,0,0,7,100,0,0
transformers_4.13.0,src/transformers/models/m2m_100/__init__.py,54,14,26,0,0,0,0,0,0,0,0,0,0,0,4,100,0,0
transformers_4.13.0,src/transformers/models/m2m_100/configuration_m2m_100.py,154,33,65,0,0,0,0,0,0,0,0,0,0,0,2,100,0,0
transformers_4.13.0,src/transformers/models/m2m_100/tokenization_m2m_100.py,385,163,214,9,61,38,74,70,112,390.304302604317,5.45901639344262,3747.50392458983,208.194662477213,686.479697897836,43,54.8869803390963,0,0
transformers_4.13.0,src/transformers/models/m2m_100/convert_m2m100_original_checkpoint_to_pytorch.py,85,32,57,1,2,1,2,3,3,2,0.5,2.37744375108173,0.13208020839343,4.75488750216347,3,87.0424626911172,0,0
transformers_4.13.0,src/transformers/models/m2m_100/modeling_m2m_100.py,1382,515,905,17,171,190,340,188,530,1337.93964834674,16.9005847953216,67668.7938252318,3759.3774347351,4003.93209138915,162,19.7720640237765,0,0
transformers_4.13.0,src/transformers/models/unispeech/modeling_unispeech.py,1549,695,1003,19,184,222,372,203,594,1465.04602266992,19.2065217391304,87451.3179131057,4858.4065507281,4553.209534808,169,15.0052826792624,0,0
transformers_4.13.0,src/transformers/models/unispeech/configuration_unispeech.py,290,58,117,2,7,4,9,9,13,21.6514844544032,1.28571428571429,52.9830321669644,2.94350178705358,41.2090250187501,5,69.950384011411,0,0
transformers_4.13.0,src/transformers/models/unispeech/convert_unispeech_original_pytorch_checkpoint_to_pytorch.py,191,105,143,9,52,46,88,61,134,324.952190356318,7.61538461538462,6052.08934770071,336.227185983373,794.718803233427,37,50.2369184221863,0,0
transformers_4.13.0,src/transformers/models/unispeech/__init__.py,53,13,28,0,0,0,0,0,0,0,0,0,0,0,4,100,0,0
transformers_4.13.0,src/transformers/models/ctrl/configuration_ctrl.py,129,31,52,0,0,0,0,0,0,0,0,0,0,0,2,100,0,0
transformers_4.13.0,src/transformers/models/ctrl/modeling_tf_ctrl.py,918,354,706,12,110,108,177,122,285,788.969118496367,9.65454545454545,19070.2388178196,1059.45771210109,1975.26014120542,88,26.0917094991659,0,0
transformers_4.13.0,src/transformers/models/ctrl/__init__.py,73,18,44,0,0,0,0,0,0,0,0,0,0,0,6,100,0,0
transformers_4.13.0,src/transformers/models/ctrl/modeling_ctrl.py,725,326,532,13,111,125,212,124,337,802.285877500696,12.4144144144144,29093.9766468047,1616.33203593359,2343.56415660038,85,29.8815234176934,0,0
transformers_4.13.0,src/transformers/models/ctrl/tokenization_ctrl.py,260,128,181,10,37,28,51,47,79,225.969055477145,6.89189189189189,3024.24844370395,168.013802427997,438.812519282533,31,54.6981427225606,0,0
transformers_4.13.0,src/transformers/models/speech_to_text/configuration_speech_to_text.py,191,42,86,1,2,1,2,3,3,2,0.5,2.37744375108173,0.13208020839343,4.75488750216347,3,84.568135697887,0,0
transformers_4.13.0,src/transformers/models/speech_to_text/modeling_speech_to_text.py,1408,532,918,17,184,194,348,201,542,1453.82226821575,16.0760869565217,66665.4429845595,3703.63572136441,4146.87001661898,171,18.3562298524976,0,0
transformers_4.13.0,src/transformers/models/speech_to_text/feature_extraction_speech_to_text.py,256,76,126,10,27,18,32,37,50,161.601243507287,5.92592592592593,1543.54173796413,85.7523187757852,260.472668281447,31,66.5454003400036,0,0
transformers_4.13.0,src/transformers/models/speech_to_text/__init__.py,71,25,39,0,0,0,0,0,0,0,0,0,0,0,10,100,0,0
transformers_4.13.0,src/transformers/models/speech_to_text/convert_s2t_fairseq_to_tfms.py,112,44,79,2,5,3,6,7,9,13.6096404744368,1.2,30.3194331582221,1.68441295323456,25.2661942985184,8,75.6449163315573,0,0
transformers_4.13.0,src/transformers/models/speech_to_text/processing_speech_to_text.py,144,39,35,1,2,2,2,3,4,2,0.5,3.16992500144231,0.176106944524573,6.33985000288463,10,54.6778733426424,0,0
transformers_4.13.0,src/transformers/models/speech_to_text/tokenization_speech_to_text.py,281,121,152,6,42,27,52,48,79,241.987106761035,3.71428571428571,1638.78756806875,91.0437537815973,441.212037556971,31,60.5637731507777,0,0
transformers_4.13.0,src/transformers/models/mobilebert/modeling_mobilebert.py,1602,737,1159,15,161,196,336,176,532,1238.88097631058,15.6521739130435,62114.3627652789,3450.79793140438,3968.41762111504,199,7.61793547344175,1,1
transformers_4.13.0,src/transformers/models/mobilebert/tokenization_mobilebert_fast.py,55,19,19,0,0,0,0,0,0,0,0,0,0,0,1,100,0,0
transformers_4.13.0,src/transformers/models/mobilebert/tokenization_mobilebert.py,50,17,14,0,0,0,0,0,0,0,0,0,0,0,1,100,0,0
transformers_4.13.0,src/transformers/models/mobilebert/__init__.py,105,22,74,0,0,0,0,0,0,0,0,0,0,0,8,100,0,0
transformers_4.13.0,src/transformers/models/mobilebert/configuration_mobilebert.py,165,38,63,0,0,0,0,0,0,0,0,0,0,0,3,100,0,0
transformers_4.13.0,src/transformers/models/mobilebert/convert_mobilebert_original_tf_checkpoint_to_pytorch.py,56,19,30,1,2,1,2,3,3,2,0.5,2.37744375108173,0.13208020839343,4.75488750216347,2,96.3329637870449,0,0
transformers_4.13.0,src/transformers/models/mobilebert/modeling_tf_mobilebert.py,1821,664,1383,14,132,129,225,146,354,983.162992664122,11.9318181818182,30368.8385060875,1687.15769478264,2545.19789384353,177,10.4362719261781,1,1
transformers_4.13.0,src/transformers/models/mmbt/__init__.py,41,13,14,0,0,0,0,0,0,0,0,0,0,0,4,100,0,0
transformers_4.13.0,src/transformers/models/mmbt/modeling_mmbt.py,407,129,291,7,29,36,63,36,99,160.532933313103,7.60344827586207,3891.61647651672,216.20091536204,511.822575142789,30,52.5861944673831,0,0
transformers_4.13.0,src/transformers/models/mmbt/configuration_mmbt.py,42,10,8,0,0,0,0,0,0,0,0,0,0,0,3,100,0,0
transformers_4.13.0,src/transformers/models/unispeech_sat/convert_unispeech_sat_original_pytorch_checkpoint_to_pytorch.py,220,114,170,10,58,52,97,68,149,372.982178666273,8.36206896551724,7584.66383143027,421.370212857237,907.031963346301,40,48.1166859548255,0,0
transformers_4.13.0,src/transformers/models/unispeech_sat/__init__.py,53,13,28,0,0,0,0,0,0,0,0,0,0,0,4,100,0,0
transformers_4.13.0,src/transformers/models/unispeech_sat/modeling_unispeech_sat.py,1540,692,992,19,181,218,367,200,585,1438.18272831749,19.2624309392265,86134.9623994751,4785.27568885973,4471.65587101821,170,15.1097249393001,0,0
transformers_4.13.0,src/transformers/models/unispeech_sat/configuration_unispeech_sat.py,284,57,115,2,7,4,9,9,13,21.6514844544032,1.28571428571429,52.9830321669644,2.94350178705358,41.2090250187501,5,70.1785720189385,0,0
transformers_4.13.0,src/transformers/models/marian/configuration_marian.py,161,34,67,0,0,0,0,0,0,0,0,0,0,0,2,100,0,0
transformers_4.13.0,src/transformers/models/marian/__init__.py,75,25,45,0,0,0,0,0,0,0,0,0,0,0,10,100,0,0
transformers_4.13.0,src/transformers/models/marian/tokenization_marian.py,347,145,174,7,39,26,50,46,76,225.782170990031,4.48717948717949,1883.67625680919,104.648680933844,419.790708660333,48,57.1655599016026,0,0
transformers_4.13.0,src/transformers/models/marian/modeling_flax_marian.py,1496,597,1127,16,146,146,263,162,409,1113.71438559648,14.4109589041096,43261.6791923447,2403.42662179693,3001.99865117981,141,15.2900657749833,0,0
transformers_4.13.0,src/transformers/models/marian/modeling_tf_marian.py,1559,528,1093,17,188,164,295,205,459,1489.74957241665,13.3377659574468,47014.042683112,2611.89126017289,3524.881365673,167,17.5441728337989,1,1
transformers_4.13.0,src/transformers/models/marian/modeling_marian.py,1593,581,1011,18,167,194,349,185,543,1308.13726686913,18.8083832335329,76917.6380715125,4273.20211508403,4089.54013306036,191,15.618049603492,1,1
transformers_4.13.0,src/transformers/models/marian/convert_marian_to_pytorch.py,648,377,499,13,134,86,153,147,239,994.961667857176,7.42164179104478,12770.5800083478,709.476667130433,1720.72169041589,85,27.2345615623658,0,0
transformers_4.13.0,src/transformers/models/marian/convert_marian_tatoeba_to_pytorch.py,1324,228,1238,11,115,81,150,126,231,825.285103663614,7.17391304347826,11562.5662732261,642.364792957003,1611.75166232848,71,27.1973364267182,0,0
transformers_4.13.0,src/transformers/models/xlm_roberta/tokenization_xlm_roberta_fast.py,218,55,104,5,35,24,45,40,69,191.134546067511,3.21428571428571,1180.3276239018,65.5737568834336,367.213038547228,14,70.8470469743344,0,0
transformers_4.13.0,src/transformers/models/xlm_roberta/modeling_tf_xlm_roberta.py,176,36,96,0,0,0,0,0,0,0,0,0,0,0,1,100,0,0
transformers_4.13.0,src/transformers/models/xlm_roberta/__init__.py,107,25,74,0,0,0,0,0,0,0,0,0,0,0,10,100,0,0
transformers_4.13.0,src/transformers/models/xlm_roberta/configuration_xlm_roberta.py,59,21,28,0,0,0,0,0,0,0,0,0,0,0,3,100,0,0
transformers_4.13.0,src/transformers/models/xlm_roberta/tokenization_xlm_roberta.py,309,99,133,7,69,41,80,76,121,441.139671972097,4.05797101449275,3067.82295877491,170.434608820828,755.999229126674,29,60.0669260756351,0,0
transformers_4.13.0,src/transformers/models/xlm_roberta/modeling_xlm_roberta.py,163,36,89,0,0,0,0,0,0,0,0,0,0,0,1,100,0,0
transformers_4.13.0,src/transformers/models/detr/modeling_detr.py,2260,1001,1261,21,318,300,542,339,842,2735.73544565878,17.8962264150943,126653.904956506,7036.32805313923,7077.1291119608,243,3.87923171200577,0,0
transformers_4.13.0,src/transformers/models/detr/configuration_detr.py,202,51,88,0,0,0,0,0,0,0,0,0,0,0,4,100,0,0
transformers_4.13.0,src/transformers/models/detr/__init__.py,59,17,30,0,0,0,0,0,0,0,0,0,0,0,6,100,0,0
transformers_4.13.0,src/transformers/models/detr/convert_detr_original_pytorch_checkpoint_to_pytorch.py,278,177,206,7,30,26,43,37,69,166.858202322659,5.01666666666667,1803.25228251246,100.180682361803,359.452282228398,33,51.970656651581,0,0
transformers_4.13.0,src/transformers/models/detr/feature_extraction_detr.py,935,517,531,21,224,193,338,245,531,1841.08616841926,15.84375,66771.1830007642,3709.51016670912,4214.35474561037,152,23.79166863389,0,0
transformers_4.13.0,src/transformers/models/beit/modeling_flax_beit.py,922,431,679,15,134,107,198,149,305,1005.45931045547,11.0820895522388,24401.0589711218,1355.61438728455,2201.84639874096,87,26.2106300101587,0,0
transformers_4.13.0,src/transformers/models/beit/configuration_beit.py,178,39,71,0,0,0,0,0,0,0,0,0,0,0,2,100,0,0
transformers_4.13.0,src/transformers/models/beit/__init__.py,78,21,46,0,0,0,0,0,0,0,0,0,0,0,8,100,0,0
transformers_4.13.0,src/transformers/models/beit/convert_beit_unilm_to_pytorch.py,370,222,286,6,78,93,109,84,202,505.771148075582,4.19230769230769,5413.30942364395,300.739412424664,1291.24811940131,51,41.4068310533378,0,0
transformers_4.13.0,src/transformers/models/beit/modeling_beit.py,1236,577,770,16,181,170,307,197,477,1421.47210556206,13.5690607734807,49333.2882382043,2740.73823545579,3635.71871788069,144,22.2094988980803,0,0
transformers_4.13.0,src/transformers/models/beit/feature_extraction_beit.py,224,77,112,6,38,29,56,44,85,214.931020515183,4.42105263157895,2051.59693458265,113.977607476814,464.05168758417,44,63.0796813593936,0,0
transformers_4.13.0,src/transformers/models/transfo_xl/modeling_transfo_xl.py,1270,694,879,20,246,235,428,266,663,2040.2971302112,17.3983739837398,92918.6652450228,5162.14806916793,5340.65225473729,203,8.74884938401323,0,0
transformers_4.13.0,src/transformers/models/transfo_xl/tokenization_transfo_xl.py,794,475,515,19,154,116,229,173,345,1199.79575002244,14.1266233766234,36234.0365563778,2013.00203090988,2564.94673853467,151,23.4315088428166,0,0
transformers_4.13.0,src/transformers/models/transfo_xl/modeling_transfo_xl_utilities.py,248,167,151,15,59,63,113,74,176,405.679298846476,14.364406779661,15698.3400680884,872.130003782688,1092.8637923507,35,52.7007862679462,0,0
transformers_4.13.0,src/transformers/models/transfo_xl/__init__.py,81,18,52,0,0,0,0,0,0,0,0,0,0,0,6,100,0,0
transformers_4.13.0,src/transformers/models/transfo_xl/modeling_tf_transfo_xl.py,1206,503,873,18,146,122,218,164,340,1124.77303562244,13.4383561643836,33616.9574742509,1867.60874856949,2501.56768157015,114,24.0786548459391,0,0
transformers_4.13.0,src/transformers/models/transfo_xl/modeling_tf_transfo_xl_utilities.py,178,111,136,12,43,38,73,55,111,276.348934460844,10.1860465116279,6536.70108260795,363.150060144886,641.730928201237,24,54.1419115615541,0,0
transformers_4.13.0,src/transformers/models/transfo_xl/convert_transfo_xl_original_tf_checkpoint_to_pytorch.py,120,55,83,2,10,6,12,12,18,35.2192809488736,1.2,77.435190015577,4.30195500086539,64.5293250129808,5,73.9412456902997,0,0
transformers_4.13.0,src/transformers/models/transfo_xl/configuration_transfo_xl.py,188,50,84,3,9,5,9,12,14,33.2842125151443,1.5,75.2842125151443,4.18245625084135,50.1894750100962,5,75.6485691060952,0,0
transformers_4.13.0,src/transformers/models/mt5/modeling_mt5.py,113,25,36,0,0,0,0,0,0,0,0,0,0,0,1,100,2,1
transformers_4.13.0,src/transformers/models/mt5/modeling_tf_mt5.py,92,19,15,0,0,0,0,0,0,0,0,0,0,0,1,100,1,1
transformers_4.13.0,src/transformers/models/mt5/__init__.py,79,32,44,0,0,0,0,0,0,0,0,0,0,0,10,100,1,1
transformers_4.13.0,src/transformers/models/mt5/modeling_flax_mt5.py,78,15,12,0,0,0,0,0,0,0,0,0,0,0,1,100,0,0
transformers_4.13.0,src/transformers/models/mt5/configuration_mt5.py,127,32,62,1,2,1,2,3,3,2,0.5,2.37744375108173,0.13208020839343,4.75488750216347,6,88.9528897847805,0,0
transformers_4.13.0,src/transformers/sagemaker/training_args_sm.py,131,73,79,5,11,7,11,16,18,49.6633882794471,2.5,180,10,72,18,71.7251449676899,0,0
transformers_4.13.0,src/transformers/sagemaker/__init__.py,20,2,2,0,0,0,0,0,0,0,0,0,0,0,1,100,0,0
transformers_4.13.0,src/transformers/sagemaker/trainer_sm.py,30,8,12,0,0,0,0,0,0,0,0,0,0,0,2,100,0,0
transformers_4.13.0,src/transformers/utils/dummy_detectron2_objects.py,14,8,8,0,0,0,0,0,0,0,0,0,0,0,3,100,0,0
transformers_4.13.0,src/transformers/utils/logging.py,265,120,110,6,16,9,17,22,26,79.5097750043269,3.1875,369.575395394566,20.5319664108092,115.94522208457,12,67.6160360947956,0,0
transformers_4.13.0,src/transformers/utils/hp_naming.py,162,110,113,9,40,22,44,49,66,241.406448808475,4.95,1834.32570607244,101.906983670691,370.570849711604,34,53.9592253299035,0,0
transformers_4.13.0,src/transformers/utils/sentencepiece_model_pb2.py,1183,52,1136,4,7,4,7,11,11,27.6514844544032,2,76.1074956100206,4.2281942005567,38.0537478050103,3,59.7715234238029,0,0
transformers_4.13.0,src/transformers/utils/dummy_sentencepiece_and_tokenizers_objects.py,9,4,4,0,0,0,0,0,0,0,0,0,0,0,1,100,0,0
transformers_4.13.0,src/transformers/utils/dummy_timm_objects.py,32,20,20,0,0,0,0,0,0,0,0,0,0,0,7,100,0,0
transformers_4.13.0,src/transformers/utils/fx.py,596,320,399,13,85,60,115,98,175,592.903945907539,8.79411764705882,10179.8438998038,565.546883322432,1157.57422272016,96,35.1601830586784,0,0
transformers_4.13.0,src/transformers/utils/dummy_timm_and_vision_objects.py,53,34,34,0,0,0,0,0,0,0,0,0,0,0,13,100,0,0
transformers_4.13.0,src/transformers/utils/dummy_tokenizers_objects.py,398,265,265,0,0,0,0,0,0,0,0,0,0,0,89,100,1,1
transformers_4.13.0,src/transformers/utils/__init__.py,38,10,19,3,7,4,8,10,12,24.4063719565667,1.71428571428571,68.3368065233972,3.79648925129984,39.8631371386484,3,94.7534470658042,0,0
transformers_4.13.0,src/transformers/utils/versions.py,120,56,66,6,14,10,17,20,27,68.8127439131334,3.64285714285714,425.092499047136,23.6162499470631,116.692058561959,17,74.1057024075281,0,0
transformers_4.13.0,src/transformers/utils/dummy_sentencepiece_objects.py,200,133,133,0,0,0,0,0,0,0,0,0,0,0,45,100,0,0
transformers_4.13.0,src/transformers/utils/dummy_vision_objects.py,79,49,49,0,0,0,0,0,0,0,0,0,0,0,17,100,0,0
transformers_4.13.0,src/transformers/utils/notebook.py,355,210,216,18,107,76,150,125,226,796.395617570884,12.6168224299065,19862.250329443,1103.45835163572,1574.26724833363,71,45.8552905458437,0,0
transformers_4.13.0,src/transformers/utils/dummy_speech_objects.py,7,4,4,0,0,0,0,0,0,0,0,0,0,0,2,100,0,0
transformers_4.13.0,src/transformers/utils/dummy_flax_objects.py,1439,943,943,0,0,0,0,0,0,0,0,0,0,0,347,100,0,0
transformers_4.13.0,src/transformers/utils/dummy_pytorch_quantization_and_torch_objects.py,122,79,79,0,0,0,0,0,0,0,0,0,0,0,29,100,0,0
transformers_4.13.0,src/transformers/utils/dummy_sentencepiece_and_speech_objects.py,11,7,7,0,0,0,0,0,0,0,0,0,0,0,3,100,0,0
transformers_4.13.0,src/transformers/utils/dummy_pt_objects.py,5520,3542,3542,0,0,0,0,0,0,0,0,0,0,0,1260,100,3,1
transformers_4.13.0,src/transformers/utils/fx_transformations.py,321,196,206,10,47,27,52,57,79,294.284956977723,5.53191489361702,2549.09704023285,141.616502235158,460.798311119015,54,48.1775905262956,0,0
transformers_4.13.0,src/transformers/utils/dummy_scatter_objects.py,69,44,44,0,0,0,0,0,0,0,0,0,0,0,16,100,0,0
transformers_4.13.0,src/transformers/utils/dummy_tf_objects.py,2971,1918,1918,0,0,0,0,0,0,0,0,0,0,0,695,100,1,1
transformers_4.13.0,src/transformers/utils/model_parallel_utils.py,56,23,30,6,22,13,26,28,39,113.617270614347,3.54545454545455,664.726076040874,36.9292264467152,187.486841960247,14,81.6882403880695,1,1
transformers_4.13.0,src/transformers/pipelines/text2text_generation.py,322,124,141,11,37,30,58,48,88,230.803522333281,8.62162162162162,4237.32614379039,235.407007988355,491.476700063462,45,56.9941024501722,0,0
transformers_4.13.0,src/transformers/pipelines/text_classification.py,167,76,89,10,32,24,45,42,69,193.219280948874,7.03125,2616.11649964501,145.339805535834,372.069902171734,28,65.7613739323629,0,0
transformers_4.13.0,src/transformers/pipelines/zero_shot_classification.py,269,137,177,11,44,30,54,55,84,278.268739025051,6.75,3278.03095756848,182.112830976027,485.634215936071,48,54.8729274347232,0,0
transformers_4.13.0,src/transformers/pipelines/fill_mask.py,225,116,151,8,35,26,51,43,77,203.524905593074,5.82857142857143,2435.3076219103,135.294867883906,417.822386112062,38,56.5048579098154,1,1
transformers_4.13.0,src/transformers/pipelines/token_classification.py,466,241,333,13,85,59,109,98,168,592.903945907539,8.33529411764706,9262.77274500406,514.598485833559,1111.27125381136,83,39.0978720747457,2,1
transformers_4.13.0,src/transformers/pipelines/feature_extraction.py,80,29,26,3,7,4,8,10,12,24.4063719565667,1.71428571428571,68.3368065233972,3.79648925129984,39.8631371386484,10,71.3625601650571,0,0
transformers_4.13.0,src/transformers/pipelines/__init__.py,597,146,378,10,50,40,80,60,120,315.41209043761,8,5670.61497178418,315.034165099121,708.826871473022,79,50.6349998503178,1,1
transformers_4.13.0,src/transformers/pipelines/base.py,1118,549,643,13,155,108,201,168,309,1175.90499915334,8.42903225806452,19253.8153437025,1069.65640798347,2284.22608363864,204,18.1255538028187,1,1
transformers_4.13.0,src/transformers/pipelines/text_generation.py,248,122,154,12,62,48,92,74,140,412.17972125264,8.90322580645161,7739.78316283557,429.987953490865,869.323471188053,43,56.2461184273528,0,0
transformers_4.13.0,src/transformers/pipelines/image_classification.py,95,43,40,4,7,4,7,11,11,27.6514844544032,2,76.1074956100206,4.2281942005567,38.0537478050103,13,80.0644373367171,0,0
transformers_4.13.0,src/transformers/pipelines/conversational.py,308,147,159,11,44,31,57,55,88,278.268739025051,7.125,3624.91254037996,201.384030021109,508.75965479017,50,56.2400406628166,0,0
transformers_4.13.0,src/transformers/pipelines/object_detection.py,137,63,66,4,8,4,8,12,12,32,2,86.0391000173078,4.77995000096154,43.0195500086539,16,76.3925422792702,0,0
transformers_4.13.0,src/transformers/pipelines/table_question_answering.py,387,221,229,12,90,64,129,102,193,627.286328678325,8.6,11074.8915826043,615.271754589127,1287.7780910005,78,44.815292250147,0,0
transformers_4.13.0,src/transformers/pipelines/question_answering.py,569,271,361,17,116,88,164,133,252,865.012663736054,12.0172413793103,21365.8280707098,1186.99044837277,1777.9311737463,102,38.2703449962417,2,1
transformers_4.13.0,src/transformers/pipelines/image_segmentation.py,142,63,65,3,7,4,8,10,12,24.4063719565667,1.71428571428571,68.3368065233972,3.79648925129984,39.8631371386484,16,76.4984084131301,0,0
transformers_4.13.0,src/transformers/pipelines/audio_classification.py,159,67,83,6,11,7,12,17,19,53.5635228093372,3.27272727272727,254.165871219567,14.1203261788648,77.6617939837565,18,73.737882507317,0,0
transformers_4.13.0,src/transformers/pipelines/automatic_speech_recognition.py,181,72,89,6,15,10,17,21,27,74.1131339384547,3.4,403.21473941109,22.4008188561717,118.592570415027,19,71.2116858558915,0,0
transformers_4.13.0,src/transformers/benchmark/benchmark_utils.py,909,482,555,17,150,109,210,167,319,1153.80967187564,11.9,28029.2798646607,1557.18221470338,2355.40166929922,95,32.155084945086,0,0
transformers_4.13.0,src/transformers/benchmark/benchmark_args_tf.py,137,81,96,4,7,4,7,11,11,27.6514844544032,2,76.1074956100206,4.2281942005567,38.0537478050103,18,69.3575169518162,0,0
transformers_4.13.0,src/transformers/benchmark/__init__.py,0,0,0,0,0,0,0,0,0,0,0,0,0,0,1,100,0,0
transformers_4.13.0,src/transformers/benchmark/benchmark.py,269,154,192,5,24,14,25,29,39,121.648740491745,2.60416666666667,493.388694817644,27.4104830454247,189.461258809975,45,51.6414347320909,0,0
transformers_4.13.0,src/transformers/benchmark/benchmark_args.py,115,63,76,4,8,5,8,12,13,32,2,93.2090250187501,5.17827916770834,46.604512509375,16,72.4644323608165,0,0
transformers_4.13.0,src/transformers/benchmark/benchmark_tf.py,294,174,218,10,44,23,45,54,68,273.434272168915,5.11363636363636,2001.13133597957,111.173963109976,391.332350147116,49,46.9733196791143,0,0
transformers_4.13.0,src/transformers/benchmark/benchmark_args_utils.py,145,77,106,2,3,2,3,5,5,6.75488750216347,1,11.6096404744368,0.644980026357601,11.6096404744368,7,74.4906077778744,0,0
transformers_4.13.0,src/transformers/commands/download.py,46,20,24,0,0,0,0,0,0,0,0,0,0,0,4,100,0,0
transformers_4.13.0,src/transformers/commands/user.py,342,195,276,6,17,14,27,23,41,84.9966433055827,4.76470588235294,883.691132709726,49.093951817207,185.466040198338,37,46.5534994716881,1,1
transformers_4.13.0,src/transformers/commands/__init__.py,27,10,10,0,0,0,0,0,0,0,0,0,0,0,3,100,0,0
transformers_4.13.0,src/transformers/commands/train.py,160,69,110,3,10,7,12,13,19,37.9741684510371,1.8,126.555038360425,7.03083546446807,70.3083546446807,14,69.1557517367448,0,0
transformers_4.13.0,src/transformers/commands/transformers_cli.py,55,28,28,2,3,2,3,5,5,6.75488750216347,1,11.6096404744368,0.644980026357601,11.6096404744368,3,89.784144545772,0,0
transformers_4.13.0,src/transformers/commands/env.py,89,48,58,1,2,1,2,3,3,2,0.5,2.37744375108173,0.13208020839343,4.75488750216347,9,82.7912347660046,0,0
transformers_4.13.0,src/transformers/commands/add_new_model.py,248,135,185,10,58,45,80,68,125,372.982178666273,6.89655172413793,5247.81279418133,291.545155232296,760.932855156293,20,49.4583874907052,0,0
transformers_4.13.0,src/transformers/commands/run.py,112,48,82,4,8,5,8,12,13,32,2,93.2090250187501,5.17827916770834,46.604512509375,14,72.4118640139757,0,0
transformers_4.13.0,src/transformers/commands/serving.py,231,98,140,4,6,4,6,10,10,23.5097750043269,2,66.4385618977473,3.69103121654151,33.2192809488736,16,71.512475507482,0,0
transformers_4.13.0,src/transformers/commands/lfs.py,227,111,132,11,30,20,38,41,58,185.260465673266,6.96666666666667,2164.80817999935,120.267121111075,310.738016267849,22,62.0371576774596,0,0
transformers_4.13.0,src/transformers/commands/convert.py,185,89,139,2,14,12,24,16,36,55.3029689088065,1.71428571428571,246.857142857143,13.7142857142857,144,23,60.7346757412368,0,0
transformers_4.13.0,src/transformers/data/test_generation_utils.py,100,40,69,2,3,2,3,5,5,6.75488750216347,1,11.6096404744368,0.644980026357601,11.6096404744368,9,80.955852417045,0,0
transformers_4.13.0,src/transformers/data/__init__.py,48,3,30,0,0,0,0,0,0,0,0,0,0,0,1,100,0,0
transformers_4.13.0,src/transformers/data/data_collator.py,1531,815,891,23,410,320,585,433,905,3662.62876578654,16.4085365853659,130057.211567688,7225.40064264932,7926.19200932769,285,0,1,1
transformers_4.13.0,src/transformers/data/processors/utils.py,350,200,217,12,63,46,90,75,136,419.588185189149,8.57142857142857,7261.0229306352,403.390162813067,847.11934190744,67,47.0984731961786,0,0
transformers_4.13.0,src/transformers/data/processors/__init__.py,22,4,4,0,0,0,0,0,0,0,0,0,0,0,1,100,0,0
transformers_4.13.0,src/transformers/data/processors/glue.py,644,389,423,5,23,33,61,28,94,115.651565463748,6.6304347826087,2996.23620903025,166.457567168347,451.891362673415,118,25.0345768659233,0,0
transformers_4.13.0,src/transformers/data/processors/squad.py,843,377,583,16,176,135,254,192,389,1376.85996488016,11.5454545454545,34065.4456748297,1892.52475971276,2950.55041278053,97,31.0151930217884,1,1
transformers_4.13.0,src/transformers/data/processors/xnli.py,97,61,59,4,15,11,16,19,27,66.6033589341278,2.13333333333333,244.68062477435,13.5933680430195,114.694042862977,18,71.2018574738518,0,0
transformers_4.13.0,src/transformers/data/datasets/__init__.py,27,3,9,0,0,0,0,0,0,0,0,0,0,0,1,100,0,0
transformers_4.13.0,src/transformers/data/datasets/glue.py,161,81,112,7,22,13,25,29,38,117.758980064424,3.97727272727273,734.217582218145,40.7898656787858,184.603277814848,16,64.9264448164645,0,0
transformers_4.13.0,src/transformers/data/datasets/language_modeling.py,532,286,346,15,122,95,173,137,268,904.1533141168,10.6352459016393,20231.1368541628,1123.95204745349,1902.27259823342,90,38.1298273469292,0,0
transformers_4.13.0,src/transformers/data/datasets/squad.py,220,117,165,10,26,16,31,36,47,155.430713620542,5.96153846153846,1448.57321675028,80.4762898194599,242.986475067789,20,56.9196348090117,0,0
transformers_4.13.0,src/transformers/data/metrics/__init__.py,102,69,70,3,28,19,38,31,57,139.360825319776,2.03571428571429,574.863707587391,31.936872643744,282.389189692052,16,64.5138069170747,0,0
transformers_4.13.0,src/transformers/data/metrics/squad_metrics.py,776,471,529,18,165,132,243,183,375,1290.50181537652,13.2545454545455,37356.4444234709,2075.35802352616,2818.38743935652,128,23.7898803983716,0,0
transformers_4.13.0,src/transformers/onnx/utils.py,63,17,14,3,5,3,6,8,9,16.3645279766003,1.8,48.6,2.7,27,3,60.177625047033,0,0
transformers_4.13.0,src/transformers/onnx/features.py,158,60,117,4,12,6,12,16,18,51.0195500086539,2,144,8,72,13,67.2250876143415,0,0
transformers_4.13.0,src/transformers/onnx/__init__.py,18,3,3,0,0,0,0,0,0,0,0,0,0,0,1,100,0,0
transformers_4.13.0,src/transformers/onnx/__main__.py,71,30,42,3,5,3,5,8,8,16.3645279766003,1.5,36,2,24,5,85.7538021708379,0,0
transformers_4.13.0,src/transformers/onnx/config.py,318,125,149,6,23,14,28,29,42,119.551699993638,3.65217391304348,745.172041339569,41.3984467410871,204.035201795358,33,62.4303461220206,0,0
transformers_4.13.0,src/transformers/onnx/convert.py,241,102,138,6,17,12,18,23,30,84.9966433055827,3.17647058823529,431.068845224257,23.9482691791254,135.70685868171,21,66.7521121072396,0,0
transformers_4.13.0,tests/test_modeling_tf_xlnet.py,795,173,705,3,18,14,25,21,39,79.8135375281251,2.08333333333333,356.875790600774,19.8264328111541,171.300379488372,33,44.9527401015508,0,0
transformers_4.13.0,tests/test_modeling_tf_vit.py,390,235,275,6,56,34,61,62,95,340.721650639553,3.26785714285714,1848.45897957278,102.692165531821,565.648649486753,39,43.6833010919162,0,0
transformers_4.13.0,tests/test_modeling_mbart.py,657,358,516,11,51,44,72,62,116,327.347440245557,7.76470588235294,5362.97964144964,297.943313413869,690.686772004878,62,31.6586839249689,0,0
transformers_4.13.0,tests/test_modeling_tf_mobilebert.py,341,187,277,3,14,12,15,17,27,58.0578564109699,1.60714285714286,177.366691147113,9.8537050637285,110.361496713759,27,46.4735680329632,0,0
transformers_4.13.0,tests/test_modeling_m2m_100.py,379,202,285,7,38,35,49,45,84,219.072729965259,4.51315789473684,2081.99041330856,115.666134072698,461.315660091693,32,45.2162930161259,0,0
transformers_4.13.0,tests/test_modeling_tf_openai.py,285,146,226,3,7,5,10,10,15,24.4063719565667,2.14285714285714,106.776260192808,5.932014455156,49.8289214233104,32,54.5479954877805,0,0
transformers_4.13.0,tests/test_modeling_tf_bart.py,478,265,375,10,69,53,91,79,144,454.707468466567,6.59420289855072,5985.85093652991,332.547274251662,907.744427737503,64,33.7510823328698,0,0
transformers_4.13.0,tests/test_modeling_tf_auto.py,311,170,238,3,8,6,9,11,15,28.7548875021635,1.6875,87.5668628467566,4.8648257137087,51.8914742795595,39,52.2836489161359,0,0
transformers_4.13.0,tests/test_modeling_tf_blenderbot_small.py,337,190,254,9,45,35,65,54,100,275.662714347816,6.5,3740.67687640626,207.81538202257,575.488750216347,50,42.5252827831451,0,0
transformers_4.13.0,tests/test_modeling_flax_blenderbot.py,417,195,336,7,41,41,66,48,107,239.311116643745,5.63414634146341,3366.91507634939,187.050837574966,597.590987577164,33,40.3263691662469,0,0
transformers_4.13.0,tests/test_modeling_tf_rembert.py,371,165,293,2,14,13,14,16,27,55.3029689088065,1,108,6,108,28,50.26048103259,0,0
transformers_4.13.0,tests/test_modeling_imagegpt.py,539,289,400,10,38,36,69,48,105,232.64052645973,9.07894736842105,5324.08596285852,295.78255349214,586.421062575722,66,36.2480756163672,0,0
transformers_4.13.0,tests/test_file_utils.py,134,72,79,1,3,2,4,4,6,4.75488750216347,0.666666666666667,8,0.444444444444444,12,12,78.6297647329173,0,0
transformers_4.13.0,tests/test_tokenization_dpr.py,89,50,57,2,26,13,26,28,39,124.211432671668,1,187.486841960247,10.4159356644581,187.486841960247,3,71.6404531367886,0,0
transformers_4.13.0,tests/test_modeling_bigbird_pegasus.py,772,407,579,11,107,92,138,118,230,759.390715349933,7.09345794392523,11228.9999731504,623.833331841691,1583.00790135322,62,30.421635487785,0,0
transformers_4.13.0,tests/test_modeling_flax_vision_encoder_decoder.py,521,263,384,9,49,44,65,58,109,303.650107374626,5.96938775510204,3811.57304239091,211.754057910606,638.519928468905,43,38.4745856144754,0,0
transformers_4.13.0,tests/test_pipelines_feature_extraction.py,107,55,78,6,426,442,448,432,890,3736.49607322053,3.15492957746479,24582.7376398776,1365.70764665987,7791.84987692549,16,56.7099949783876,0,0
transformers_4.13.0,tests/test_tokenization_speech_to_text.py,164,98,111,4,19,25,47,23,72,88.7106227554281,4.94736842105263,1611.34038518915,89.5189102882862,325.696460836105,16,59.3444782312058,0,0
transformers_4.13.0,tests/test_modeling_bart.py,968,498,779,12,70,61,94,82,155,472.069361194802,8.05714285714286,7939.67423205304,441.093012891836,985.420560715803,86,22.7426256222241,0,0
transformers_4.13.0,tests/test_modeling_openai.py,267,130,211,2,4,2,4,6,6,10,1,15.5097750043269,0.861654166907052,15.5097750043269,25,60.9978704466741,0,0
transformers_4.13.0,tests/test_tokenization_cpm.py,39,17,17,1,2,1,2,3,3,2,0.5,2.37744375108173,0.13208020839343,4.75488750216347,2,96.5421274873175,0,0
transformers_4.13.0,tests/test_tokenization_prophetnet.py,206,106,144,2,13,7,14,15,21,50.1057163358342,1.07692307692308,88.3558334699157,4.90865741499532,82.0447025077789,23,56.9284967272063,0,0
transformers_4.13.0,tests/test_modeling_distilbert.py,294,164,238,2,6,8,9,8,17,17.5097750043269,1.5,76.5,4.25,51,29,50.3619845009157,0,0
transformers_4.13.0,tests/test_tokenization_barthez.py,118,64,75,2,2,2,2,4,4,4,1,8,0.444444444444444,8,9,78.325742048599,0,0
transformers_4.13.0,tests/test_tokenization_small_blenderbot.py,87,53,54,4,14,8,15,18,23,61.3029689088065,2.14285714285714,205.517732213943,11.4176517896635,95.9082750331732,11,73.4486972401928,0,0
transformers_4.13.0,tests/test_modeling_roformer.py,558,233,463,4,70,73,82,74,155,437.049811186148,2.34285714285714,2254.91863648983,125.273257582768,962.465271672487,38,35.3865651335957,0,0
transformers_4.13.0,tests/test_modeling_tf_pegasus.py,374,216,280,10,45,35,65,55,100,280.352670283709,7.22222222222222,4175.42645976781,231.968136653767,578.135971352466,53,41.4556247892639,0,0
transformers_4.13.0,tests/test_modeling_tf_wav2vec2.py,574,337,402,9,61,43,74,70,117,390.304302604317,5.45901639344262,3914.80320693759,217.489067052088,717.126112982561,64,34.0388499809899,0,0
transformers_4.13.0,tests/test_tokenization_m2m_100.py,240,146,169,4,16,12,20,20,32,72,2.5,345.754247590989,19.2085693106105,138.301699036396,29,54.8093590995752,0,0
transformers_4.13.0,tests/test_modeling_flax_clip.py,587,370,428,7,27,16,29,34,45,148.033447012817,3.75925925925926,860.629130644849,47.8127294802694,228.935827856265,70,34.9671123653605,0,0
transformers_4.13.0,tests/test_modeling_flax_vision_text_dual_encoder.py,395,216,278,5,15,11,18,20,29,70.2129994085646,3,376.007744255201,20.8893191252889,125.335914751734,33,46.6691979457257,0,0
transformers_4.13.0,tests/test_modeling_visual_bert.py,687,370,545,8,91,88,131,99,219,616.209312258081,5.75824175824176,8359.98294828413,464.443497126896,1451.82909979743,75,23.5741322586273,0,0
transformers_4.13.0,tests/test_tokenization_fnet.py,443,196,335,5,25,16,29,30,45,127.706045218805,2.9,640.349222726912,35.5749568181618,220.810076802383,24,47.5900249441635,0,0
transformers_4.13.0,tests/test_tokenization_xlm_prophetnet.py,157,54,115,2,14,23,43,16,66,55.3029689088065,3.07142857142857,810.857142857143,45.0476190476191,264,11,65.1479928822928,0,0
transformers_4.13.0,tests/test_tokenization_mpnet.py,82,36,52,2,19,10,20,21,30,82.7106227554281,1.05263157894737,138.704760719329,7.70582003996274,131.769522683363,8,75.8529576303579,0,0
transformers_4.13.0,tests/test_tokenization_xlm_roberta.py,272,86,214,3,14,22,42,17,64,58.0578564109699,4.5,1177.1892982801,65.3994054600054,261.597621840022,15,59.3316927445273,0,0
transformers_4.13.0,tests/test_modeling_gpt2.py,773,396,609,10,59,62,98,69,160,380.295220861222,8.30508474576271,8117.09012561709,450.949451423172,977.363913084507,60,29.6254491625269,0,0
transformers_4.13.0,tests/test_skip_decorators.py,120,48,48,2,4,2,4,6,6,10,1,15.5097750043269,0.861654166907052,15.5097750043269,11,79.4504276353346,0,0
transformers_4.13.0,tests/test_onnx.py,195,116,116,2,4,3,6,6,9,10,1.5,34.8969937597356,1.93872187554087,23.2646625064904,24,70.021195390472,0,0
transformers_4.13.0,tests/test_modeling_sew.py,554,316,399,12,115,92,134,127,226,830.250905867257,6.99130434782609,11042.3648897848,613.464716099155,1579.44273921051,69,32.0047365279349,0,0
transformers_4.13.0,tests/test_onnx_v2.py,279,118,177,5,8,6,11,13,17,35.6096404744368,3.4375,216.24444602887,12.0135803349372,62.9074752083986,17,67.3458787535068,0,0
transformers_4.13.0,tests/test_modeling_fsmt.py,539,299,428,9,43,31,50,52,81,261.858709465171,5.23255813953488,2416.05846193306,134.225470107392,461.735617169429,57,36.600737504696,0,0
transformers_4.13.0,tests/test_generation_flax_logits_process.py,301,184,183,8,48,32,58,56,90,292.078200034615,4.83333333333333,2526.19939109506,140.344410616392,522.661942985184,11,56.472235582206,0,0
transformers_4.13.0,tests/test_modeling_blenderbot.py,537,284,408,10,50,42,70,60,112,315.41209043761,7,4631.00222695708,257.277901497616,661.571746708154,50,36.8905880912708,0,0
transformers_4.13.0,tests/test_tokenization_phobert.py,67,38,37,1,2,1,2,3,3,2,0.5,2.37744375108173,0.13208020839343,4.75488750216347,6,87.9566623776468,0,0
transformers_4.13.0,tests/test_modeling_tf_electra.py,268,158,209,1,1,1,1,2,2,0,0.5,1,0.055555555555556,2,28,61.5750974621756,0,0
transformers_4.13.0,tests/test_tokenization_bert_generation.py,243,76,191,3,16,22,43,19,65,68.7548875021635,4.03125,1113.08975625701,61.8383197920564,276.115288373833,12,57.6356869253777,0,0
transformers_4.13.0,tests/test_doc_samples.py,114,63,72,5,10,9,18,15,27,44.8289214233104,4.5,474.687207366435,26.3715115203575,105.48604608143,25,70.6891589129412,0,0
transformers_4.13.0,tests/test_modeling_unispeech.py,584,325,420,13,79,53,95,92,148,546.104395441825,7.81645569620253,7546.68768562089,419.260426978938,965.487169496438,73,32.8337942261841,0,0
transformers_4.13.0,tests/test_modeling_fnet.py,559,280,394,5,24,25,29,29,54,121.648740491745,3.02083333333333,792.458149830186,44.0254527683436,262.330973736889,45,46.0408820740923,0,0
transformers_4.13.0,tests/test_modeling_flax_t5.py,610,320,429,7,68,47,76,75,123,433.598957659426,3.91176470588235,2996.97779287712,166.498766270951,766.144698930993,49,39.9221023985467,0,0
transformers_4.13.0,tests/test_generation_flax_utils.py,276,181,175,9,29,24,33,38,57,169.41077387168,5.12068965517241,1531.76146336356,85.0978590757533,299.131868266284,30,48.9808517686598,0,0
transformers_4.13.0,tests/test_versions_utils.py,97,51,50,0,0,0,0,0,0,0,0,0,0,0,14,100,0,0
transformers_4.13.0,tests/test_modeling_beit.py,526,308,382,12,93,67,97,105,164,651.161319441701,6.25806451612903,6890.9817867763,382.832321487572,1101.13626489724,54,36.2383409025171,0,0
transformers_4.13.0,tests/test_modeling_vision_encoder_decoder.py,725,339,582,6,68,65,89,74,154,429.45724820935,3.92647058823529,3754.71034541075,208.595019189486,956.255818306859,39,33.2814920610298,0,0
transformers_4.13.0,tests/test_generation_stopping_criteria.py,94,54,65,2,4,2,4,6,6,10,1,15.5097750043269,0.861654166907052,15.5097750043269,8,52.79696608104,0,0
transformers_4.13.0,tests/test_modeling_flax_common.py,839,558,592,11,80,51,92,91,143,543.807995395999,6.325,5886.13755719372,327.007642066318,930.614633548414,114,23.6268131303732,0,0
transformers_4.13.0,tests/test_pipelines_object_detection.py,256,86,210,0,0,0,0,0,0,0,0,0,0,0,13,100,0,0
transformers_4.13.0,tests/test_modeling_flax_gpt_neo.py,331,200,249,4,28,41,59,32,100,142.605937817613,4.21428571428571,2107.14285714286,117.063492063492,500,31,44.2767079531036,0,0
transformers_4.13.0,tests/test_modeling_tf_lxmert.py,797,379,662,8,50,44,66,58,110,306.192809488736,5.28,3402.31536197009,189.01752010945,644.377909464033,65,27.8208120192322,0,0
transformers_4.13.0,tests/test_modeling_tf_funnel.py,409,190,333,2,5,3,5,7,8,13.6096404744368,1,22.4588393764608,1.24771329869227,22.4588393764608,35,50.9683608612844,0,0
transformers_4.13.0,tests/test_feature_extraction_detr.py,338,180,225,5,6,7,13,11,20,27.1194154787637,5.41666666666667,374.771758685707,20.8206532603171,69.188632372746,44,57.1247529472894,0,0
transformers_4.13.0,tests/test_modeling_tf_mbart.py,345,204,265,9,41,30,59,50,89,248.188957202322,6.47560975609756,3252.719508202,180.706639344555,502.303200889951,52,41.6712089444519,0,0
transformers_4.13.0,tests/test_trainer.py,1700,1056,1265,17,190,149,285,207,434,1507.75943388414,12.75,42571.9100793225,2365.10611551792,3338.97333955471,152,8.27057082944898,0,0
transformers_4.13.0,tests/test_modeling_flax_marian.py,489,261,388,6,37,39,62,43,101,208.259549532598,5.02702702702703,2755.07593734685,153.059774297048,548.052740224912,40,35.6684979770651,0,0
transformers_4.13.0,tests/test_modeling_deberta.py,283,147,229,1,6,6,6,7,12,15.5097750043269,0.5,16.8441295323456,0.935784974019201,33.6882590646913,27,53.1848430530355,0,0
transformers_4.13.0,tests/test_pipelines_common.py,422,237,314,11,35,22,42,46,64,217.578653398084,6.6,2333.15257023848,129.619587235471,353.507965187649,43,44.6674254357853,0,0
transformers_4.13.0,tests/test_modeling_bert.py,623,289,525,3,13,17,20,16,37,52.8606038379977,2.30769230769231,341.538461538461,18.974358974359,148,52,36.902962793425,0,0
transformers_4.13.0,tests/test_optimization_tf.py,100,70,71,2,5,11,12,7,23,13.6096404744368,2.4,154.96599169758,8.60922176097665,64.5691632073249,7,68.7952418304477,0,0
transformers_4.13.0,tests/test_modeling_tf_dpr.py,258,122,208,2,7,5,7,9,12,21.6514844544032,1,38.0391000173078,2.11328333429488,38.0391000173078,25,56.8006297316709,0,0
transformers_4.13.0,tests/test_modeling_flax_roberta.py,140,56,108,0,0,0,0,0,0,0,0,0,0,0,11,100,0,0
transformers_4.13.0,tests/test_pipelines_automatic_speech_recognition.py,243,145,180,2,4,2,4,6,6,10,1,15.5097750043269,0.861654166907052,15.5097750043269,17,60.8566302090572,0,0
transformers_4.13.0,tests/test_modeling_bort.py,51,21,28,1,6,6,6,7,12,15.5097750043269,0.5,16.8441295323456,0.935784974019201,33.6882590646913,3,89.2976983630154,0,0
transformers_4.13.0,tests/test_feature_extraction_vit.py,191,71,137,0,0,0,0,0,0,0,0,0,0,0,16,100,0,0
transformers_4.13.0,tests/test_cli.py,32,12,12,0,0,0,0,0,0,0,0,0,0,0,2,100,0,0
transformers_4.13.0,tests/test_tokenization_bart.py,185,110,140,5,15,10,18,20,28,70.2129994085646,3,363.041959970538,20.168997776141,121.013986656846,20,58.4096474645695,0,0
transformers_4.13.0,tests/test_modeling_xlnet.py,1070,282,932,10,70,53,100,80,153,462.269092135021,7.14285714285714,6908.9642751269,383.831348618161,967.254998517766,62,31.2929411469869,0,0
transformers_4.13.0,tests/test_processor_layoutxlm.py,423,225,266,2,4,8,9,6,17,10,2.25,98.8748156525842,5.49304531403246,43.9443625122597,24,59.7189438713422,0,0
transformers_4.13.0,tests/test_data_collator.py,856,645,652,6,77,75,133,83,208,498.052338637834,5.18181818181818,6871.13340891356,381.729633828531,1326.00820172016,79,20.9007614169351,0,0
transformers_4.13.0,tests/test_modeling_tf_bert.py,418,215,343,3,14,10,15,17,25,58.0578564109699,1.60714285714286,164.228417728808,9.12380098493379,102.186571031259,47,41.0061040905037,0,0
transformers_4.13.0,tests/test_processor_speech_to_text.py,148,84,94,2,6,5,9,8,14,17.5097750043269,1.5,63,3.5,42,14,65.1416507976755,0,0
transformers_4.13.0,tests/test_modeling_flax_electra.py,133,60,115,1,2,1,2,3,3,2,0.5,2.37744375108173,0.13208020839343,4.75488750216347,12,54.8560925732727,0,0
transformers_4.13.0,tests/test_tokenization_gpt2.py,180,84,119,2,7,4,7,9,11,21.6514844544032,1,34.8691750158654,1.9371763897703,34.8691750158654,12,70.5692712379985,0,0
transformers_4.13.0,tests/test_modeling_blenderbot_small.py,538,278,411,10,50,42,70,60,112,315.41209043761,7,4631.00222695708,257.277901497616,661.571746708154,53,36.4298866193856,0,0
transformers_4.13.0,tests/test_modeling_perceiver.py,990,612,744,15,128,107,174,143,281,954.603358934128,10.1953125,20512.1923324478,1139.56624069154,2011.92384563473,93,20.60156127133,0,0
transformers_4.13.0,tests/test_modeling_qdqbert.py,563,247,466,2,8,14,15,10,29,26,1.875,180.6298401595,10.0349911199722,96.3359147517335,43,42.805816464294,0,0
transformers_4.13.0,tests/test_tokenization_luke.py,657,331,494,3,15,508,513,18,1021,63.3582464362913,51.3,218409.412778044,12133.8562654469,4257.4934264726,30,33.9423809799282,0,0
transformers_4.13.0,tests/test_tokenization_blenderbot.py,52,29,28,1,8,4,8,9,12,24,0.5,19.0195500086539,1.05664166714744,38.0391000173078,13,84.482816193915,0,0
transformers_4.13.0,tests/test_modeling_flax_albert.py,161,70,126,1,6,6,6,7,12,15.5097750043269,0.5,16.8441295323456,0.935784974019201,33.6882590646913,12,65.4973759716119,0,0
transformers_4.13.0,tests/test_tokenization_layoutlm.py,74,32,45,1,2,1,2,3,3,2,0.5,2.37744375108173,0.13208020839343,4.75488750216347,7,88.2410911079749,0,0
transformers_4.13.0,tests/test_trainer_tpu.py,131,70,77,4,16,10,20,20,30,72,2.5,324.144607116552,18.0080337286973,129.657842846621,15,69.709572476659,0,0
transformers_4.13.0,tests/test_modeling_unispeech_sat.py,813,442,597,12,108,87,149,120,236,772.547400242309,8.27777777777778,13492.9944946654,749.610805259191,1630.02618056361,113,21.9375968935869,0,0
transformers_4.13.0,tests/test_processor_wav2vec2_with_lm.py,236,130,158,2,6,6,8,8,14,17.5097750043269,1.33333333333333,56,3.11111111111111,42,22,59.2171933599289,0,0
transformers_4.13.0,tests/test_configuration_common.py,347,189,258,6,24,14,26,30,40,125.548875021635,3.25,637.895777429108,35.4386543016171,196.275623824341,47,48.1763503749554,0,0
transformers_4.13.0,tests/test_processor_wav2vec2.py,140,79,90,1,3,2,4,4,6,4.75488750216347,0.666666666666667,8,0.444444444444444,12,12,70.1540305706265,0,0
transformers_4.13.0,tests/test_modeling_flax_gptj.py,328,199,246,4,28,41,59,32,100,142.605937817613,4.21428571428571,2107.14285714286,117.063492063492,500,31,44.4155522518272,0,0
transformers_4.13.0,tests/test_modeling_tf_mpnet.py,262,141,212,1,6,6,6,7,12,15.5097750043269,0.5,16.8441295323456,0.935784974019201,33.6882590646913,25,53.9031805650444,0,0
transformers_4.13.0,tests/test_modeling_deberta_v2.py,283,147,229,1,5,5,5,6,10,11.6096404744368,0.5,12.9248125036058,0.71804513908921,25.8496250072116,27,53.9902448602085,0,0
transformers_4.13.0,tests/test_modeling_flax_big_bird.py,192,85,149,0,0,0,0,0,0,0,0,0,0,0,16,100,0,0
transformers_4.13.0,tests/test_modeling_reformer.py,1255,615,1079,10,170,159,236,180,395,1292.81574009228,6.94117647058824,20540.8984011721,1141.16102228734,2959.28197305022,100,13.9037211421035,0,0
transformers_4.13.0,tests/test_tokenization_xlnet.py,213,66,167,3,41,43,85,44,128,224.414519691505,3.10975609756098,2173.12009795514,120.728894330841,698.807247185574,12,57.1702745338574,0,0
transformers_4.13.0,tests/test_modeling_tf_core.py,357,217,271,12,46,31,59,58,90,297.103399987276,7.69565217391304,4057.28857619053,225.404920899474,527.218289561482,63,38.710526223929,0,0
transformers_4.13.0,tests/test_modeling_mt5.py,53,20,19,4,9,6,9,13,15,36.5293250129808,2,111.013191544233,6.16739953023515,55.5065957721164,3,81.195587443302,0,0
transformers_4.13.0,tests/test_modeling_tf_gpt2.py,487,239,376,7,25,29,45,32,74,135.747889198771,6.3,2331,129.5,370,40,43.6079592384728,0,0
transformers_4.13.0,tests/test_feature_extraction_common.py,101,48,61,3,6,6,8,9,14,20.2646625064904,2,88.7579000403848,4.93099444668804,44.3789500201924,17,75.8947998515931,0,0
transformers_4.13.0,tests/test_modeling_hubert.py,805,482,580,12,119,98,156,131,254,863.502863842299,7.86554621848739,14051.7152779623,780.650848775686,1786.48944239051,109,22.2435969726308,0,0
transformers_4.13.0,tests/test_generation_utils.py,1726,586,1433,13,152,124,184,165,308,1149.79069837926,7.86842105263158,17852.0880356401,991.782668646675,2268.82724198771,122,15.5937084531729,0,0
transformers_4.13.0,tests/test_tokenization_reformer.py,371,112,292,4,14,21,40,18,61,61.3029689088065,5.71428571428571,1453.51671478846,80.7509285993591,254.365425087981,17,54.1922593744704,0,0
transformers_4.13.0,tests/test_modeling_speech_encoder_decoder.py,549,240,454,4,22,19,29,26,48,106.107495610021,2.63636363636364,594.819280695673,33.045515594204,225.621106470772,36,40.1668635667321,0,0
transformers_4.13.0,tests/test_flax_auto.py,78,50,50,0,0,0,0,0,0,0,0,0,0,0,10,100,0,0
transformers_4.13.0,tests/test_processor_auto.py,57,26,28,0,0,0,0,0,0,0,0,0,0,0,4,100,0,0
transformers_4.13.0,tests/test_modeling_speech_to_text.py,763,419,572,13,76,69,122,89,191,522.948207357547,10.4342105263158,12905.7106928219,716.983927378994,1236.86508531458,74,29.6288826782212,0,0
transformers_4.13.0,tests/test_benchmark.py,264,125,229,0,0,0,0,0,0,0,0,0,0,0,18,100,0,0
transformers_4.13.0,tests/test_tokenization_fast.py,162,96,96,1,2,1,2,3,3,2,0.5,2.37744375108173,0.13208020839343,4.75488750216347,18,77.6615384456967,0,0
transformers_4.13.0,tests/test_modeling_flax_mt5.py,61,26,25,4,9,7,10,13,17,36.5293250129808,2.22222222222222,139.794389351997,7.76635496399982,62.9074752083986,3,82.87381844139,0,0
transformers_4.13.0,tests/test_pipelines_summarization.py,97,45,67,4,6,5,8,10,13,23.5097750043269,2.66666666666667,115.160173956095,6.39778744200529,43.1850652335357,8,75.7007030286346,0,0
transformers_4.13.0,tests/test_modeling_tf_xlm.py,367,152,306,2,4,2,4,6,6,10,1,15.5097750043269,0.861654166907052,15.5097750043269,27,54.8724116746332,0,0
transformers_4.13.0,tests/test_modeling_marian.py,771,420,607,10,52,44,72,62,116,329.64214629221,6.92307692307692,4781.67765234146,265.648758463414,690.686772004878,75,27.9678110757271,0,0
transformers_4.13.0,tests/test_pipelines_text_classification.py,95,62,64,1,6,3,6,7,9,15.5097750043269,0.5,12.6330971492592,0.701838730514401,25.2661942985184,7,74.2437197332615,0,0
transformers_4.13.0,tests/test_tokenization_utils.py,287,200,208,0,0,0,0,0,0,0,0,0,0,0,25,100,0,0
transformers_4.13.0,tests/__init__.py,0,0,0,0,0,0,0,0,0,0,0,0,0,0,1,100,0,0
transformers_4.13.0,tests/test_modeling_xlm.py,488,202,410,5,34,27,48,39,75,184.583377076948,3.52941176470588,1399.07705793412,77.7265032185625,396.405166414669,41,40.0566176542804,0,0
transformers_4.13.0,tests/test_sequence_feature_extraction_common.py,425,249,302,11,102,77,146,113,223,718.641132686103,7.87254901960784,11973.3590845169,665.186615806495,1520.89990861859,29,39.8079846506617,0,0
transformers_4.13.0,tests/test_tokenization_distilbert.py,43,17,19,2,15,8,16,17,24,60.6033589341278,1.06666666666667,104.639048736009,5.81328048533382,98.0991081900082,4,87.2856935820907,0,0
transformers_4.13.0,tests/test_tokenization_ctrl.py,66,38,37,1,4,2,4,5,6,8,0.5,6.96578428466209,0.38698801581456,13.9315685693242,5,84.8222070495732,0,0
transformers_4.13.0,tests/test_optimization.py,166,80,125,4,13,12,15,17,27,56.1057163358342,2.30769230769231,254.680377031752,14.1489098350973,110.361496713759,17,63.4495451453121,0,0
transformers_4.13.0,tests/test_modeling_mpnet.py,252,132,204,1,7,10,10,8,20,19.6514844544032,0.714285714285714,42.8571428571429,2.38095238095238,60,23,53.7757604021145,0,0
transformers_4.13.0,tests/test_feature_extraction_clip.py,229,92,165,3,6,6,8,9,14,20.2646625064904,2,88.7579000403848,4.93099444668804,44.3789500201924,26,64.73335573741,0,0
transformers_4.13.0,tests/test_tokenization_roformer.py,73,41,41,1,4,2,4,5,6,8,0.5,6.96578428466209,0.38698801581456,13.9315685693242,9,83.7280727379423,0,0
transformers_4.13.0,tests/test_modeling_tf_flaubert.py,363,157,301,3,10,8,10,13,18,37.9741684510371,1.5,99.9118723898095,5.55065957721164,66.6079149265397,27,49.8889405511798,0,0
transformers_4.13.0,tests/test_pipelines_text_generation.py,146,64,101,7,13,9,18,20,27,67.7572007902374,4.84615384615385,565.507668415646,31.4170926897581,116.692058561959,9,70.2984179777837,0,0
transformers_4.13.0,tests/test_modeling_tf_deberta_v2.py,278,135,222,1,5,5,5,6,10,11.6096404744368,0.5,12.9248125036058,0.71804513908921,25.8496250072116,24,54.9483672599128,0,0
transformers_4.13.0,tests/test_tokenization_auto.py,309,190,214,4,13,8,16,17,24,56.1057163358342,2.46153846153846,241.474727852328,13.4152626584627,98.0991081900082,39,52.596352892548,0,0
transformers_4.13.0,tests/test_modeling_ibert.py,698,429,522,13,133,124,197,146,321,986.458280257492,9.62781954887218,22220.3690345438,1234.46494636354,2307.93368340049,77,28.1945445982155,0,0
transformers_4.13.0,tests/test_tokenization_deberta.py,158,67,114,2,8,4,8,10,12,26,1,39.8631371386484,2.21461872992491,39.8631371386484,13,68.1889467371894,0,0
transformers_4.13.0,tests/test_tokenization_deberta_v2.py,140,76,87,3,13,8,14,16,22,52.8606038379977,1.61538461538462,142.153846153846,7.8974358974359,88,11,68.3781525958096,0,0
transformers_4.13.0,tests/test_modeling_roberta.py,553,254,427,4,31,34,51,35,85,161.580085621993,3.29032258064516,1434.54463731977,79.6969242955428,435.989056440322,42,41.7982571446552,0,0
transformers_4.13.0,tests/conftest.py,61,22,26,1,2,1,2,3,3,2,0.5,2.37744375108173,0.13208020839343,4.75488750216347,3,93.9272412202373,0,0
transformers_4.13.0,tests/test_modeling_megatron_gpt2.py,85,31,59,4,23,20,24,27,44,112.041924989311,2.08695652173913,436.622713242141,24.2568174023412,209.215050095193,5,75.833150506637,0,0
transformers_4.13.0,tests/test_modeling_dpr.py,311,153,249,2,27,25,27,29,52,130.381962558414,1,252.615011746634,14.0341673192574,252.615011746634,28,47.592310608828,0,0
transformers_4.13.0,tests/test_modeling_longformer.py,710,355,570,9,107,109,146,116,255,749.866292557904,6.14018691588785,10737.8677198009,596.548206655606,1748.78515375753,41,31.5748444345748,0,0
transformers_4.13.0,tests/test_modeling_tf_blenderbot.py,328,190,246,10,45,35,65,55,100,280.352670283709,7.22222222222222,4175.42645976781,231.968136653767,578.135971352466,50,42.4671342490358,0,0
transformers_4.13.0,tests/test_modeling_trocr.py,191,97,131,4,12,11,19,16,30,51.0195500086539,3.16666666666667,380,21.1111111111111,120,18,62.3454195395202,0,0
transformers_4.13.0,tests/test_modeling_vision_text_dual_encoder.py,527,285,391,5,22,19,30,27,49,109.717136084457,3.40909090909091,794.282344111398,44.1267968950777,232.98948760601,40,38.8537603032722,0,0
transformers_4.13.0,tests/test_modeling_layoutlm.py,338,163,249,2,13,27,29,15,56,50.1057163358342,2.23076923076923,488.060794405249,27.1144885780694,218.785873354077,29,52.6251979059139,0,0
transformers_4.13.0,tests/test_modeling_segformer.py,400,221,301,7,87,89,114,94,203,580.187568593243,4.58620689655172,6102.32222091188,339.017901161771,1330.58153689056,32,39.684211232683,0,0
transformers_4.13.0,tests/test_modeling_tf_tapas.py,1036,437,838,11,81,127,159,92,286,551.581598038665,10.7962962962963,20143.0680264636,1119.05933480353,1865.73871943231,62,29.3500299147194,0,0
transformers_4.13.0,tests/test_modeling_big_bird.py,905,390,742,8,341,344,359,349,703,2893.04712379724,4.21114369501466,25007.0325323298,1389.27958512943,5938.29950802539,62,22.8518818655481,0,0
transformers_4.13.0,tests/test_modeling_tf_roformer.py,401,190,320,3,65,62,70,68,132,396.208795349013,1.61538461538462,1298.03438430353,72.1130213501963,803.545095045045,30,39.3551283138475,0,0
transformers_4.13.0,tests/test_tokenization_funnel.py,83,39,53,3,14,8,16,17,24,58.0578564109699,1.71428571428571,168.1698997543,9.34277220857221,98.0991081900082,9,75.7144056765841,0,0
transformers_4.13.0,tests/test_model_output.py,109,87,78,0,0,0,0,0,0,0,0,0,0,0,8,100,0,0
transformers_4.13.0,tests/test_tokenization_mbart50.py,245,140,184,4,26,30,56,30,86,130.211432671668,4.30769230769231,1817.81423911159,100.989679950644,421.992591222333,27,51.7113756687296,0,0
transformers_4.13.0,tests/test_feature_extraction_segformer.py,335,129,255,3,18,13,25,21,38,79.8135375281251,2.08333333333333,347.725129303319,19.3180627390733,166.908062065593,19,55.9143702466775,0,0
transformers_4.13.0,tests/test_modeling_tf_common.py,1407,823,1093,18,231,173,290,249,463,1888.81267859307,11.2987012987013,41641.1477695629,2313.39709830905,3685.48089454752,196,2.86493365904049,0,0
transformers_4.13.0,tests/test_modeling_deit.py,424,252,318,11,59,38,66,70,104,385.129687717359,6.15254237288136,3921.91004162214,217.88389120123,637.445433762277,53,38.7156347176792,0,0
transformers_4.13.0,tests/test_modeling_tf_xlm_roberta.py,57,22,32,1,3,3,3,4,6,4.75488750216347,0.5,6,0.333333333333333,12,3,91.8333281749974,0,0
transformers_4.13.0,tests/test_modeling_flax_beit.py,370,214,259,5,42,30,45,47,75,238.086972231145,2.67857142857143,1115.87722466738,61.9931791481879,416.594163875823,32,46.4640936194868,0,0
transformers_4.13.0,tests/test_tokenization_bertweet.py,65,37,36,1,2,1,2,3,3,2,0.5,2.37744375108173,0.13208020839343,4.75488750216347,6,88.3550357627131,0,0
transformers_4.13.0,tests/test_modeling_tf_t5.py,698,352,488,8,49,41,65,57,106,299.120782361645,5.30612244897959,3280.70303653837,182.261279807687,618.286341501463,56,38.4888040779345,0,0
transformers_4.13.0,tests/test_modeling_ctrl.py,236,122,185,1,2,1,2,3,3,2,0.5,2.37744375108173,0.13208020839343,4.75488750216347,22,65.582507564719,0,0
transformers_4.13.0,tests/test_generation_beam_search.py,250,117,156,7,36,33,53,43,86,205.768784506326,5.15277777777778,2404.58893421563,133.58827412309,466.65876890438,15,60.0746955389596,0,0
transformers_4.13.0,tests/test_trainer_callback.py,242,150,170,8,40,31,54,48,85,236.877123795494,5.4,2563.49778783101,142.41654376839,474.721812561298,39,49.078343300673,0,0
transformers_4.13.0,tests/test_feature_extraction_deit.py,199,75,145,0,0,0,0,0,0,0,0,0,0,0,16,100,0,0
transformers_4.13.0,tests/test_pipelines_table_question_answering.py,634,221,584,0,0,0,0,0,0,0,0,0,0,0,9,100,0,0
transformers_4.13.0,tests/test_feature_extraction_wav2vec2.py,225,143,152,7,26,16,31,33,47,141.862917126072,4.17307692307692,989.380300448786,54.9655722471548,237.086523609847,32,54.151796176988,0,0
transformers_4.13.0,tests/test_feature_extraction_imagegpt.py,177,102,121,2,9,6,9,11,15,30.5293250129808,1,51.8914742795595,2.88285968219775,51.8914742795595,20,61.9797313860128,0,0
transformers_4.13.0,tests/test_modeling_tf_distilbert.py,247,141,192,1,3,3,3,4,6,4.75488750216347,0.5,6,0.333333333333333,12,25,57.717992807654,0,0
transformers_4.13.0,tests/test_tokenization_camembert.py,131,70,79,2,2,2,2,4,4,4,1,8,0.444444444444444,8,10,78.0540565331584,0,0
transformers_4.13.0,tests/test_modeling_speech_to_text_2.py,211,98,150,4,12,11,19,16,30,51.0195500086539,3.16666666666667,380,21.1111111111111,120,18,61.1378258961092,0,0
transformers_4.13.0,tests/test_tokenization_common.py,3695,2004,2688,19,470,383,718,489,1101,4252.67358764098,14.5127659574468,142747.470334318,7930.41501857323,9835.99341110241,464,0,0,0
transformers_4.13.0,tests/test_hf_argparser.py,230,176,157,1,2,2,4,3,6,2,1,9.50977500432694,0.528320833573719,9.50977500432694,18,60.6188975801628,0,0
transformers_4.13.0,tests/test_activations_tf.py,39,20,20,0,0,0,0,0,0,0,0,0,0,0,3,100,0,0
transformers_4.13.0,tests/test_modeling_tf_ctrl.py,261,142,206,3,8,6,12,11,18,28.7548875021635,2.25,140.106980554811,7.78372114193392,62.2697691354714,35,54.4444352846867,0,0
transformers_4.13.0,tests/test_modeling_squeezebert.py,287,151,235,1,3,6,6,4,12,4.75488750216347,1,24,1.33333333333333,24,26,53.4721596573275,0,0
transformers_4.13.0,tests/test_feature_extraction_layoutlmv2.py,221,84,150,0,0,0,0,0,0,0,0,0,0,0,17,100,0,0
transformers_4.13.0,tests/test_pipelines_fill_mask.py,342,151,277,2,5,3,6,7,9,13.6096404744368,1.2,30.3194331582221,1.68441295323456,25.2661942985184,26,56.4904146194455,0,0
transformers_4.13.0,tests/test_trainer_seq2seq.py,127,49,84,3,11,6,11,14,17,42.8086353071737,1.5,97.0875505124689,5.39375280624827,64.7250336749793,3,74.8232670154634,0,0
transformers_4.13.0,tests/test_modeling_sew_d.py,567,317,414,12,108,85,127,120,212,772.547400242309,7.05555555555556,10331.1734664535,573.954081469641,1464.26080626901,67,32.1915145009659,0,0
transformers_4.13.0,tests/test_tokenization_perceiver.py,288,170,195,8,31,20,41,39,61,177.580085621993,5.29032258064516,1705.65044508058,94.7583580600321,322.409535350597,38,52.6505302834714,0,0
transformers_4.13.0,tests/test_modeling_flax_blenderbot_small.py,398,181,322,6,39,40,64,45,104,221.640461539955,4.92307692307692,2811.82878532079,156.2127102956,571.152722018286,31,41.7161038985193,0,0
transformers_4.13.0,tests/test_modeling_canine.py,532,315,410,10,37,41,58,47,99,225.969055477145,7.83783783783784,4310.06070085581,239.447816714212,549.904296316086,40,38.564764760682,0,0
transformers_4.13.0,tests/test_modeling_encoder_decoder.py,960,401,798,5,32,31,49,37,80,171.609640474437,3.828125,1595.39509322387,88.6330607346592,416.756269250316,64,28.049898524099,0,0
transformers_4.13.0,tests/test_modeling_funnel.py,509,251,422,9,51,36,65,60,101,317.823017453527,5.73529411764706,3421.65324354441,190.091846863578,596.59595015646,58,34.0163590913413,0,0
transformers_4.13.0,tests/test_modeling_tf_mt5.py,56,21,20,3,6,4,6,9,10,20.2646625064904,1.5,47.5488750216347,2.64160416786859,31.6992500144231,3,82.6249340158416,0,0
transformers_4.13.0,tests/test_pipelines_question_answering.py,357,215,280,1,2,1,2,3,3,2,0.5,2.37744375108173,0.13208020839343,4.75488750216347,26,55.1704740221943,0,0
transformers_4.13.0,tests/test_tokenization_albert.py,136,76,85,4,17,10,18,21,28,77.4868683012558,2.11764705882353,260.43858600947,14.4688103338594,122.984887837805,13,66.4342129096768,0,0
transformers_4.13.0,tests/test_modeling_lxmert.py,886,401,742,10,47,45,67,57,112,294.284956977723,7.12765957446809,4656.38368790343,258.687982661302,653.283681586451,54,27.8861767657484,0,0
transformers_4.13.0,tests/test_modeling_xlm_prophetnet.py,142,70,104,1,21,21,21,22,42,92.238665878354,0.5,93.6480639913832,5.20267022174351,187.296127982766,7,65.0952507934795,0,0
transformers_4.13.0,tests/test_pipelines_text2text_generation.py,58,30,32,0,0,0,0,0,0,0,0,0,0,0,5,100,0,0
transformers_4.13.0,tests/test_tokenization_openai.py,134,51,88,1,2,1,2,3,3,2,0.5,2.37744375108173,0.13208020839343,4.75488750216347,7,82.5660618032788,0,0
transformers_4.13.0,tests/test_modeling_tf_transfo_xl.py,258,136,170,5,17,11,22,22,33,81.0965087756926,3.23529411764706,476.109905166276,26.4505502870153,147.161243415031,33,59.4353919296088,0,0
transformers_4.13.0,tests/test_tokenization_mluke.py,668,313,505,3,13,599,602,16,1201,52.8606038379977,69.4615384615385,333693.230769231,18538.5128205128,4804,29,33.3173283078597,0,0
transformers_4.13.0,tests/test_modeling_luke.py,683,295,563,4,21,21,30,25,51,100.238665878354,2.85714285714286,676.676187652888,37.5931215362716,236.836665678511,42,37.0977793749239,0,0
transformers_4.13.0,tests/test_tokenization_bert.py,301,142,222,3,19,11,20,22,31,85.4655102575916,1.57894736842105,218.277442385931,12.1265245769962,138.242380177756,33,49.0620426363046,0,0
transformers_4.13.0,tests/test_modeling_tf_longformer.py,709,364,545,10,123,112,154,133,266,887.1485651056,6.26016260162602,11748.4792556045,652.693291978028,1876.70512784332,44,31.6927448938061,0,0
transformers_4.13.0,tests/test_modeling_mobilebert.py,370,180,302,8,17,17,25,25,42,93.4868683012558,5.88235294117647,1147.30564688552,63.7392026047511,195.041959970538,33,44.8513247884715,0,0
transformers_4.13.0,tests/test_modeling_tf_roberta.py,304,167,241,1,7,7,7,8,14,19.6514844544032,0.5,21,1.16666666666667,42,29,51.1270309276494,0,0
transformers_4.13.0,tests/test_tokenization_big_bird.py,235,100,158,5,19,24,46,24,70,92.3202632298649,6.05263157894737,1942.57621741081,107.920900967267,320.947375050481,15,60.7776471481763,0,0
transformers_4.13.0,tests/test_modeling_flax_bert.py,145,56,113,0,0,0,0,0,0,0,0,0,0,0,11,100,0,0
transformers_4.13.0,tests/test_pipelines_image_classification.py,160,49,123,0,0,0,0,0,0,0,0,0,0,0,8,100,0,0
transformers_4.13.0,tests/test_pipelines_translation.py,158,91,118,0,0,0,0,0,0,0,0,0,0,0,13,100,0,0
transformers_4.13.0,tests/test_modeling_detr.py,529,319,402,8,79,66,93,87,159,521.998679105991,4.70886075949367,4823.88888471469,267.993826928594,1024.42801583995,57,32.5478551607201,0,0
transformers_4.13.0,tests/test_tokenization_speech_to_text_2.py,97,56,55,6,12,7,12,18,19,58.5293250129808,3,237.685725082212,13.2047625045673,79.2285750274039,11,74.1844631737087,0,0
transformers_4.13.0,tests/test_generation_logits_process.py,460,230,286,8,61,50,89,69,139,385.774977591336,5.83606557377049,4955.31515113461,275.295286174145,849.084899492166,17,51.2093429191565,0,0
transformers_4.13.0,tests/test_tokenization_mbart.py,251,118,200,4,26,31,56,30,87,130.211432671668,4.30769230769231,1838.95161398498,102.163978554721,426.899481817941,22,51.2448440889393,0,0
transformers_4.13.0,tests/test_modeling_xlm_roberta.py,69,30,32,1,11,11,11,12,22,38.0537478050103,0.5,39.4345875079327,2.19081041710737,78.8691750158654,4,81.9179877584145,0,0
transformers_4.13.0,tests/test_offline.py,71,22,34,0,0,0,0,0,0,0,0,0,0,0,2,100,0,0
transformers_4.13.0,tests/test_utils_check_copies.py,154,59,102,4,12,8,16,16,24,51.0195500086539,2.66666666666667,256,14.2222222222222,96,9,70.6278674541262,0,0
transformers_4.13.0,tests/test_pipelines_audio_classification.py,129,57,93,0,0,0,0,0,0,0,0,0,0,0,7,100,0,0
transformers_4.13.0,tests/test_tokenization_layoutxlm.py,1785,967,1294,15,197,215,355,212,570,1560.14756736703,13.5152284263959,59533.4278165303,3307.41265647391,4404.91465910102,200,2.64689783421502,0,0
transformers_4.13.0,tests/test_modeling_flaubert.py,447,200,372,5,19,20,26,24,46,92.3202632298649,3.42105263157895,721.528309324014,40.0849060735563,210.908275033173,35,41.3569573078783,0,0
transformers_4.13.0,tests/test_modeling_flax_gpt2.py,337,203,252,4,28,41,59,32,100,142.605937817613,4.21428571428571,2107.14285714286,117.063492063492,500,32,43.9111731510461,0,0
transformers_4.13.0,tests/test_tokenization_pegasus.py,208,122,130,4,32,21,40,36,61,168,2.5,788.413562719953,43.8007534844418,315.365425087981,36,57.6522570288847,0,0
transformers_4.13.0,tests/test_modeling_clip.py,746,438,529,13,57,32,59,70,91,380.580447143224,6.7280701754386,3752.68040994481,208.482244996934,557.764754541992,94,30.0454423802941,0,0
transformers_4.13.0,tests/test_processor_vision_text_dual_encoder.py,170,94,102,2,3,2,3,5,5,6.75488750216347,1,11.6096404744368,0.644980026357601,11.6096404744368,17,70.0161471298386,0,0
transformers_4.13.0,tests/test_tokenization_layoutlmv2.py,2423,1297,1827,18,322,325,561,340,886,2757.61388477887,15.6801242236025,116828.2209478,6490.45671932221,7450.720369418,254,0,0,0
transformers_4.13.0,tests/test_processor_layoutlmv2.py,429,227,273,2,5,9,11,7,20,13.6096404744368,2.2,123.523616570535,6.86242314280748,56.1470984411521,25,58.5605169894809,0,0
transformers_4.13.0,tests/test_feature_extraction_speech_to_text.py,250,154,184,7,30,19,36,37,55,166.858202322659,4.2,1203.38372746029,66.8546515255715,286.519935109592,35,49.5717913746422,0,0
transformers_4.13.0,tests/test_modeling_tapas.py,1084,455,874,8,76,125,153,84,278,498.842491021713,8.05263157894737,14310.043645288,795.002424738222,1777.0642435325,67,28.5448029223072,0,0
transformers_4.13.0,tests/test_retrieval_rag.py,387,214,336,5,32,23,36,37,59,171.609640474437,2.8125,864.443667859054,48.0246482143919,307.357748572108,25,44.3192641058226,0,0
transformers_4.13.0,tests/test_feature_extraction_auto.py,58,27,29,0,0,0,0,0,0,0,0,0,0,0,5,100,0,0
transformers_4.13.0,tests/test_modeling_led.py,538,299,396,11,64,51,83,75,134,422.05374780501,7.1328125,5953.48543931755,330.749191073197,834.661704526448,47,39.4708212674545,0,0
transformers_4.13.0,tests/test_tokenization_squeezebert.py,46,19,21,2,15,8,16,17,24,60.6033589341278,1.06666666666667,104.639048736009,5.81328048533382,98.0991081900082,5,86.5129404771989,0,0
transformers_4.13.0,tests/test_modeling_rag.py,1173,468,933,6,47,27,56,53,83,276.575451033176,3.57446808510638,1699.36431528573,94.4091286269849,475.417397728746,64,28.377950870849,0,0
transformers_4.13.0,tests/test_modeling_layoutlmv2.py,533,268,413,9,46,29,49,55,78,282.613174991603,4.79347826086957,2161.60012419371,120.088895788539,450.946057654924,46,40.2067740751469,0,0
transformers_4.13.0,tests/test_modeling_prophetnet.py,1293,599,1061,10,65,69,98,75,167,424.673188795723,7.53846153846154,7841.60359143504,435.644643968614,1040.21272131281,92,20.846293634907,0,0
transformers_4.13.0,tests/test_tokenization_t5.py,374,192,282,6,26,29,56,32,85,137.721207675995,6.46153846153846,2746.15384615385,152.564102564103,425,32,44.1021833785601,0,0
transformers_4.13.0,tests/test_modeling_flax_wav2vec2.py,484,236,342,12,71,50,89,83,139,479.651595493486,7.52112676056338,6664.69967367827,370.261092982126,886.130480957223,36,42.5423856048788,0,0
transformers_4.13.0,tests/test_trainer_distributed.py,143,75,95,7,25,16,30,32,46,135.747889198771,4.2,966,53.6666666666667,230,19,63.8016480137341,0,0
transformers_4.13.0,tests/test_modeling_tf_albert.py,337,182,270,3,10,7,11,13,18,37.9741684510371,1.65,109.90305962879,6.1057255349328,66.6079149265397,40,47.8254127868492,0,0
transformers_4.13.0,tests/test_modeling_gpt_neo.py,552,292,409,7,49,54,71,56,125,294.772266816048,5.07142857142857,3681.44820951866,204.524900528814,725.919365257201,43,39.1271406022623,0,0
transformers_4.13.0,tests/test_image_utils.py,436,277,289,3,37,23,44,40,67,197.504662030435,1.78378378378378,636.042325286268,35.335684738126,356.569182357453,28,48.4923985518547,0,0
transformers_4.13.0,tests/test_modeling_tf_bort.py,51,21,26,1,6,6,6,7,12,15.5097750043269,0.5,16.8441295323456,0.935784974019201,33.6882590646913,3,89.254293555947,0,0
transformers_4.13.0,tests/test_modeling_flax_distilbert.py,152,67,118,1,3,3,3,4,6,4.75488750216347,0.5,6,0.333333333333333,12,11,69.6917336443761,0,0
transformers_4.13.0,tests/test_modeling_tf_marian.py,438,268,328,9,43,34,63,52,97,261.858709465171,6.59302325581395,3645.56376811677,202.531320450931,552.942652659686,59,37.523265035316,0,0
transformers_4.13.0,tests/test_pipelines_zero_shot.py,246,105,193,2,3,2,3,5,5,6.75488750216347,1,11.6096404744368,0.644980026357601,11.6096404744368,11,64.2668931832541,0,0
transformers_4.13.0,tests/test_modeling_wav2vec2.py,1371,746,998,15,187,147,256,202,403,1469.87262293312,10.2673796791444,31687.7952775082,1760.43307097268,3086.25922754897,149,10.2262956154325,0,0
transformers_4.13.0,tests/test_modeling_splinter.py,219,108,170,0,0,0,0,0,0,0,0,0,0,0,20,100,0,0
transformers_4.13.0,tests/test_modeling_t5.py,1049,483,807,7,93,78,124,100,202,627.79325388745,4.66666666666667,6262.94176822764,347.94120934598,1342.05895033449,87,26.2436217808478,0,0
transformers_4.13.0,tests/test_modeling_tf_layoutlm.py,318,157,233,2,13,27,29,15,56,50.1057163358342,2.23076923076923,488.060794405249,27.1144885780694,218.785873354077,28,52.9858963894277,0,0
transformers_4.13.0,tests/test_pipelines_token_classification.py,758,286,664,0,0,0,0,0,0,0,0,0,0,0,28,100,0,0
transformers_4.13.0,tests/test_modeling_pegasus.py,553,284,428,10,54,44,74,64,118,343.983206065701,6.85185185185185,4851.11111111111,269.506172839506,708,53,35.9316177038952,0,0
transformers_4.13.0,tests/test_modeling_common.py,2277,1445,1636,17,265,249,411,282,660,2202.69673390565,13.1830188679245,70820.5469763752,3934.47483202084,5372.1038925832,297,0,0,0
transformers_4.13.0,tests/test_modeling_tf_led.py,432,255,321,11,70,58,97,81,155,467.103558991158,7.62142857142857,7489.40066233624,416.077814574236,982.676750447117,53,38.9529164280892,0,0
transformers_4.13.0,tests/test_modeling_vit.py,358,213,264,8,42,28,49,50,77,250.477331756708,4.66666666666667,2028.02565752572,112.668092084762,434.576926612654,39,44.0303934253107,0,0
transformers_4.13.0,tests/test_modeling_rembert.py,499,208,407,2,17,23,24,19,47,71.4868683012558,1.41176470588235,281.862484421433,15.6590269123018,199.652593131849,36,44.3096693494097,0,0
transformers_4.13.0,tests/test_trainer_utils.py,422,268,291,10,81,61,106,91,167,546.747131182528,6.54320987654321,7111.17164943193,395.065091635107,1086.80170491318,64,40.7934222371219,0,0
transformers_4.13.0,tests/test_processor_clip.py,177,101,108,2,3,2,3,5,5,6.75488750216347,1,11.6096404744368,0.644980026357601,11.6096404744368,16,69.0017582361738,0,0
transformers_4.13.0,tests/test_modeling_tf_encoder_decoder.py,1019,454,760,9,56,43,75,65,118,353.741200648207,6.02678571428571,4282.87139560461,237.937299755812,710.639401937358,62,32.0377663578397,0,0
transformers_4.13.0,tests/test_modeling_albert.py,309,172,252,2,9,13,14,11,27,30.5293250129808,1.55555555555556,145.296127982767,8.0720071101537,93.404653703207,33,47.1592360181884,0,0
transformers_4.13.0,tests/test_modeling_flax_pegasus.py,338,160,264,6,32,34,52,38,86,175.509775004327,4.875,2200.19361001122,122.232978333957,451.321766156148,26,44.5114195588863,0,0
transformers_4.13.0,tests/test_modeling_tf_hubert.py,546,320,385,9,61,43,74,70,117,390.304302604317,5.45901639344262,3914.80320693759,217.489067052088,717.126112982561,61,35.2622713678034,0,0
transformers_4.13.0,tests/test_configuration_auto.py,79,44,42,2,6,3,6,8,9,17.5097750043269,1,27,1.5,27,10,81.9481413293309,0,0
transformers_4.13.0,tests/test_pipelines_image_segmentation.py,247,81,201,1,7,6,12,8,18,19.6514844544032,0.857142857142857,46.2857142857143,2.57142857142857,54,16,60.658906933917,0,0
transformers_4.13.0,tests/test_tokenization_fsmt.py,168,84,113,2,13,7,14,15,21,50.1057163358342,1.07692307692308,88.3558334699157,4.90865741499532,82.0447025077789,14,66.6062741809119,0,0
transformers_4.13.0,tests/test_modeling_megatron_bert.py,382,197,315,4,16,17,21,20,38,72,2.625,431.112327465014,23.9506848591675,164.23326760572,36,42.7576583814875,0,0
transformers_4.13.0,tests/test_modeling_tf_convbert.py,411,229,336,4,21,17,23,25,40,100.238665878354,2.19047619047619,406.890256627881,22.6050142571045,185.754247590989,33,40.9721511269843,0,0
transformers_4.13.0,tests/test_modeling_auto.py,391,214,306,3,9,7,10,12,17,33.2842125151443,1.66666666666667,101.573937520433,5.64299652891293,60.9443625122597,48,45.9415886455549,0,0
transformers_4.13.0,tests/test_modeling_tf_pytorch.py,243,136,186,0,0,0,0,0,0,0,0,0,0,0,21,100,0,0
transformers_4.13.0,tests/test_tokenization_wav2vec2.py,564,334,410,10,54,42,75,64,117,343.983206065701,6.94444444444444,4875,270.833333333333,702,46,36.6473035888595,0,0
transformers_4.13.0,tests/test_modeling_electra.py,368,172,310,2,6,10,11,8,21,17.5097750043269,1.83333333333333,115.5,6.41666666666667,63,34,46.9328493929049,0,0
transformers_4.13.0,tests/test_tokenization_tapas.py,1234,684,935,16,147,115,221,163,336,1122.35183469095,12.0272108843537,29697.2602895555,1649.8477938642,2469.17265982164,162,8.89822405250149,0,0
transformers_4.13.0,tests/test_tokenization_bert_japanese.py,301,157,213,2,28,18,36,30,54,136.605937817613,1.28571428571429,340.678404209391,18.9265780116329,264.97209216286,39,48.2919404686506,0,0
transformers_4.13.0,tests/test_modeling_tf_rag.py,1070,414,855,4,32,17,37,36,54,168,2.3125,645.594384555109,35.866354697506,279.175950077885,58,29.562508858028,0,0
transformers_4.13.0,tests/test_tokenization_lxmert.py,89,43,57,2,3,2,3,5,5,6.75488750216347,1,11.6096404744368,0.644980026357601,11.6096404744368,7,80.9907862206158,0,0
transformers_4.13.0,tests/test_modeling_convbert.py,457,253,375,8,31,37,54,39,91,177.580085621993,6.96774193548387,3351.28600045021,186.182555580567,480.971601916465,46,37.2461259414346,0,0
transformers_4.13.0,tests/test_tokenization_herbert.py,128,63,88,3,18,10,19,21,29,79.8135375281251,1.58333333333333,201.680574995925,11.2044763886625,127.377205260584,9,66.8715537044767,0,0
transformers_4.13.0,tests/test_tokenization_roberta.py,198,108,141,3,14,8,16,17,24,58.0578564109699,1.71428571428571,168.1698997543,9.34277220857221,98.0991081900082,14,61.1624469686062,0,0
transformers_4.13.0,tests/test_modeling_tf_deberta.py,282,135,226,1,7,7,7,8,14,19.6514844544032,0.5,21,1.16666666666667,42,24,53.3548769972308,0,0
transformers_4.13.0,tests/test_modeling_flax_vit.py,240,132,170,5,24,15,27,29,42,121.648740491745,2.8125,573.849005049445,31.8805002805247,204.035201795358,20,55.7443659325715,0,0
transformers_4.13.0,tests/test_modeling_tf_camembert.py,54,21,26,1,5,5,5,6,10,11.6096404744368,0.5,12.9248125036058,0.71804513908921,25.8496250072116,3,89.5175111163942,0,0
transformers_4.13.0,tests/test_pipelines_conversational.py,384,179,307,3,7,4,7,10,11,24.4063719565667,1.5,54.8118135656415,3.04510075364675,36.541209043761,17,59.4888117111393,0,0
transformers_4.13.0,tests/test_tokenization_byt5.py,323,194,219,8,33,21,43,41,64,190.465005938829,5.21212121212121,1787.149468692,99.2860815939998,342.883328295557,43,50.1594354719021,0,0
transformers_4.13.0,tests/test_tokenization_xlm.py,98,43,64,2,17,9,18,19,27,71.4868683012558,1.05882352941176,121.440751266681,6.74670840370452,114.694042862977,7,73.6590373246785,0,0
transformers_4.13.0,tests/test_tokenization_rag.py,170,71,139,2,6,3,7,8,10,17.5097750043269,1.16666666666667,35,1.94444444444444,30,12,66.0611292019058,0,0
transformers_4.13.0,tests/test_tokenization_transfo_xl.py,131,46,91,1,4,2,4,5,6,8,0.5,6.96578428466209,0.38698801581456,13.9315685693242,10,76.700457308402,0,0
transformers_4.13.0,tests/test_model_card.py,81,38,54,0,0,0,0,0,0,0,0,0,0,0,7,100,0,0
transformers_4.13.0,tests/test_modeling_flax_encoder_decoder.py,474,235,353,9,33,32,53,42,85,194.99433095181,7.22727272727273,3312.59863494795,184.033257497108,458.346980936195,42,40.1062365460573,0,0
transformers_4.13.0,tests/test_modeling_flax_mbart.py,464,221,378,6,39,40,64,45,104,221.640461539955,4.92307692307692,2811.82878532079,156.2127102956,571.152722018286,38,37.8602482914131,0,0
transformers_4.13.0,tests/test_feature_extraction_beit.py,344,133,264,3,18,13,25,21,38,79.8135375281251,2.08333333333333,347.725129303319,19.3180627390733,166.908062065593,19,55.3467925016145,0,0
transformers_4.13.0,tests/test_modeling_camembert.py,55,21,28,1,5,5,5,6,10,11.6096404744368,0.5,12.9248125036058,0.71804513908921,25.8496250072116,3,89.8330492203084,0,0
transformers_4.13.0,tests/test_modeling_transfo_xl.py,421,233,298,11,78,61,120,89,181,528.315120876266,8.46153846153846,9917.83481619546,550.99082312197,1172.10775100492,76,40.477778502758,0,0
transformers_4.13.0,tests/test_modeling_gptj.py,569,303,430,7,37,42,67,44,109,212.401258982674,6.33783783783784,3771.50815913996,209.528231063331,595.078046431465,40,39.0547378270285,0,0
transformers_4.13.0,tests/test_tokenization_marian.py,135,84,90,4,10,8,14,14,22,41.2192809488736,2.8,234.533063198748,13.0296146221527,83.7618082852673,16,65.3209499120723,0,0
transformers_4.13.0,tests/test_tokenization_canine.py,304,189,197,2,6,3,6,8,9,17.5097750043269,1,27,1.5,27,32,60.4652994383044,0,0
transformers_4.13.0,tests/test_logging.py,105,52,56,2,4,3,6,6,9,10,1.5,34.8969937597356,1.93872187554087,23.2646625064904,6,81.0618613854862,0,0
transformers_4.13.0,tests/test_modeling_flax_bart.py,477,219,383,7,45,43,70,52,113,266.784873789239,5.44444444444444,3507.03719103858,194.835399502143,644.149688149944,38,38.0972646528094,0,0
transformers_4.13.0,tests/test_benchmark_tf.py,226,106,193,0,0,0,0,0,0,0,0,0,0,0,16,100,0,0
transformers_4.13.0,tests/test_modeling_bert_generation.py,331,147,263,2,8,9,10,10,19,26,1.25,78.8957922535749,4.38309956964305,63.1166338028599,26,52.4337751220352,0,0
transformers_4.13.0,tests/test_tokenization_bartpho.py,66,37,36,1,2,1,2,3,3,2,0.5,2.37744375108173,0.13208020839343,4.75488750216347,6,87.9461207091466,0,0
transformers_4.13.0,tests/test_tokenization_clip.py,208,117,131,4,15,14,23,19,37,66.6033589341278,3.06666666666667,481.998175192066,26.7776763995592,157.173317997413,13,63.4207432501324,0,0
transformers_4.13.0,tests/test_activations.py,46,25,25,1,3,3,3,4,6,4.75488750216347,0.5,6,0.333333333333333,12,4,90.5649608136465,0,0
transformers_4.13.0,tests/sagemaker/test_multi_node_model_parallel.py,124,46,96,4,14,8,16,18,24,61.3029689088065,2.28571428571429,228.750171507693,12.7083428615385,100.078200034616,12,66.2372854890966,0,0
transformers_4.13.0,tests/sagemaker/__init__.py,5,3,3,1,2,1,2,3,3,2,0.5,2.37744375108173,0.13208020839343,4.75488750216347,1,84.7162462759479,0,0
transformers_4.13.0,tests/sagemaker/conftest.py,65,36,50,1,4,2,4,5,6,8,0.5,6.96578428466209,0.38698801581456,13.9315685693242,7,71.3107646450788,0,0
transformers_4.13.0,tests/sagemaker/test_single_node_gpu.py,96,38,73,4,12,7,14,16,21,51.0195500086539,2.33333333333333,196,10.8888888888889,84,11,69.1059155122177,0,0
transformers_4.13.0,tests/sagemaker/test_multi_node_data_parallel.py,110,42,84,6,15,9,18,21,27,74.1131339384547,3.6,426.933253494096,23.7185140830053,118.592570415027,13,67.4880486198285,0,0
transformers_4.13.0,tests/sagemaker/scripts/tensorflow/run_tf_dist.py,194,118,139,6,23,15,28,29,43,119.551699993638,3.65217391304348,762.914232800035,42.3841240444464,208.893182790486,26,52.3761255167188,0,0
transformers_4.13.0,tests/sagemaker/scripts/tensorflow/run_tf.py,91,50,64,2,4,2,4,6,6,10,1,15.5097750043269,0.861654166907052,15.5097750043269,5,75.2893720187177,0,0
transformers_4.13.0,tests/sagemaker/scripts/pytorch/run_glue_model_parallelism.py,529,266,378,15,101,83,157,116,240,731.082718692059,11.6584158415842,19188.7666259708,1066.04259033171,1645.91543883062,88,37.7799352046043,0,0
transformers_4.13.0,tests/sagemaker/scripts/pytorch/run_ddp.py,52,32,42,2,4,2,4,6,6,10,1,15.5097750043269,0.861654166907052,15.5097750043269,8,57.7540537588094,0,0
transformers_4.13.0,tests/extended/test_trainer_ext.py,307,127,226,7,30,21,36,37,57,166.858202322659,4.2,1247.14313573157,69.2857297628651,296.93884184085,35,55.7840426349266,0,0
transformers_4.13.0,tests/deepspeed/test_model_zoo.py,263,83,156,2,14,7,14,16,21,55.3029689088065,1,84,4.66666666666667,84,10,71.5413017235842,0,0
transformers_4.13.0,tests/deepspeed/test_deepspeed.py,1021,442,683,10,80,46,88,90,134,538.973528539863,5.5,4784.49573199497,265.805318444165,869.908314908176,63,39.0830810392165,0,0
transformers_4.13.0,utils/print_env_pt.py,28,7,7,0,0,0,0,0,0,0,0,0,0,0,1,100,0,0
transformers_4.13.0,utils/check_dummies.py,229,115,163,12,33,25,48,45,73,209.484555947483,8.72727272727273,3498.8096817344,194.378315651911,400.905276032066,30,53.994367005858,1,1
transformers_4.13.0,utils/check_repo.py,612,265,482,12,155,91,174,167,265,1170.81883282616,6.73548387096774,13179.1976100379,732.177645002104,1956.68163750562,112,33.5427485842125,2,1
transformers_4.13.0,utils/download_glue_data.py,157,97,117,5,23,15,25,28,40,115.651565463748,2.71739130434783,522.538578484522,29.0299210269179,192.294196882304,18,58.5232937830922,0,0
transformers_4.13.0,utils/tests_fetcher.py,499,267,333,15,116,70,132,131,202,854.129154368926,8.53448275862069,12125.3787228229,673.63215126794,1420.75144631056,100,38.056823099198,0,0
transformers_4.13.0,utils/check_table.py,231,144,152,14,71,52,99,85,151,489.935014393639,9.76056338028169,9446.44923563743,524.802735313191,967.818031356793,37,52.3915649063843,0,0
transformers_4.13.0,utils/check_copies.py,423,251,298,15,134,102,196,149,298,1005.45931045547,10.9701492537313,23600.216134878,1311.12311860433,2151.31221909772,68,37.2774470560586,0,0
transformers_4.13.0,utils/notification_service.py,220,105,167,10,39,28,49,49,77,239.349967484501,6.28205128205128,2715.93592844188,150.885329357882,432.332657996871,30,52.2312435525928,0,0
transformers_4.13.0,utils/check_tf_ops.py,101,41,60,5,18,10,20,23,30,86.6682905003984,2.77777777777778,376.963496338084,20.9424164632269,135.70685868171,14,75.7944135602514,0,0
transformers_4.13.0,utils/style_doc.py,550,370,373,17,250,166,326,267,492,2060.93293946678,11.084,43957.6188237578,2442.08993465321,3965.86239839028,141,25.1975860612485,0,0
transformers_4.13.0,utils/get_modified_files.py,34,10,9,0,0,0,0,0,0,0,0,0,0,0,3,100,0,0
transformers_4.13.0,utils/check_inits.py,206,143,133,16,68,68,125,84,193,477.947473205023,14.7058823529412,18142.9009205338,1007.93894002966,1233.7172625963,53,51.0685042454875,0,0
transformers_4.13.0,utils/release.py,256,176,174,11,43,35,61,54,96,271.3831322572,7.80232558139535,4310.54457371351,239.47469853964,552.469200207693,35,49.273647940794,0,0
transformers_4.13.0,utils/custom_init_isort.py,241,150,137,14,93,69,125,107,194,661.444738341853,9.40860215053763,12304.9894724903,683.610526249459,1307.84459536182,51,52.6884383893631,0,0
transformers_4.13.0,scripts/check_tokenizers.py,169,118,123,11,67,53,106,78,159,444.481723565681,8.70149253731343,8696.08849972946,483.116027762748,999.378952799098,42,46.9666284537726,0,0
transformers_4.13.0,scripts/stale.py,65,19,38,8,31,18,38,39,56,177.580085621993,4.90322580645161,1451.26915119211,80.6260639551173,295.982524256286,15,81.8607718672153,0,0
transformers_4.13.0,scripts/pegasus/build_test_sample_spm_no_bos.py,33,2,2,0,0,0,0,0,0,0,0,0,0,0,1,100,0,0
transformers_4.13.0,scripts/fsmt/gen-card-facebook-wmt19.py,164,20,107,1,6,3,6,7,9,15.5097750043269,0.5,12.6330971492592,0.701838730514401,25.2661942985184,2,83.937937049477,0,0
transformers_4.13.0,scripts/fsmt/gen-card-allenai-wmt19.py,152,19,97,1,6,3,6,7,9,15.5097750043269,0.5,12.6330971492592,0.701838730514401,25.2661942985184,2,85.2267104798243,0,0
transformers_4.13.0,scripts/fsmt/fsmt-make-super-tiny-model.py,87,31,42,1,4,3,6,5,9,8,0.75,15.6730146404897,0.870723035582761,20.8973528539863,1,86.6908735221516,0,0
transformers_4.13.0,scripts/fsmt/gen-card-allenai-wmt16.py,155,19,100,1,6,3,6,7,9,15.5097750043269,0.5,12.6330971492592,0.701838730514401,25.2661942985184,2,84.9780137675216,0,0
transformers_4.13.0,scripts/fsmt/fsmt-make-tiny-model.py,59,15,19,0,0,0,0,0,0,0,0,0,0,0,1,100,0,0
transformers_4.13.0,examples/flax/test_examples.py,274,109,222,2,4,2,4,6,6,10,1,15.5097750043269,0.861654166907052,15.5097750043269,12,60.6033528437176,0,0
transformers_4.13.0,examples/flax/conftest.py,45,14,14,0,0,0,0,0,0,0,0,0,0,0,2,100,0,0
transformers_4.13.0,examples/flax/text-classification/run_flax_glue.py,558,301,400,16,108,81,154,124,235,793.527850233655,11.4074074074074,18642.397368363,1035.68874268684,1634.23613294092,60,37.6513821841142,0,0
transformers_4.13.0,examples/flax/token-classification/run_flax_ner.py,732,396,542,16,132,107,198,148,305,993.860023755316,12,26386.599318202,1465.92218434455,2198.88327651683,75,31.6105910559822,0,0
transformers_4.13.0,examples/flax/summarization/run_summarization_flax.py,829,442,604,14,126,102,188,140,290,932.440239269796,10.4444444444444,21593.8061157689,1199.65589532049,2067.49207491404,82,30.5895245132202,1,1
transformers_4.13.0,examples/flax/question-answering/utils_qa.py,431,189,241,15,120,87,163,135,250,887.43023040715,10.1875,18023.7647237388,1001.32026242994,1769.20389926271,77,46.4832833880517,0,0
transformers_4.13.0,examples/flax/question-answering/run_qa.py,984,473,663,20,166,136,259,186,395,1310.69510750134,15.6024096385542,46463.4724199041,2581.304023328,2977.96773038767,94,30.6291598620332,0,0
transformers_4.13.0,examples/flax/vision/run_image_classification.py,476,222,338,9,59,35,69,68,104,375.605264925329,5.26271186440678,3331.80254355349,185.100141308527,633.096135490035,30,47.9711341240063,0,0
transformers_4.13.0,examples/flax/language-modeling/run_mlm_flax.py,742,349,491,19,130,95,176,149,271,993.618438449127,12.8615384615385,25162.2452818742,1397.90251565968,1956.39466904525,69,38.2423125322844,0,0
transformers_4.13.0,examples/flax/language-modeling/run_clm_flax.py,704,366,503,16,121,88,169,137,257,901.182451710226,11.1735537190083,20382.7323939983,1132.3740218888,1824.19424532086,75,35.0388965740493,0,0
transformers_4.13.0,examples/flax/language-modeling/t5_tokenizer_model.py,112,38,82,1,2,1,2,3,3,2,0.5,2.37744375108173,0.13208020839343,4.75488750216347,7,75.3999153073977,0,0
transformers_4.13.0,examples/flax/language-modeling/run_t5_mlm_flax.py,840,392,523,20,154,121,223,174,344,1205.52368916476,14.4805194805195,37075.5247697109,2059.75137609505,2560.37256257196,74,37.1606608307126,0,0
transformers_4.13.0,examples/tensorflow/text-classification/run_glue.py,560,283,398,12,72,53,101,84,154,487.2541501125,8.41666666666667,8285.5087661584,460.306042564356,984.416883107929,81,39.2084468671128,0,0
transformers_4.13.0,examples/tensorflow/text-classification/run_text_classification.py,531,271,375,16,96,72,135,112,207,696.156400069231,11.25,15852.6277747416,880.701543041203,1409.12246886592,80,40.1294071367671,0,0
transformers_4.13.0,examples/tensorflow/multiple-choice/run_swag.py,460,210,329,15,66,49,90,81,139,457.533370811786,10.2272727272727,9012.67312910076,500.70406272782,881.239150400963,55,46.4581089902042,0,0
transformers_4.13.0,examples/tensorflow/token-classification/run_ner.py,537,260,380,11,61,47,83,72,130,399.828725396346,7.48360655737705,6002.52785591138,333.473769772854,802.090250187501,42,46.5736718701671,0,0
transformers_4.13.0,examples/tensorflow/summarization/run_summarization.py,663,287,486,13,96,75,139,109,214,680.262116405065,9.41145833333333,13631.475739701,757.304207761166,1448.39144550226,72,38.7237473836771,1,1
transformers_4.13.0,examples/tensorflow/question-answering/utils_qa.py,431,189,241,15,120,87,163,135,250,887.43023040715,10.1875,18023.7647237388,1001.32026242994,1769.20389926271,77,46.4832833880517,0,0
transformers_4.13.0,examples/tensorflow/question-answering/run_qa.py,704,312,492,17,90,75,140,107,215,653.753646970927,13.2222222222222,19164.4925385637,1064.69402992021,1449.41540207625,71,39.7704892765591,0,0
transformers_4.13.0,examples/tensorflow/translation/run_translation.py,620,270,452,13,93,71,132,106,203,656.247485768881,9.2258064516129,12600.3098629365,700.017214607581,1365.76785227633,67,40.3503841787919,0,0
transformers_4.13.0,examples/tensorflow/language-modeling/run_clm.py,564,264,406,16,81,77,143,97,220,577.527850233655,14.1234567901235,20506.9884459464,1139.27713588591,1451.98082528117,65,41.2567290730833,0,0
transformers_4.13.0,examples/tensorflow/language-modeling/run_mlm.py,621,285,440,20,105,94,171,125,265,791.43434125269,16.2857142857143,30062.3347485202,1670.12970825112,1845.93283543545,68,39.8652868986263,0,0
transformers_4.13.0,examples/tensorflow/benchmarking/plot_csv_file.py,178,99,126,7,14,10,18,21,28,72.9544533632097,4.5,553.431995270124,30.7462219594513,122.984887837805,25,59.9601780008079,0,0
transformers_4.13.0,examples/tensorflow/benchmarking/run_benchmark_tf.py,48,27,24,5,12,8,14,17,22,54.6291904830907,2.91666666666667,262.278865646897,14.5710480914943,89.9241825075075,6,82.7995569673769,0,0
transformers_4.13.0,examples/pytorch/test_examples.py,538,212,444,6,22,11,22,28,33,113.617270614347,3,475.928137283703,26.4404520713168,158.642712427901,33,41.2556160275564,0,0
transformers_4.13.0,examples/pytorch/conftest.py,45,14,14,0,0,0,0,0,0,0,0,0,0,0,2,100,0,0
transformers_4.13.0,examples/pytorch/xla_spawn.py,85,23,36,2,6,3,6,8,9,17.5097750043269,1,27,1.5,27,2,87.7524545208784,0,0
transformers_4.13.0,examples/pytorch/test_xla_examples.py,93,38,61,1,2,1,2,3,3,2,0.5,2.37744375108173,0.13208020839343,4.75488750216347,4,85.2889945460733,0,0
transformers_4.13.0,examples/pytorch/text-classification/run_glue.py,568,298,419,15,108,92,174,123,266,788.131209167783,12.0833333333333,22314.3987059112,1239.68881699507,1846.70885842024,96,33.9287297514725,0,0
transformers_4.13.0,examples/pytorch/text-classification/run_xnli.py,400,174,293,10,27,24,44,37,68,161.601243507287,8.14814814814815,2886.42304999293,160.356836110718,354.242828862769,41,51.056797583428,0,0
transformers_4.13.0,examples/pytorch/text-classification/run_glue_no_trainer.py,491,240,371,16,78,73,136,94,209,554.261373071255,13.9487179487179,19108.4752328293,1061.5819573794,1369.90907000063,73,38.842855511454,0,0
transformers_4.13.0,examples/pytorch/multiple-choice/run_swag_no_trainer.py,524,232,378,15,49,41,75,64,116,333.724141295773,11.4795918367347,7989.79591836735,443.877551020408,696,55,45.7876454928195,0,0
transformers_4.13.0,examples/pytorch/multiple-choice/run_swag.py,455,196,316,13,54,45,83,67,128,358.869641452662,9.99074074074074,7757.40472474541,430.966929152523,776.459416378595,53,48.2570542252596,0,0
transformers_4.13.0,examples/pytorch/text-generation/run_generation.py,290,125,193,9,50,32,60,59,92,310.722134501717,5.4,2922.49706692296,162.360948162387,541.20316054129,32,54.6843841082088,0,0
transformers_4.13.0,examples/pytorch/token-classification/run_ner_no_trainer.py,608,293,471,17,76,65,117,93,182,544.329359322968,13.0855263157895,15573.4369164703,865.190939803906,1190.12690362166,65,37.9534365340518,0,0
transformers_4.13.0,examples/pytorch/token-classification/run_ner.py,577,282,437,12,77,65,118,89,183,525.562113642161,9.1948051948052,10896.3886525939,605.354925144106,1185.05921786685,71,38.0332407400777,0,0
transformers_4.13.0,examples/pytorch/summarization/run_summarization_no_trainer.py,619,267,492,17,76,68,125,93,193,544.329359322968,13.9802631578947,17643.8980750374,980.216559724299,1262.05765054385,69,35.9474817766741,0,0
transformers_4.13.0,examples/pytorch/summarization/run_summarization.py,648,302,511,13,87,78,144,100,222,608.641800474674,10.7586206896552,15868.2777630537,881.570986836315,1474.93607412999,81,33.2231973621024,0,0
transformers_4.13.0,examples/pytorch/image-classification/run_image_classification.py,352,158,258,12,42,29,57,54,86,269.496881765362,8.14285714285714,4030.06550508647,223.89252806036,494.920325186058,40,50.2328405390296,0,0
transformers_4.13.0,examples/pytorch/question-answering/utils_qa.py,431,189,241,15,120,87,163,135,250,887.43023040715,10.1875,18023.7647237388,1001.32026242994,1769.20389926271,77,46.4832833880517,0,0
transformers_4.13.0,examples/pytorch/question-answering/run_qa_beam_search_no_trainer.py,862,391,629,19,117,112,201,136,313,884.543294946687,16.3205128205128,36205.0318158123,2011.39065643402,2218.37586931136,69,35.0452780551186,0,0
transformers_4.13.0,examples/pytorch/question-answering/trainer_seq2seq_qa.py,120,56,77,5,18,15,28,23,43,86.6682905003984,3.88888888888889,756.440082651756,42.0244490362087,194.513164110452,23,70.2729297626951,1,1
transformers_4.13.0,examples/pytorch/question-answering/trainer_qa.py,105,52,65,5,16,13,24,21,37,75.6096404744368,3.75,609.434042410553,33.8574468005863,162.515744642814,21,72.5166546044194,0,0
transformers_4.13.0,examples/pytorch/question-answering/run_qa_beam_search.py,680,297,491,16,101,90,169,117,259,736.479359757931,13.3861386138614,23819.6225062087,1323.31236145604,1779.4244623721,66,39.2078812317978,0,0
transformers_4.13.0,examples/pytorch/question-answering/run_seq2seq_qa.py,678,315,515,11,85,82,152,96,234,582.851977376715,9.83529411764706,15155.020049895,841.9455583275,1540.88122516875,80,34.6981139001889,1,1
transformers_4.13.0,examples/pytorch/question-answering/run_qa.py,647,278,462,15,87,81,152,102,233,619.139443072967,13.1034482758621,20371.6048199364,1131.7558233298,1554.67510467936,67,40.3826210888548,0,0
transformers_4.13.0,examples/pytorch/question-answering/run_qa_no_trainer.py,825,360,597,19,102,96,177,121,273,761.298007636521,16.4852941176471,31138.2422513655,1729.90234729809,1888.84966377596,75,35.6380767704542,0,0
transformers_4.13.0,examples/pytorch/speech-recognition/run_speech_recognition_ctc.py,650,258,441,13,49,38,70,62,108,323.226498697479,9.28571428571429,5971.20829984513,331.73379443584,643.053201521783,42,47.4274641556378,1,1
transformers_4.13.0,examples/pytorch/translation/run_translation.py,624,289,475,12,89,79,146,101,225,619.359825364663,9.84269662921348,14745.3200365211,819.184446473395,1498.09758361915,81,34.742019513539,0,0
transformers_4.13.0,examples/pytorch/translation/run_translation_no_trainer.py,599,251,455,16,74,65,119,90,184,523.499549056542,12.8648648648649,15367.0935564578,853.72741980321,1194.50096972466,65,38.8278270910638,0,0
transformers_4.13.0,examples/pytorch/audio-classification/run_audio_classification.py,367,164,267,15,41,28,55,56,83,278.262991123469,10.0609756097561,4849.49546692554,269.416414829197,482.010458530781,32,51.6002787168816,0,0
transformers_4.13.0,examples/pytorch/language-modeling/run_plm.py,525,237,395,16,74,61,115,90,176,523.499549056542,12.4324324324324,14204.8763967257,789.159799818094,1142.56614495402,61,41.6464106896576,0,0
transformers_4.13.0,examples/pytorch/language-modeling/run_clm_no_trainer.py,526,232,403,18,68,59,109,86,168,489.006123230985,14.4264705882353,15574.9976719551,865.277648441947,1079.61247878995,56,41.8554839258826,0,0
transformers_4.13.0,examples/pytorch/language-modeling/run_mlm_no_trainer.py,567,242,435,18,72,62,114,90,176,519.293250129808,14.25,16281.5675655948,904.531531421935,1142.56614495402,58,41.4826618446135,0,0
transformers_4.13.0,examples/pytorch/language-modeling/run_clm.py,526,242,393,17,75,64,122,92,186,536.648270088447,13.8266666666667,16777.0356961092,932.057538672733,1213.3825238266,64,40.903695042442,0,0
transformers_4.13.0,examples/pytorch/language-modeling/run_mlm.py,556,249,418,15,79,66,124,94,190,556.602038040119,11.7721518987342,14660.7069631828,814.48372017682,1245.37188181875,67,40.4638895745717,0,0
transformers_4.13.0,examples/pytorch/speech-pretraining/run_wav2vec2_pretraining_no_trainer.py,725,293,531,18,104,89,171,122,260,771.904380712635,14.7980769230769,26666.0119062732,1481.44510590407,1801.99170776635,67,37.2691672989538,0,0
transformers_4.13.0,examples/pytorch/benchmarking/plot_csv_file.py,178,99,126,7,14,10,18,21,28,72.9544533632097,4.5,553.431995270124,30.7462219594513,122.984887837805,25,59.9601780008079,0,0
transformers_4.13.0,examples/pytorch/benchmarking/run_benchmark.py,48,26,23,5,12,8,14,17,22,54.6291904830907,2.91666666666667,262.278865646897,14.5710480914943,89.9241825075075,6,82.8856038242335,0,0
transformers_4.13.0,examples/research_projects/movement-pruning/counts_parameters.py,92,44,61,10,30,21,41,40,62,180.425998817129,6.83333333333333,2254.72353620061,125.262418677812,329.959541883016,10,71.9356720272242,0,0
transformers_4.13.0,examples/research_projects/movement-pruning/masked_run_glue.py,952,468,788,19,325,280,523,344,803,2792.60679282807,15.2876923076923,103440.96872705,5746.72048483609,6766.29059802579,173,8.80202181182597,0,0
transformers_4.13.0,examples/research_projects/movement-pruning/masked_run_squad.py,1132,511,918,20,327,281,522,347,803,2817.91757383562,15.9633027522936,108172.924332655,6009.60690736972,6776.34985762034,183,6.54175698051414,0,0
transformers_4.13.0,examples/research_projects/movement-pruning/bertarize.py,132,76,98,9,32,29,54,41,83,188.529325012981,7.59375,3376.76457441069,187.598031911705,444.676816383301,18,60.6944698825714,0,0
transformers_4.13.0,examples/research_projects/movement-pruning/emmental/modeling_bert_masked.py,1019,429,667,15,112,133,224,127,357,821.027110204579,15,37424.406497665,2079.13369431472,2494.96043317766,96,32.8414524720457,0,0
transformers_4.13.0,examples/research_projects/movement-pruning/emmental/__init__.py,10,3,9,0,0,0,0,0,0,0,0,0,0,0,1,100,0,0
transformers_4.13.0,examples/research_projects/movement-pruning/emmental/configuration_bert_masked.py,71,24,41,0,0,0,0,0,0,0,0,0,0,0,2,100,0,0
transformers_4.13.0,examples/research_projects/movement-pruning/emmental/modules/__init__.py,3,2,2,0,0,0,0,0,0,0,0,0,0,0,1,100,0,0
transformers_4.13.0,examples/research_projects/movement-pruning/emmental/modules/masked_nn.py,106,44,49,7,32,21,40,39,61,179.651484454403,4.375,1410.54171715886,78.3634287310479,322.409535350597,14,70.6379598448219,0,0
transformers_4.13.0,examples/research_projects/movement-pruning/emmental/modules/binarizer.py,144,52,41,5,13,9,18,18,27,59.715356810271,3.46153846153846,389.727605904031,21.6515336613351,112.587975038942,8,51.2244264788087,0,0
transformers_4.13.0,examples/research_projects/quantization-qdqbert/trainer_quant_qa.py,212,104,139,8,28,21,40,36,61,158.605937817613,5.71428571428571,1802.08814335989,100.116007964438,315.365425087981,33,59.493769604741,0,0
transformers_4.13.0,examples/research_projects/quantization-qdqbert/utils_qa.py,427,183,237,14,118,85,161,132,246,865.454848733504,9.55084745762712,16550.8636816879,919.492426760441,1732.92095336218,77,46.8482688937089,0,0
transformers_4.13.0,examples/research_projects/quantization-qdqbert/run_quant_qa.py,668,290,475,16,86,86,162,102,248,616.65876890438,15.0697674418605,24936.8707478183,1385.38170821213,1654.76148480893,74,38.7705334719285,0,0
transformers_4.13.0,examples/research_projects/quantization-qdqbert/quant_trainer.py,303,210,200,11,55,34,61,66,95,356.028532048867,6.1,3502.72639216822,194.595910676012,574.217441339053,63,41.7224972752596,0,0
transformers_4.13.0,examples/research_projects/quantization-qdqbert/evaluate-hf-trt-qa.py,456,190,307,12,36,28,50,48,78,229.136850060577,8.33333333333333,3630.22562546875,201.679201414931,435.62707505625,42,51.0372803699955,0,0
transformers_4.13.0,examples/research_projects/adversarial/run_hans.py,239,85,163,8,25,14,27,33,41,140.096404744368,4.32,893.463086420769,49.6368381344872,206.820158893697,20,64.397391285417,0,0
transformers_4.13.0,examples/research_projects/adversarial/utils_hans.py,340,142,207,6,25,14,27,31,41,131.606179748695,3.24,658.115437871793,36.5619687706551,203.122048725862,31,59.8408147683371,0,0
transformers_4.13.0,examples/research_projects/longform-qa/eli5_app.py,351,166,316,10,46,31,60,56,91,287.303130927496,6.52173913043478,3446.53889939506,191.474383299725,528.469297907242,34,34.6859259183569,0,0
transformers_4.13.0,examples/research_projects/longform-qa/eli5_utils.py,688,403,582,19,196,129,254,215,383,1573.19375220201,12.3112244897959,36534.271018065,2029.68172322583,2967.55786139276,105,20.6616896760081,0,0
transformers_4.13.0,examples/research_projects/performer/run_mlm_performer.py,685,317,433,19,140,105,196,159,301,1078.81024512772,13.3,29275.6643348899,1626.42579638277,2201.17776954059,59,41.4303853291244,0,0
transformers_4.13.0,examples/research_projects/performer/modeling_flax_performer.py,553,287,384,11,44,38,66,55,104,278.268739025051,8.25,4960.40663420416,275.578146344675,601.261410206565,41,43.7958502331159,0,0
transformers_4.13.0,examples/research_projects/performer/modeling_flax_performer_utils.py,660,309,433,14,146,128,238,160,366,1103.01735450529,11.4109589041096,30579.3807357955,1698.85448532197,2679.82568272877,39,43.4028711491159,0,0
transformers_4.13.0,examples/research_projects/bert-loses-patience/run_glue_with_pabee.py,751,376,607,16,174,152,275,190,427,1359.07216827768,12.6436781609195,40868.5193015293,2270.4732945294,3232.32834475731,123,20.5623253165263,0,0
transformers_4.13.0,examples/research_projects/bert-loses-patience/test_run_glue_with_pabee.py,50,23,40,0,0,0,0,0,0,0,0,0,0,0,3,100,0,0
transformers_4.13.0,examples/research_projects/bert-loses-patience/pabee/__init__.py,0,0,0,0,0,0,0,0,0,0,0,0,0,0,1,100,0,0
transformers_4.13.0,examples/research_projects/bert-loses-patience/pabee/modeling_pabee_bert.py,343,139,192,10,43,47,88,53,135,266.548665401064,10.2325581395349,7912.52267444312,439.584593024618,773.269261366032,37,57.0495903239136,0,0
transformers_4.13.0,examples/research_projects/bert-loses-patience/pabee/modeling_pabee_albert.py,317,141,194,10,52,54,101,62,155,329.64214629221,9.71153846153846,8962.78300376025,497.932389097791,922.900428109966,35,55.6573223331307,0,0
transformers_4.13.0,examples/research_projects/zero-shot-distillation/distill_classifier.py,338,169,269,11,46,36,60,57,96,292.137597783633,7.17391304347826,4017.08599236389,223.171444020216,559.957441359815,31,43.6440768164196,0,0
transformers_4.13.0,examples/research_projects/codeparrot/scripts/validation_loss.py,99,74,74,7,18,11,21,25,32,94.7101344803648,4.08333333333333,606.797208797231,33.7109560442906,148.603398072791,14,59.5313439346418,0,0
transformers_4.13.0,examples/research_projects/codeparrot/scripts/human_eval.py,87,51,55,5,16,9,17,21,26,75.6096404744368,2.65625,303.344422010658,16.852467889481,114.200252992248,7,71.4859407182615,0,0
transformers_4.13.0,examples/research_projects/codeparrot/scripts/codeparrot_training.py,240,177,187,10,39,25,48,49,73,239.349967484501,6.15384615384615,2522.30042227945,140.127801237747,409.87381862041,31,47.5747541130533,0,0
transformers_4.13.0,examples/research_projects/codeparrot/scripts/preprocessing.py,122,97,83,8,28,17,32,36,49,158.605937817613,4.57142857142857,1158.06320032308,64.3368444623932,253.326325070673,16,53.1381439937101,0,0
transformers_4.13.0,examples/research_projects/codeparrot/scripts/initialize_model.py,22,10,9,0,0,0,0,0,0,0,0,0,0,0,1,100,0,0
transformers_4.13.0,examples/research_projects/codeparrot/scripts/bpe_training.py,32,16,18,0,0,0,0,0,0,0,0,0,0,0,3,100,0,0
transformers_4.13.0,examples/research_projects/codeparrot/scripts/arguments.py,175,130,139,1,1,2,2,2,4,0,1,4,0.222222222222222,4,1,69.3740872535111,0,0
transformers_4.13.0,examples/research_projects/fsner/setup.py,27,5,24,0,0,0,0,0,0,0,0,0,0,0,1,100,0,0
transformers_4.13.0,examples/research_projects/fsner/src/fsner/__init__.py,5,3,3,0,0,0,0,0,0,0,0,0,0,0,1,100,0,0
transformers_4.13.0,examples/research_projects/fsner/src/fsner/tokenizer_utils.py,101,45,62,5,16,8,16,21,24,75.6096404744368,2.5,263.539045366726,14.6410580759292,105.41561814669,19,75.3049168475936,0,0
transformers_4.13.0,examples/research_projects/fsner/src/fsner/model.py,80,47,43,5,13,10,20,18,30,59.715356810271,3.84615384615385,481.145192474113,26.7302884707841,125.097750043269,9,76.098077250786,0,0
transformers_4.13.0,examples/research_projects/bertology/run_prune_gpt.py,389,195,292,17,97,77,136,114,213,709.678413993407,11.9175257731959,17344.8334268841,963.601857049116,1455.40557301709,45,42.7216550875276,0,0
transformers_4.13.0,examples/research_projects/bertology/run_bertology.py,450,206,325,18,105,83,147,123,230,780.054429380905,12.6,20119.4070364731,1117.74483535962,1596.77833622803,46,44.4138756956605,0,0
transformers_4.13.0,examples/research_projects/jax-projects/model_parallel/run_clm_mp.py,649,324,466,15,116,86,162,131,248,854.129154368926,10.4741379310345,18269.9225760626,1014.99569867015,1744.28890438129,61,37.6077168196155,0,0
transformers_4.13.0,examples/research_projects/jax-projects/model_parallel/partitions.py,85,35,47,4,10,5,10,14,15,41.2192809488736,2,114.220647661728,6.34559153676267,57.1103238308641,8,82.1290811392078,0,0
transformers_4.13.0,examples/research_projects/jax-projects/big_bird/bigbird_flax.py,321,255,249,12,60,39,72,72,111,397.432985745165,7.2,4931.0040611527,273.944670064039,684.861675160097,23,36.8909136542936,0,0
transformers_4.13.0,examples/research_projects/jax-projects/big_bird/evaluate.py,165,108,119,17,74,47,89,91,136,528.986417357798,10.222972972973,9047.94518597571,502.663621443095,885.060071067023,21,46.2674168393145,0,0
transformers_4.13.0,examples/research_projects/jax-projects/big_bird/train.py,78,47,62,6,18,10,20,24,30,90.5684250302886,3.33333333333333,458.496250072116,25.4720138928953,137.548875021635,4,58.6457107662884,0,0
transformers_4.13.0,examples/research_projects/jax-projects/big_bird/prepare_natural_questions.py,330,207,264,14,95,87,151,109,238,677.439251700246,11.1263157894737,17922.5795562824,995.698864237914,1610.82786929691,48,38.2692622337096,0,0
transformers_4.13.0,examples/research_projects/jax-projects/dataset-streaming/run_mlm_flax_stream.py,624,296,405,19,112,78,146,131,224,843.13437402588,12.3839285714286,19510.7154062649,1083.92863368138,1575.48675234439,53,42.6242422646994,1,1
transformers_4.13.0,examples/research_projects/jax-projects/wav2vec2/run_wav2vec2_pretrain_flax.py,601,268,414,18,110,77,137,128,214,821.008218513674,11.2090909090909,16791.2181818182,932.845454545455,1498,28,44.3333626454374,0,0
transformers_4.13.0,examples/research_projects/jax-projects/hybrid_clip/configuration_hybrid_clip.py,112,40,37,2,6,4,8,8,12,17.5097750043269,1.33333333333333,48,2.66666666666667,36,8,75.652735932817,0,0
transformers_4.13.0,examples/research_projects/jax-projects/hybrid_clip/modeling_hybrid_clip.py,423,147,259,10,45,38,67,55,105,280.352670283709,7.44444444444444,4519.09617607178,251.060898670654,607.042769920089,40,55.394699649548,0,0
transformers_4.13.0,examples/research_projects/jax-projects/hybrid_clip/run_hybrid_clip.py,565,268,395,11,68,45,88,79,133,452.001221010033,7.11764705882353,5967.45550473024,331.525305818347,838.402839507555,43,44.0560565341269,0,0
transformers_4.13.0,examples/research_projects/deebert/test_glue_deebert.py,104,36,84,1,2,1,2,3,3,2,0.5,2.37744375108173,0.13208020839343,4.75488750216347,6,75.8800371103732,0,0
transformers_4.13.0,examples/research_projects/deebert/run_glue_deebert.py,731,409,614,18,218,187,338,236,525,1768.52283282733,13.954128440367,57747.5921191896,3208.1995621772,4138.38760091497,146,13.7740255100853,0,0
transformers_4.13.0,examples/research_projects/deebert/src/modeling_highway_roberta.py,156,76,103,6,17,23,33,23,56,84.9966433055827,5.82352941176471,1475.21338143412,81.9562989685624,253.319469539193,14,67.0062222619852,0,0
transformers_4.13.0,examples/research_projects/deebert/src/__init__.py,0,0,0,0,0,0,0,0,0,0,0,0,0,0,1,100,0,0
transformers_4.13.0,examples/research_projects/deebert/src/modeling_highway_bert.py,396,203,253,13,72,63,109,85,172,492.340316439681,9.84027777777778,10848.0721980502,602.670677669454,1102.41524101568,55,48.5790550982671,0,0
transformers_4.13.0,examples/research_projects/rag/callbacks_rag.py,116,78,89,5,23,15,29,28,44,115.651565463748,3.15217391304348,666.75922614625,37.0421792303472,211.523616570535,21,56.6378815186348,0,0
transformers_4.13.0,examples/research_projects/rag/lightning_base.py,391,173,329,10,37,22,43,47,65,225.969055477145,5.81081081081081,2097.98322168095,116.554623426719,361.048275359046,48,39.7160530905539,0,0
transformers_4.13.0,examples/research_projects/rag/test_distributed_retriever.py,338,165,290,5,15,11,16,20,27,70.2129994085646,2.66666666666667,311.17882283189,17.2877123795495,116.692058561959,31,47.776010799966,0,0
transformers_4.13.0,examples/research_projects/rag/distributed_ray_retriever.py,151,57,82,6,19,10,20,25,30,96.2203977597551,3.15789473684211,439.944270610237,24.4413483672354,139.315685693242,21,73.0676978305568,0,0
transformers_4.13.0,examples/research_projects/rag/__init__.py,5,3,3,0,0,0,0,0,0,0,0,0,0,0,1,100,0,0
transformers_4.13.0,examples/research_projects/rag/_test_finetune_rag.py,110,62,95,3,6,3,6,9,9,20.2646625064904,1.5,42.7939875194712,2.37744375108173,28.5293250129808,11,49.2313297839637,0,0
transformers_4.13.0,examples/research_projects/rag/use_own_knowledge_dataset.py,204,95,138,5,18,10,20,23,30,86.6682905003984,2.77777777777778,376.963496338084,20.9424164632269,135.70685868171,11,63.6476390448144,0,0
transformers_4.13.0,examples/research_projects/rag/utils_rag.py,244,155,187,11,49,30,57,60,87,313.174530166655,6.39795918367347,3287.90790918213,182.661550510119,513.899481817941,34,37.3916007859281,0,0
transformers_4.13.0,examples/research_projects/rag/parse_dpr_relevance_data.py,47,19,33,2,5,3,6,7,9,13.6096404744368,1.2,30.3194331582221,1.68441295323456,25.2661942985184,4,84.3486848748723,0,0
transformers_4.13.0,examples/research_projects/rag/eval_rag.py,312,163,264,12,44,31,60,56,91,283.234541228695,8.18181818181818,4323.83971015016,240.213317230564,528.469297907242,38,34.9428478923203,0,0
transformers_4.13.0,examples/research_projects/rag/finetune_rag.py,617,320,518,16,95,65,123,111,188,688.13628279144,10.3578947368421,13230.658736293,735.036596460725,1277.35018287382,98,22.7859649602574,0,0
transformers_4.13.0,examples/research_projects/rag/distributed_pytorch_retriever.py,138,59,62,4,10,6,10,14,16,41.2192809488736,2,121.835357505843,6.76863097254685,60.9176787529217,18,74.3121998509071,0,0
transformers_4.13.0,examples/research_projects/rag/consolidate_rag_checkpoint.py,99,37,74,3,11,8,16,14,24,42.8086353071737,2.18181818181818,199.366948645925,11.0759415914403,91.3765181293825,7,67.3883218084813,0,0
transformers_4.13.0,examples/research_projects/visual_bert/utils.py,559,367,425,16,111,71,130,127,201,818.180161164862,9.36936936936937,13161.3932155212,731.1885119734,1404.72562204121,94,26.9174600070731,0,0
transformers_4.13.0,examples/research_projects/visual_bert/extracting_data.py,149,101,120,9,28,21,36,37,57,163.135262830594,5.78571428571429,1718.00329922206,95.444627734559,296.93884184085,31,51.958422504243,0,0
transformers_4.13.0,examples/research_projects/visual_bert/modeling_frcnn.py,1921,1047,1338,21,381,301,546,402,847,3358.79824431331,15.0472440944882,110257.79004111,6125.43278006166,7327.44078242855,258,0,0,0
transformers_4.13.0,examples/research_projects/visual_bert/processing_image.py,149,100,102,9,36,28,51,45,79,214.646625064904,6.375,2765.83451563903,153.657473091057,433.856394610044,26,60.2737989332999,0,0
transformers_4.13.0,examples/research_projects/visual_bert/visualizing_image.py,499,171,451,16,105,71,135,121,206,768.995779354943,10.2857142857143,14660.082790751,814.44904393061,1425.28582687857,54,34.3003563606783,0,0
transformers_4.13.0,examples/research_projects/seq2seq-distillation/utils.py,645,432,470,15,102,76,138,117,214,739.19074381522,10.1470588235294,14918.7949190248,828.821939945821,1470.25804999085,112,22.4166753541796,0,0
transformers_4.13.0,examples/research_projects/seq2seq-distillation/run_eval.py,164,90,119,11,29,17,34,40,51,178.93519666371,6.44827586206897,1750.18028417037,97.2322380094651,271.418332839255,25,58.0619717941186,0,0
transformers_4.13.0,examples/research_projects/seq2seq-distillation/_test_seq2seq_examples_multi_gpu.py,164,62,141,8,20,16,27,28,43,110.438561897747,5.4,1116.26781290178,62.0148784945431,206.716261648477,13,54.0619037503401,0,0
transformers_4.13.0,examples/research_projects/seq2seq-distillation/lightning_base.py,391,174,329,10,35,21,41,45,62,212.744186541947,5.85714285714286,1994.32722441001,110.795956911667,340.49489197244,48,39.4575973790452,0,0
transformers_4.13.0,examples/research_projects/seq2seq-distillation/sentence_splitter.py,22,15,14,0,0,0,0,0,0,0,0,0,0,0,4,100,0,0
transformers_4.13.0,examples/research_projects/seq2seq-distillation/convert_pl_checkpoint_to_hf.py,74,47,44,4,7,4,7,11,11,27.6514844544032,2,76.1074956100206,4.2281942005567,38.0537478050103,14,75.7335882213974,0,0
transformers_4.13.0,examples/research_projects/seq2seq-distillation/callbacks.py,115,78,88,5,23,16,31,28,47,115.651565463748,3.3695652173913,761.338708851949,42.2965949362194,225.945681336707,22,55.4157579955977,0,0
transformers_4.13.0,examples/research_projects/seq2seq-distillation/make_student.py,185,99,140,7,18,17,34,25,51,94.7101344803648,6.61111111111111,1565.75351198571,86.9863062214284,236.836665678511,25,60.4181018756938,0,0
transformers_4.13.0,examples/research_projects/seq2seq-distillation/distillation.py,309,204,247,14,68,56,93,82,149,467.25044211383,9.57352941176471,9068.7674543522,503.820414130678,947.275248688095,45,42.0509958407077,0,0
transformers_4.13.0,examples/research_projects/seq2seq-distillation/finetune.py,443,269,378,16,86,58,108,102,166,616.65876890438,10.046511627907,11127.74339822,618.207966567778,1107.62260676727,76,27.1878026041556,0,0
transformers_4.13.0,examples/research_projects/seq2seq-distillation/_test_bash_script.py,203,107,151,8,45,28,52,53,80,271.133389334835,4.62222222222222,2118.05769697626,117.669872054237,458.233636365056,31,54.4280077355467,0,0
transformers_4.13.0,examples/research_projects/seq2seq-distillation/_test_make_student.py,39,29,29,0,0,0,0,0,0,0,0,0,0,0,7,100,0,0
transformers_4.13.0,examples/research_projects/seq2seq-distillation/_test_seq2seq_examples.py,444,236,384,10,46,41,67,56,108,287.303130927496,7.28260869565217,4567.61089304444,253.756160724691,627.194331582221,57,32.6259217782878,0,0
transformers_4.13.0,examples/research_projects/bertabs/modeling_bertabs.py,1058,559,608,17,161,142,250,178,392,1249.76448567771,13.1987577639752,38678.7947080435,2148.82192822464,2930.48750493883,126,27.3047660763773,0,0
transformers_4.13.0,examples/research_projects/bertabs/__init__.py,0,0,0,0,0,0,0,0,0,0,0,0,0,0,1,100,0,0
transformers_4.13.0,examples/research_projects/bertabs/configuration_bertabs.py,97,23,37,0,0,0,0,0,0,0,0,0,0,0,2,100,0,0
transformers_4.13.0,examples/research_projects/bertabs/utils_summarization.py,167,86,75,10,24,16,27,34,43,143.258380966181,5.625,1230.53007472743,68.3627819293014,218.760902173765,25,66.7815704983386,0,0
transformers_4.13.0,examples/research_projects/bertabs/test_utils_summarization.py,98,58,62,0,0,0,0,0,0,0,0,0,0,0,12,100,0,0
transformers_4.13.0,examples/research_projects/bertabs/run_summarization.py,347,136,251,6,27,18,29,33,47,143.891737562741,3.22222222222222,763.945464965064,42.4414147202813,237.086523609847,23,53.9357476070534,0,0
transformers_4.13.0,examples/research_projects/bertabs/convert_bertabs_original_pytorch_checkpoint.py,185,62,117,3,16,9,18,19,27,68.7548875021635,1.6875,193.546197331273,10.7525665184041,114.694042862977,4,73.315104043426,0,0
transformers_4.13.0,examples/research_projects/lxmert/utils.py,559,367,425,16,111,71,130,127,201,818.180161164862,9.36936936936937,13161.3932155212,731.1885119734,1404.72562204121,94,26.9174600070731,0,0
transformers_4.13.0,examples/research_projects/lxmert/extracting_data.py,149,101,120,9,28,21,36,37,57,163.135262830594,5.78571428571429,1718.00329922206,95.444627734559,296.93884184085,31,51.958422504243,0,0
transformers_4.13.0,examples/research_projects/lxmert/modeling_frcnn.py,1921,1047,1338,21,381,301,546,402,847,3358.79824431331,15.0472440944882,110257.79004111,6125.43278006166,7327.44078242855,258,0,0,0
transformers_4.13.0,examples/research_projects/lxmert/processing_image.py,149,100,102,9,36,28,51,45,79,214.646625064904,6.375,2765.83451563903,153.657473091057,433.856394610044,26,60.2737989332999,0,0
transformers_4.13.0,examples/research_projects/lxmert/visualizing_image.py,499,171,451,16,105,71,135,121,206,768.995779354943,10.2857142857143,14660.082790751,814.44904393061,1425.28582687857,54,34.3003563606783,0,0
transformers_4.13.0,examples/research_projects/mlm_wwm/run_chinese_ref.py,147,95,106,12,77,52,106,89,158,525.562113642161,8.25974025974026,8451.08442871365,469.504690484092,1023.16588209269,47,53.142017100226,0,0
transformers_4.13.0,examples/research_projects/mlm_wwm/run_mlm_wwm.py,408,190,295,12,58,41,75,70,116,382.782447726053,7.75862068965517,5516.35471525047,306.464150847248,710.996829965616,54,47.4642330948964,0,0
transformers_4.13.0,examples/research_projects/wav2vec2/run_asr.py,473,235,331,10,51,31,59,61,90,322.51297338942,5.7843137254902,3087.4720845548,171.526226919711,533.76636038066,39,49.0223224464803,0,0
transformers_4.13.0,examples/research_projects/wav2vec2/test_wav2vec2_deepspeed.py,201,65,140,2,8,4,8,10,12,26,1,39.8631371386484,2.21461872992491,39.8631371386484,12,74.1378274285996,0,0
transformers_4.13.0,examples/research_projects/wav2vec2/run_pretrain.py,394,160,262,15,37,30,53,52,83,251.353133462399,10.7432432432432,5083.02047029108,282.390026127282,473.136496605711,24,55.7308016490464,0,0
transformers_4.13.0,examples/research_projects/wav2vec2/run_common_voice.py,506,229,351,12,47,34,62,59,96,304.085226037503,7.91489361702128,4469.80741657043,248.322634253913,564.733732738737,39,48.1363928855319,0,0
transformers_4.13.0,examples/research_projects/pplm/run_pplm_discrim_train.py,522,309,397,12,67,45,88,79,133,449.447525769325,7.88059701492537,6607.11491432819,367.0619396849,838.402839507555,52,32.7479085019782,0,0
transformers_4.13.0,examples/research_projects/pplm/run_pplm.py,827,384,648,17,151,135,238,168,373,1162.48598393934,13.3973509933775,36940.9767454502,2052.27648585834,2757.33439869648,83,26.7806197622101,0,0
transformers_4.13.0,examples/research_projects/pplm/pplm_classification_head.py,19,11,10,0,0,0,0,0,0,0,0,0,0,0,3,100,0,0
transformers_4.13.0,examples/research_projects/mm-imdb/run_mmimdb.py,572,306,457,17,130,120,214,147,334,982.394683994955,13.9923076923077,33647.1702647381,1869.28723692989,2404.69056317535,87,29.2140022287853,0,0
transformers_4.13.0,examples/research_projects/mm-imdb/utils_mmimdb.py,146,71,104,1,2,3,3,3,6,2,0.75,7.1323312532452,0.396240625180289,9.50977500432694,16,72.3447174106491,0,0
transformers_4.13.0,examples/research_projects/rag-end2end-retriever/callbacks_rag.py,119,80,91,5,24,16,31,29,47,121.648740491745,3.22916666666667,737.299823948008,40.9611013304449,228.325106770996,22,55.867476434224,0,0
transformers_4.13.0,examples/research_projects/rag-end2end-retriever/lightning_base.py,415,183,342,11,55,32,63,66,95,356.028532048867,6.3,3617.56988043603,200.976104468669,574.217441339053,54,40.1426805532867,0,0
transformers_4.13.0,examples/research_projects/rag-end2end-retriever/distributed_ray_retriever.py,185,69,103,6,19,10,20,25,30,96.2203977597551,3.15789473684211,439.944270610237,24.4413483672354,139.315685693242,25,70.6481313757007,0,0
transformers_4.13.0,examples/research_projects/rag-end2end-retriever/use_own_knowledge_dataset.py,171,84,118,5,16,10,20,21,30,75.6096404744368,3.125,411.779758385509,22.8766532436394,131.769522683363,10,63.8620754677347,0,0
transformers_4.13.0,examples/research_projects/rag-end2end-retriever/utils_rag.py,244,155,187,11,49,30,57,60,87,313.174530166655,6.39795918367347,3287.90790918213,182.661550510119,513.899481817941,34,37.3916007859281,0,0
transformers_4.13.0,examples/research_projects/rag-end2end-retriever/eval_rag.py,312,163,264,12,44,31,60,56,91,283.234541228695,8.18181818181818,4323.83971015016,240.213317230564,528.469297907242,38,34.9428478923203,0,0
transformers_4.13.0,examples/research_projects/rag-end2end-retriever/finetune_rag.py,789,407,656,17,133,87,164,150,251,1007.83943222291,10.4812030075188,19017.445766108,1056.52476478378,1814.43349131447,112,18.6587658350265,0,0
transformers_4.13.0,examples/research_projects/rag-end2end-retriever/kb_encode_utils.py,81,49,59,2,9,5,10,11,15,30.5293250129808,1.11111111111111,57.657193643955,3.20317742466416,51.8914742795595,8,63.2152865599177,0,0
transformers_4.13.0,examples/research_projects/distillation/utils.py,133,72,78,12,41,42,78,53,120,262.679182197995,11.4146341463415,7845.85396898218,435.880776054565,687.350454547584,15,66.1162866051217,0,0
transformers_4.13.0,examples/research_projects/distillation/train.py,322,158,249,11,62,52,99,73,151,407.213919048997,8.78225806451613,8208.45613417477,456.025340787487,934.663508390883,40,45.3813463683339,0,0
transformers_4.13.0,examples/research_projects/distillation/distiller.py,600,363,426,21,182,165,291,203,456,1458.65729039452,16.7884615384615,58682.2739346233,3260.1263297013,3495.39317823644,101,31.5029834629402,0,0
transformers_4.13.0,examples/research_projects/distillation/grouped_batch_sampler.py,108,61,57,8,22,17,33,30,50,122.107495610021,6,1472.06717868256,81.7815099268086,245.344529780426,14,71.3792163039776,0,0
transformers_4.13.0,examples/research_projects/distillation/run_squad_w_distillation.py,871,391,693,18,184,165,297,202,462,1459.39404994045,14.5271739130435,51398.5025736345,2855.47236520192,3538.09370503133,127,19.4178252483524,0,0
transformers_4.13.0,examples/research_projects/distillation/lm_seqs_dataset.py,166,100,91,13,50,32,60,63,92,330.29852582457,7.8,4289.29607310354,238.29422628353,549.909752961992,33,61.9853951624288,0,0
transformers_4.13.0,examples/research_projects/distillation/scripts/token_counts.py,56,26,33,2,4,2,4,6,6,10,1,15.5097750043269,0.861654166907052,15.5097750043269,4,89.3968683714619,0,0
transformers_4.13.0,examples/research_projects/distillation/scripts/extract_distilbert.py,92,44,61,2,6,3,6,8,9,17.5097750043269,1,27,1.5,27,9,79.3062688267697,0,0
transformers_4.13.0,examples/research_projects/distillation/scripts/binarized_data.py,96,62,65,6,16,10,20,22,30,79.5097750043269,3.75,501.686057096696,27.8714476164831,133.782948559119,10,72.2499464344665,0,0
transformers_4.13.0,examples/research_projects/distillation/scripts/extract.py,102,56,70,2,7,8,16,9,24,21.6514844544032,2.28571428571429,173.89302865055,9.66072381391943,76.0782000346155,20,72.5083336954177,0,0
transformers_4.13.0,examples/legacy/run_language_modeling.py,364,148,271,13,40,26,47,53,73,260.982840131329,7.6375,3193.53045043603,177.418358357557,418.138193183114,34,51.7687077415196,0,0
transformers_4.13.0,examples/legacy/run_chinese_ref.py,148,95,106,12,77,52,106,89,158,525.562113642161,8.25974025974026,8451.08442871365,469.504690484092,1023.16588209269,47,53.5005332687855,0,0
transformers_4.13.0,examples/legacy/run_swag.py,720,365,522,18,173,143,260,191,403,1361.24933340712,13.5260115606936,41304.433141123,2294.69073006239,3053.70381769841,110,27.8575659717716,0,0
transformers_4.13.0,examples/legacy/run_openai_gpt.py,320,198,230,13,76,50,93,89,143,522.948207357547,7.95394736842105,7365.59293210189,409.199607338994,926.029880628195,34,48.2811623586228,0,0
transformers_4.13.0,examples/legacy/run_transfo_xl.py,145,81,88,10,35,23,45,45,68,212.744186541947,6.42857142857143,2400.7243535384,133.373575196578,373.446010550418,14,66.3918012785162,0,0
transformers_4.13.0,examples/legacy/run_camembert.py,47,26,39,2,6,3,6,8,9,17.5097750043269,1,27,1.5,27,5,76.4492276593583,0,0
transformers_4.13.0,examples/legacy/text-classification/run_tf_text_classification.py,310,134,221,6,34,20,41,40,61,188.483511606839,3.61764705882353,1174.42430870411,65.2457949280063,324.637613788129,32,53.8546299100228,0,0
transformers_4.13.0,examples/legacy/token-classification/tasks.py,163,103,143,7,32,23,46,39,69,179.651484454403,5.03125,1834.8604140419,101.936689668994,364.692753101495,36,41.9556575788578,0,0
transformers_4.13.0,examples/legacy/token-classification/utils_ner.py,372,164,243,13,76,57,112,89,169,522.948207357547,9.57894736842105,10483.1899405087,582.39944113937,1094.39894983332,41,52.0239116685642,0,0
transformers_4.13.0,examples/legacy/token-classification/run_ner.py,321,128,230,7,22,13,25,29,38,117.758980064424,3.97727272727273,734.217582218145,40.7898656787858,184.603277814848,28,57.9545031821359,0,0
transformers_4.13.0,examples/legacy/token-classification/run_tf_ner.py,307,124,217,10,31,17,34,41,51,186.799366570867,5.48387096774194,1498.38631871093,83.2436843728294,273.235152235522,25,56.4179450460323,0,0
transformers_4.13.0,examples/legacy/token-classification/scripts/preprocess.py,41,26,26,5,7,6,11,12,17,31.26112492884,3.92857142857143,239.424281298163,13.3013489610091,60.9443625122597,5,71.8572040458364,0,0
transformers_4.13.0,examples/legacy/pytorch-lightning/lightning_base.py,391,174,329,10,35,21,41,45,62,212.744186541947,5.85714285714286,1994.32722441001,110.795956911667,340.49489197244,48,39.4575973790452,0,0
transformers_4.13.0,examples/legacy/pytorch-lightning/run_ner.py,215,133,166,7,22,14,26,29,40,117.758980064424,4.13636363636364,803.775037375653,44.6541687430918,194.319239805103,39,50.8390162176297,0,0
transformers_4.13.0,examples/legacy/pytorch-lightning/run_glue.py,201,129,153,7,27,17,31,34,48,148.033447012817,4.01851851851852,981.315054712288,54.5175030395715,244.198216380016,39,41.609160968229,0,0
transformers_4.13.0,examples/legacy/question-answering/run_squad.py,830,378,639,16,167,146,260,183,406,1297.07861684317,12.4550898203593,38005.1389187671,2111.39660659817,3051.37413434332,125,21.7245901035397,0,0
transformers_4.13.0,examples/legacy/question-answering/run_squad_trainer.py,185,57,120,6,17,10,19,23,29,84.9966433055827,3.35294117647059,439.849877256603,24.4361042920335,131.183296725653,18,71.8162642540055,0,0
transformers_4.13.0,examples/legacy/seq2seq/finetune_trainer.py,367,146,264,8,29,21,38,37,59,164.8814488587,5.24137931034483,1610.97854424001,89.4988080133341,307.357748572108,36,53.7826420657556,0,0
transformers_4.13.0,examples/legacy/seq2seq/utils.py,664,437,475,15,105,78,141,120,219,763.599138289071,10.0714285714286,15234.1339072711,846.340772626172,1512.60904043827,112,24.1637457942975,0,0
transformers_4.13.0,examples/legacy/seq2seq/run_eval.py,182,91,120,11,33,19,38,44,57,204.518753743839,6.33333333333333,1970.85481432806,109.491934129337,311.187602262326,27,61.8271613835925,0,0
transformers_4.13.0,examples/legacy/seq2seq/old_test_fsmt_bleu_score.py,71,33,45,2,4,2,4,6,6,10,1,15.5097750043269,0.861654166907052,15.5097750043269,5,85.4779996147926,0,0
transformers_4.13.0,examples/legacy/seq2seq/sentence_splitter.py,35,15,14,0,0,0,0,0,0,0,0,0,0,0,4,100,0,0
transformers_4.13.0,examples/legacy/seq2seq/run_distributed_eval.py,262,140,214,13,36,22,44,49,66,234.223016387757,7.94444444444444,2943.97952826441,163.554418236912,370.570849711604,29,51.499293339555,0,0
transformers_4.13.0,examples/legacy/seq2seq/old_test_seq2seq_examples_multi_gpu.py,55,20,30,1,4,2,4,5,6,8,0.5,6.96578428466209,0.38698801581456,13.9315685693242,3,92.3969012832702,0,0
transformers_4.13.0,examples/legacy/seq2seq/rouge_cli.py,31,13,11,2,4,2,4,6,6,10,1,15.5097750043269,0.861654166907052,15.5097750043269,5,87.7474176305963,0,0
transformers_4.13.0,examples/legacy/seq2seq/old_test_tatoeba_conversion.py,38,19,19,1,2,1,2,3,3,2,0.5,2.37744375108173,0.13208020839343,4.75488750216347,5,95.632079094799,0,0
transformers_4.13.0,examples/legacy/seq2seq/__init__.py,5,3,3,0,0,0,0,0,0,0,0,0,0,0,1,100,0,0
transformers_4.13.0,examples/legacy/seq2seq/pack_dataset.py,88,52,51,5,23,15,30,28,45,115.651565463748,3.26086956521739,705.427080954105,39.1903933863392,216.330971492592,11,73.5081676749319,0,0
transformers_4.13.0,examples/legacy/seq2seq/old_test_seq2seq_examples.py,131,71,94,5,23,14,26,28,40,115.651565463748,2.82608695652174,543.440121623903,30.1911178679946,192.294196882304,16,64.9390393765469,0,0
transformers_4.13.0,examples/legacy/seq2seq/seq2seq_trainer.py,258,121,178,11,48,39,68,59,107,306.131947839626,7.79166666666667,4904.40853227838,272.467140682132,629.442806281717,50,52.9495606980834,0,0
transformers_4.13.0,examples/legacy/seq2seq/seq2seq_training_args.py,59,27,30,0,0,0,0,0,0,0,0,0,0,0,1,100,0,0
transformers_4.13.0,examples/legacy/seq2seq/download_wmt.py,67,30,29,3,9,5,10,12,15,33.2842125151443,1.66666666666667,89.6240625180289,4.97911458433494,53.7744375108174,7,81.7500751511226,0,0
transformers_4.13.0,examples/legacy/seq2seq/save_len_file.py,56,29,33,1,2,1,2,3,3,2,0.5,2.37744375108173,0.13208020839343,4.75488750216347,2,91.6164746622838,0,0
transformers_4.13.0,examples/legacy/seq2seq/old_test_datasets.py,247,151,202,13,78,50,95,91,145,538.36708940709,7.91666666666667,7470.40593072809,415.022551707116,943.630222828811,57,45.1844335082117,0,0
transformers_4.13.0,examples/legacy/seq2seq/save_randomly_initialized_model.py,39,11,10,1,2,1,2,3,3,2,0.5,2.37744375108173,0.13208020839343,4.75488750216347,2,74.2654504356407,0,0
transformers_4.13.0,examples/legacy/seq2seq/xla_spawn.py,85,23,36,2,6,3,6,8,9,17.5097750043269,1,27,1.5,27,2,87.7524545208784,0,0
transformers_4.13.0,examples/legacy/seq2seq/run_eval_search.py,151,68,80,5,15,8,16,20,24,70.2129994085646,2.66666666666667,276.603398072791,15.3668554484884,103.726274277297,22,72.1740112576791,0,0
transformers_4.13.0,examples/legacy/seq2seq/convert_model_to_fp16.py,36,16,15,3,5,3,5,8,8,16.3645279766003,1.5,36,2,24,5,89.0389097782268,0,0
transformers_4.13.0,examples/legacy/seq2seq/minify_dataset.py,34,15,13,1,2,1,2,3,3,2,0.5,2.37744375108173,0.13208020839343,4.75488750216347,4,93.5313910858761,0,0
transformers_4.13.0,examples/legacy/seq2seq/old_test_calculate_rouge.py,94,38,61,2,10,5,10,12,15,35.2192809488736,1,53.7744375108174,2.98746875060096,53.7744375108174,9,76.1057858529345,0,0
transformers_4.13.0,examples/legacy/seq2seq/test_data/fsmt/build-eval-data.py,33,20,24,0,0,0,0,0,0,0,0,0,0,0,2,100,0,0
transformers_4.13.0,examples/legacy/multiple_choice/utils_multiple_choice.py,579,319,405,11,79,49,95,90,144,536.052426911001,6.61392405063291,6182.87375908664,343.492986615925,934.826845871473,73,34.834657098631,0,0
transformers_4.13.0,examples/legacy/multiple_choice/run_multiple_choice.py,242,87,164,8,21,12,23,29,35,116.238665878354,4.38095238095238,744.890419252895,41.3828010696053,170.029334829465,20,64.3493911378689,0,0
transformers_4.13.0,examples/onnx/pytorch/summarization/run_onnx_exporter.py,205,80,146,3,6,3,6,9,9,20.2646625064904,1.5,42.7939875194712,2.37744375108173,28.5293250129808,7,66.8003617696253,0,0
transformers_4.13.0,examples/onnx/pytorch/summarization/bart_onnx/generation_onnx.py,756,378,563,19,176,141,257,195,398,1393.57058763559,13.8721590909091,42000.9783550331,2333.38768639073,3027.71746487235,94,26.9281449627508,0,0
transformers_4.13.0,examples/onnx/pytorch/summarization/bart_onnx/reduce_onnx_size.py,122,81,79,7,33,25,50,40,75,186.116490393232,5.3030303030303,2116.6759468302,117.593108157233,399.144607116552,23,54.9747964408018,0,0
transformers_4.13.0,templates/adding_a_new_example_script/{{cookiecutter.directory_name}}/run_{{cookiecutter.example_shortcut}}.py,893,407,686,0,0,0,0,0,0,398.38777,5.18244,12377.577,687.6365,945.83,70,60.8,0,0
transformers_4.13.0,templates/adding_a_new_model/cookiecutter-template-{{cookiecutter.modelname}}/configuration_{{cookiecutter.lowercase_modelname}}.py,240,45,101,13,78,50,95,91,145,538.36708940709,7.91666666666667,7470.40593072809,415.022551707116,943.630222828811,57,45.1844335082117,0,0
transformers_4.13.0,templates/adding_a_new_model/cookiecutter-template-{{cookiecutter.modelname}}/__init__.py,213,77,181,13,78,50,95,91,145,538.36708940709,7.91666666666667,7470.40593072809,415.022551707116,943.630222828811,57,45.1844335082117,0,0
transformers_4.13.0,templates/adding_a_new_model/cookiecutter-template-{{cookiecutter.modelname}}/modeling_{{cookiecutter.lowercase_modelname}}.py,3363,1365,2333,19,470,383,718,489,1101,4252.67358764098,14.5127659574468,142747.470334318,7930.41501857323,9835.99341110241,464,0,0,0
transformers_4.13.0,templates/adding_a_new_model/cookiecutter-template-{{cookiecutter.modelname}}/modeling_flax_{{cookiecutter.lowercase_modelname}}.py,669,325,489,15,105,78,141,120,219,763.599138289071,10.0714285714286,15234.1339072711,846.340772626172,1512.60904043827,112,24.1637457942975,0,0
transformers_4.13.0,templates/adding_a_new_model/cookiecutter-template-{{cookiecutter.modelname}}/modeling_tf_{{cookiecutter.lowercase_modelname}}.py,3270,1121,2388,18,307,344,617,325,961,2611.52176755461,18.0879478827362,145044.87310999,8058.04850611055,8018.8683675071,340,0,0,0
transformers_4.13.0,templates/adding_a_new_model/cookiecutter-template-{{cookiecutter.modelname}}/test_modeling_{{cookiecutter.lowercase_modelname}}.py,1070,524,861,18,307,344,617,325,961,2611.52176755461,18.0879478827362,145044.87310999,8058.04850611055,8018.8683675071,340,0,0,0
transformers_4.13.0,templates/adding_a_new_model/cookiecutter-template-{{cookiecutter.modelname}}/test_modeling_flax_{{cookiecutter.lowercase_modelname}}.py,669,326,547,21,182,165,291,203,456,1458.65729039452,16.7884615384615,58682.2739346233,3260.1263297013,3495.39317823644,101,31.5029834629402,0,0
transformers_4.13.0,templates/adding_a_new_model/cookiecutter-template-{{cookiecutter.modelname}}/test_modeling_tf_{{cookiecutter.lowercase_modelname}}.py,700,336,558,21,182,165,291,203,456,1458.65729039452,16.7884615384615,58682.2739346233,3260.1263297013,3495.39317823644,101,31.5029834629402,0,0
transformers_4.13.0,templates/adding_a_new_model/cookiecutter-template-{{cookiecutter.modelname}}/tokenization_{{cookiecutter.lowercase_modelname}}.py,335,122,159,21,182,165,291,203,456,1458.65729039452,16.7884615384615,58682.2739346233,3260.1263297013,3495.39317823644,101,31.5029834629402,0,0
transformers_4.13.0,templates/adding_a_new_model/cookiecutter-template-{{cookiecutter.modelname}}/tokenization_fast_{{cookiecutter.lowercase_modelname}}.py,201,73,110,8,28,21,40,36,61,158.605937817613,5.71428571428571,1802.08814335989,100.116007964438,315.365425087981,33,59.493769604741,0,0
transformers_4.13.0,templates/adding_a_new_model/cookiecutter-template-{{cookiecutter.modelname}}/to_replace_{{cookiecutter.lowercase_modelname}}.py,472,146,259,15,66,49,90,81,139,457.533370811786,10.2272727272727,9012.67312910076,500.70406272782,881.239150400963,55,46.4581089902042,0,0
transformers_4.23.0,./hubconf.py,161,34,36,0,0,0,0,0,0,0,0,0,0,0,1,100,0,0
transformers_4.23.0,./conftest.py,77,30,34,2,4,2,4,6,6,10,1,15.5097750043269,0.861654166907052,15.5097750043269,5,87.9601513169638,0,0
transformers_4.23.0,./setup.py,442,79,303,3,108,54,108,111,162,734.282737735818,1.5,1651.04305552308,91.7246141957265,1100.69537034872,10,62.8428640283326,3,1
transformers_4.23.0,src/transformers/generation_flax_logits_process.py,268,118,122,12,52,42,69,64,111,339.442415351991,7.96153846153846,5302.38461538462,294.576923076923,666,31,60.0977536110766,0,0
transformers_4.23.0,src/transformers/feature_extraction_utils.py,576,234,261,10,36,23,39,46,62,219.336581000797,5.41666666666667,1854.99622357581,103.055345754212,342.460841275535,69,49.0981395181566,0,0
transformers_4.23.0,src/transformers/modeling_flax_outputs.py,642,211,116,0,0,0,0,0,0,0,0,0,0,0,1,100,0,0
transformers_4.23.0,src/transformers/modeling_tf_pytorch_utils.py,492,261,323,13,115,86,161,128,247,835.337072194437,9.1,15733.9,874.105555555556,1729,93,38.2395620963628,0,0
transformers_4.23.0,src/transformers/processing_utils.py,233,99,107,8,21,14,24,29,38,116.238665878354,4.57142857142857,843.900698582161,46.8833721434534,184.603277814848,37,63.9228448522255,0,0
transformers_4.23.0,src/transformers/activations_tf.py,134,49,57,6,44,26,51,50,77,255.724766224368,3.47727272727273,1511.14249481218,83.952360822899,434.576926612654,3,72.5876169799784,0,0
transformers_4.23.0,src/transformers/optimization_tf.py,365,133,207,12,43,27,51,55,78,276.348934460844,7.11627906976744,3209.05799168387,178.280999537993,450.946057654924,47,57.9383145982043,1,1
transformers_4.23.0,src/transformers/convert_tf_hub_seq_to_seq_bert_to_pytorch.py,88,26,58,1,2,1,2,3,3,2,0.5,2.37744375108173,0.13208020839343,4.75488750216347,3,90.7293933592469,0,0
transformers_4.23.0,src/transformers/debug_utils.py,346,129,132,9,24,16,31,33,47,138.568425030289,5.8125,1378.06541848224,76.5591899156799,237.086523609847,46,56.8954203872318,0,0
transformers_4.23.0,src/transformers/tokenization_utils.py,960,395,548,18,177,115,235,195,350,1396.82483239065,11.9491525423729,31815.402625724,1767.52236809578,2662.56560981236,150,28.3342227426208,0,0
transformers_4.23.0,src/transformers/convert_pytorch_checkpoint_to_tf2.py,491,93,430,11,39,29,54,50,83,244.184434340638,7.61538461538462,3567.35125472145,198.186180817859,468.440063751302,26,49.6127026616033,0,0
transformers_4.23.0,src/transformers/modeling_flax_utils.py,1093,415,589,15,97,73,138,112,211,698.794904626279,10.6701030927835,15326.0227283871,851.445707132617,1436.35188855415,121,33.7475435894916,0,0
transformers_4.23.0,src/transformers/configuration_utils.py,946,351,399,12,101,62,119,113,181,715.498909766585,7.06930693069307,8726.72285176995,484.817936209441,1234.45239219715,108,33.6503244864282,0,0
transformers_4.23.0,src/transformers/optimization.py,671,248,290,18,133,115,210,151,325,1013.41121394762,14.2105263157895,33430.0008355671,1857.22226864262,2352.48154028065,57,43.310290623821,1,1
transformers_4.23.0,src/transformers/trainer_pt_utils.py,1086,560,580,21,248,190,358,269,548,2064.8793508543,15.1572580645161,67042.9984170403,3724.61102316891,4423.16137468103,189,18.2532710505457,0,0
transformers_4.23.0,src/transformers/modeling_utils.py,3143,1392,1766,20,501,421,748,521,1169,4579.74062528855,14.9301397205589,157518.769160301,8751.04273112783,10550.3881483036,462,0,1,1
transformers_4.23.0,src/transformers/dependency_versions_table.py,82,2,79,0,0,0,0,0,0,0,0,0,0,0,1,100,2,1
transformers_4.23.0,src/transformers/tf_utils.py,70,17,15,3,6,3,6,9,9,20.2646625064904,1.5,42.7939875194712,2.37744375108173,28.5293250129808,5,57.7414711155087,0,0
transformers_4.23.0,src/transformers/dependency_versions_check.py,47,19,19,4,7,5,9,11,14,27.6514844544032,2.57142857142857,124.539538270943,6.9188632372746,48.4320426609222,7,84.2136442035513,0,0
transformers_4.23.0,src/transformers/trainer_utils.py,696,353,394,16,117,76,146,133,222,867.832672191258,9.98290598290598,15635.9531144933,868.664061916295,1566.27270068126,98,36.9063648348187,0,0
transformers_4.23.0,src/transformers/__init__.py,5571,1059,5432,2,54,46,54,56,100,312.763925116827,1,580.73549220576,32.26308290032,580.73549220576,107,6.84080715553065,1,1
transformers_4.23.0,src/transformers/file_utils.py,137,3,112,0,0,0,0,0,0,0,0,0,0,0,1,100,0,0
transformers_4.23.0,src/transformers/trainer.py,3609,1867,2446,20,746,607,1136,766,1743,7205.54029980815,15.2278820375335,254306.12667345,14128.118148525,16700.0326142952,762,0,1,1
transformers_4.23.0,src/transformers/dynamic_module_utils.py,441,161,208,11,57,41,72,68,113,370.528478612401,6.94736842105263,4778.97872316264,265.49881795348,687.883301061288,32,55.8753103634044,0,0
transformers_4.23.0,src/transformers/modeling_flax_pytorch_utils.py,352,179,218,10,130,100,180,140,280,946.127096642573,6.92307692307692,13819.8409251549,767.768940286381,1996.19924474459,64,44.9002052352233,0,0
transformers_4.23.0,src/transformers/modeling_tf_utils.py,3057,1345,1660,19,436,341,627,455,968,3903.63898835817,13.6616972477064,116768.870826722,6487.15949037345,8547.17160756331,426,0,1,1
transformers_4.23.0,src/transformers/generation_beam_constraints.py,520,275,287,15,84,60,105,99,165,595.558022447544,9.375,10254.7860216856,569.710334538092,1093.84384231314,108,39.4089262404964,0,0
transformers_4.23.0,src/transformers/modelcard.py,893,531,650,16,252,185,367,268,552,2074.27454072198,11.6507936507937,51874.9400812602,2881.94111562557,4452.48123313269,190,10.093806460719,0,0
transformers_4.23.0,src/transformers/keras_callbacks.py,410,221,258,14,100,63,118,114,181,717.688587886279,8.26,10215.5805445771,567.532252476508,1236.75309256382,90,43.6891804311453,0,0
transformers_4.23.0,src/transformers/generation_beam_search.py,897,376,577,20,139,138,254,159,392,1075.97137100631,18.273381294964,52383.3906540829,2910.18836967127,2866.65011847147,112,31.652577019179,0,0
transformers_4.23.0,src/transformers/convert_slow_tokenizers_checkpoints_to_fast.py,126,62,80,9,17,13,24,26,37,98.0161933142366,6.35294117647059,1104.87983021717,61.3822127898425,173.91626957122,15,67.5266417336722,0,0
transformers_4.23.0,src/transformers/modeling_tf_outputs.py,947,330,180,0,0,0,0,0,0,0,0,0,0,0,1,100,0,0
transformers_4.23.0,src/transformers/hf_argparser.py,307,154,162,11,60,44,86,71,130,392.467183541521,7.88333333333333,6302.46583963905,350.136991091058,799.467125535609,68,51.8624848250685,0,0
transformers_4.23.0,src/transformers/deepspeed.py,367,163,177,11,54,36,70,65,106,348.817672921838,7.12962962962963,4551.34871203132,252.852706223962,638.370988181016,41,55.722295874026,0,0
transformers_4.23.0,src/transformers/integrations.py,1319,827,941,13,271,182,338,284,520,2238.36810654273,8.1070110701107,34356.4468605422,1908.69149225234,4237.86850214244,287,0,1,1
transformers_4.23.0,src/transformers/generation_utils.py,3448,1073,1843,21,512,529,995,533,1524,4700.23866587835,20.4052734375,281682.135995809,15649.0075553227,13804.379385485,529,0,1,1
transformers_4.23.0,src/transformers/training_args.py,1732,682,1084,17,247,186,348,264,534,2032.73357450267,11.9757085020243,51444.128372078,2858.00713178211,4295.70645973741,223,11.5306855695881,1,1
transformers_4.23.0,src/transformers/feature_extraction_sequence_utils.py,367,132,186,15,82,56,110,97,166,579.922623312811,10.0609756097561,11022.6593138723,612.369961881793,1095.58553180306,66,52.6068453579491,0,0
transformers_4.23.0,src/transformers/image_utils.py,416,190,192,16,106,76,137,122,213,777.159568183699,10.3396226415094,15263.8374526357,847.99096959087,1476.24705290089,78,45.8150743676037,0,0
transformers_4.23.0,src/transformers/pytorch_utils.py,272,114,119,12,33,26,48,45,74,209.484555947483,8.72727272727273,3546.73858148418,197.041032304677,406.397129128396,24,61.3093609830403,0,0
transformers_4.23.0,src/transformers/generation_flax_utils.py,947,391,562,23,200,171,309,223,480,1632.81316294426,17.7675,66529.1947064803,3696.06637258224,3744.43195196175,102,33.2155508238226,0,0
transformers_4.23.0,src/transformers/activations.py,176,75,80,7,39,26,51,46,77,225.782170990031,4.57692307692308,1946.63070012886,108.146150007159,425.31427061639,18,67.3142614576239,0,0
transformers_4.23.0,src/transformers/training_args_tf.py,288,87,99,4,13,7,14,17,21,56.1057163358342,2.15384615384615,184.879088511938,10.2710604728855,85.8367196662571,22,57.2791943988896,0,0
transformers_4.23.0,src/transformers/testing_utils.py,1637,710,730,19,112,76,132,131,208,843.13437402588,11.1964285714286,16379.8373958662,909.990966437012,1462.95198431979,139,25.7557268009798,0,0
transformers_4.23.0,src/transformers/generation_stopping_criteria.py,132,58,73,9,17,13,24,26,37,98.0161933142366,6.35294117647059,1104.87983021717,61.3822127898425,173.91626957122,18,71.2650560714372,0,0
transformers_4.23.0,src/transformers/convert_slow_tokenizer.py,1162,492,923,12,58,49,88,70,137,382.782447726053,9.10344827586207,7644.27269506433,424.681816392463,839.711773321461,116,18.7615904257433,0,0
transformers_4.23.0,src/transformers/generation_tf_utils.py,3384,1261,1940,24,686,643,1201,710,1844,6573.57552961186,21.0087463556851,366933.91283094,20385.2173794967,17465.7690953389,469,0,1,1
transformers_4.23.0,src/transformers/trainer_callback.py,581,292,285,14,87,52,104,101,156,613.839053047646,8.36781609195402,8691.49151348455,482.860639638031,1038.68099130928,111,39.2533186939765,0,0
transformers_4.23.0,src/transformers/convert_graph_to_onnx.py,551,207,304,9,40,24,41,49,65,241.406448808475,4.6125,1683.36019513879,93.5200108410439,364.956139867489,36,55.3520507148969,0,0
transformers_4.23.0,src/transformers/trainer_seq2seq.py,253,84,119,11,62,47,88,73,135,407.213919048997,7.80645161290323,6523.27639801968,362.404244334427,835.626315448802,39,60.4923724245282,0,0
transformers_4.23.0,src/transformers/trainer_tf.py,804,377,452,18,135,110,214,153,324,1030.42875562782,14.2666666666667,33546.5495640625,1863.69719800347,2351.39366103242,121,32.095506319636,0,0
transformers_4.23.0,src/transformers/training_args_seq2seq.py,68,18,31,0,0,0,0,0,0,0,0,0,0,0,1,100,0,0
transformers_4.23.0,src/transformers/generation_logits_process.py,750,373,386,17,171,157,256,188,413,1337.93964834674,12.7251461988304,39703.0312627864,2205.72395904369,3120.04519574286,126,31.6436493158807,0,0
transformers_4.23.0,src/transformers/tokenization_utils_fast.py,763,315,494,12,137,101,203,149,304,1015.44994537425,8.89051094890511,19511.3574190406,1083.96430105781,2194.6272302205,134,31.2696701696404,0,0
transformers_4.23.0,src/transformers/generation_tf_logits_process.py,587,262,330,12,109,107,164,121,271,780.751641409339,9.02752293577982,16926.7132688495,940.372959380526,1875.01193730142,89,41.0582638702198,0,0
transformers_4.23.0,src/transformers/tokenization_utils_base.py,3737,1306,2133,18,505,370,702,523,1072,4610.02913673374,12.5108910891089,121116.374899838,6728.68749443546,9680.87517005672,481,0,1,1
transformers_4.23.0,src/transformers/modeling_outputs.py,1033,360,196,0,0,0,0,0,0,0,0,0,0,0,1,100,0,0
transformers_4.23.0,src/transformers/models/__init__.py,172,1,154,0,0,0,0,0,0,0,0,0,0,0,1,100,0,0
transformers_4.23.0,src/transformers/models/fnet/modeling_fnet.py,1199,552,814,13,90,130,221,103,351,632.372495005505,15.9611111111111,37460.1162284649,2081.11756824805,2346.96168504131,146,20.3901005544678,0,0
transformers_4.23.0,src/transformers/models/fnet/configuration_fnet.py,121,23,42,0,0,0,0,0,0,0,0,0,0,0,2,100,0,0
transformers_4.23.0,src/transformers/models/fnet/tokenization_fnet.py,315,124,155,10,73,48,88,83,136,485.076473747115,6.02739726027397,5225.78574755891,290.321430419939,867.005362663182,40,57.3881262375828,0,0
transformers_4.23.0,src/transformers/models/fnet/tokenization_fnet_fast.py,203,56,96,5,32,22,42,37,64,171.609640474437,3.28125,1093.98520678208,60.7769559323378,333.405015400253,13,70.5114527076085,0,0
transformers_4.23.0,src/transformers/models/fnet/convert_fnet_original_flax_checkpoint_to_pytorch.py,157,54,109,1,2,1,2,3,3,2,0.5,2.37744375108173,0.13208020839343,4.75488750216347,3,81.5475413145428,0,0
transformers_4.23.0,src/transformers/models/fnet/__init__.py,111,51,80,1,6,6,6,7,12,15.5097750043269,0.5,16.8441295323456,0.935784974019201,33.6882590646913,20,72.7463367205987,0,0
transformers_4.23.0,src/transformers/models/gpt_neo/configuration_gpt_neo.py,273,112,154,7,18,11,21,25,32,94.7101344803648,4.08333333333333,606.797208797231,33.7109560442906,148.603398072791,15,67.0847832123047,0,0
transformers_4.23.0,src/transformers/models/gpt_neo/__init__.py,85,37,56,1,4,4,4,5,8,8,0.5,9.28771237954945,0.51598402108608,18.5754247590989,14,81.1815199643737,0,0
transformers_4.23.0,src/transformers/models/gpt_neo/modeling_flax_gpt_neo.py,689,324,520,15,90,64,114,105,178,642.870137603799,9.5,11353.7891703734,630.766065020745,1195.13570214457,62,32.8687666238464,0,0
transformers_4.23.0,src/transformers/models/gpt_neo/modeling_gpt_neo.py,928,454,698,17,142,151,257,159,408,1084.75095927092,15.3838028169014,45899.9793581269,2549.99885322927,2983.65624575602,122,21.1027086114209,0,0
transformers_4.23.0,src/transformers/models/gpt_neo/convert_gpt_neo_mesh_tf_to_pytorch.py,72,21,42,1,2,1,2,3,3,2,0.5,2.37744375108173,0.13208020839343,4.75488750216347,2,94.7177109941608,0,0
transformers_4.23.0,src/transformers/models/mbart50/__init__.py,62,35,35,1,4,4,4,5,8,8,0.5,9.28771237954945,0.51598402108608,18.5754247590989,14,84.368768912279,0,0
transformers_4.23.0,src/transformers/models/mbart50/tokenization_mbart50_fast.py,276,98,153,7,44,30,57,51,87,259.866475674444,4.53409090909091,2237.5784192711,124.309912181728,493.50100475152,26,63.1221681850383,0,0
transformers_4.23.0,src/transformers/models/mbart50/tokenization_mbart50.py,353,144,178,11,71,42,81,82,123,474.685793289843,6.27464788732394,4906.64223128246,272.591235071248,781.978896568024,44,55.9747744120662,0,0
transformers_4.23.0,src/transformers/models/roberta/configuration_roberta.py,83,25,31,1,2,1,2,3,3,2,0.5,2.37744375108173,0.13208020839343,4.75488750216347,4,88.3713688664662,0,0
transformers_4.23.0,src/transformers/models/roberta/convert_roberta_original_pytorch_checkpoint_to_pytorch.py,178,101,124,4,9,10,17,13,27,36.5293250129808,3.77777777777778,377.444851250391,20.9691584027995,99.9118723898095,14,66.0276282077029,0,0
transformers_4.23.0,src/transformers/models/roberta/__init__.py,168,66,135,1,8,8,8,9,16,24,0.5,25.3594000115385,1.40885555619658,50.718800023077,26,64.0053657250376,0,0
transformers_4.23.0,src/transformers/models/roberta/tokenization_roberta.py,423,176,230,15,104,68,133,119,201,755.449089620801,9.59134615384615,13292.2473509503,738.458186163907,1385.8583704249,56,50.6983829737771,0,0
transformers_4.23.0,src/transformers/models/roberta/tokenization_roberta_fast.py,307,85,156,7,41,26,50,48,76,239.311116643745,4.26829268292683,1811.70734779491,100.650408210828,424.457150054808,23,65.564562842113,0,0
transformers_4.23.0,src/transformers/models/roberta/modeling_tf_roberta.py,1721,653,1243,12,133,160,277,145,437,981.372113930312,12.4962406015038,39208.457839273,2178.24765773739,3137.62027233653,184,11.7451903172859,1,1
transformers_4.23.0,src/transformers/models/roberta/modeling_roberta.py,1571,671,1112,15,173,211,365,188,576,1344.79404231528,15.8236994219653,68855.9289093948,3825.32938385527,4351.44317856632,193,10.0816071760933,0,0
transformers_4.23.0,src/transformers/models/roberta/modeling_flax_roberta.py,1494,611,1160,14,123,124,212,137,336,907.232253065533,12.0650406504065,28774.3833279196,1598.57685155109,2384.93877987474,130,15.908319747254,0,0
transformers_4.23.0,src/transformers/models/esm/convert_esm.py,264,141,187,5,15,14,24,20,38,70.2129994085646,4,656.933070422879,36.49628169016,164.23326760572,22,59.50641988339,0,0
transformers_4.23.0,src/transformers/models/esm/tokenization_esm.py,106,67,66,2,10,5,10,12,15,35.2192809488736,1,53.7744375108174,2.98746875060096,53.7744375108174,17,71.1487894961749,0,0
transformers_4.23.0,src/transformers/models/esm/modeling_esm.py,1241,578,875,16,182,188,330,198,518,1430.41862451616,14.5054945054945,57325.8118961059,3184.76732756144,3952.00672920124,161,15.7623296782151,0,0
transformers_4.23.0,src/transformers/models/esm/configuration_esm.py,142,29,50,0,0,0,0,0,0,0,0,0,0,0,2,100,0,0
transformers_4.23.0,src/transformers/models/esm/__init__.py,67,24,40,1,2,2,2,3,4,2,0.5,3.16992500144231,0.176106944524573,6.33985000288463,8,91.4547008233048,0,0
transformers_4.23.0,src/transformers/models/gpt_neox_japanese/modeling_gpt_neox_japanese.py,724,335,453,13,121,109,190,134,299,885.28816804606,10.2066115702479,21564.1274786313,1198.00708214618,2112.76066794687,78,38.1862012007681,0,0
transformers_4.23.0,src/transformers/models/gpt_neox_japanese/__init__.py,66,25,39,1,2,2,2,3,4,2,0.5,3.16992500144231,0.176106944524573,6.33985000288463,8,91.1896589477459,0,0
transformers_4.23.0,src/transformers/models/gpt_neox_japanese/configuration_gpt_neox_japanese.py,124,26,45,0,0,0,0,0,0,0,0,0,0,0,2,100,0,0
transformers_4.23.0,src/transformers/models/gpt_neox_japanese/tokenization_gpt_neox_japanese.py,379,214,253,15,125,82,159,140,241,929.326394516889,9.54,16391.2197555788,910.623319754381,1718.15720708374,60,45.0484917661514,0,0
transformers_4.23.0,src/transformers/models/albert/tokenization_albert.py,353,123,170,10,73,48,88,83,136,485.076473747115,6.02739726027397,5225.78574755891,290.321430419939,867.005362663182,40,57.4089591558754,0,0
transformers_4.23.0,src/transformers/models/albert/modeling_tf_albert.py,1500,530,1084,10,105,124,210,115,334,738.215060303816,10,22863.9367701542,1270.21870945301,2286.39367701542,134,20.7950161002422,0,0
transformers_4.23.0,src/transformers/models/albert/convert_albert_original_tf_checkpoint_to_pytorch.py,63,20,32,1,2,1,2,3,3,2,0.5,2.37744375108173,0.13208020839343,4.75488750216347,2,95.8446982931609,0,0
transformers_4.23.0,src/transformers/models/albert/modeling_albert.py,1407,624,998,17,195,206,368,212,574,1552.91627948243,16.0410256410256,71155.2040738231,3953.06689299017,4435.82634091928,168,13.1983008628233,0,0
transformers_4.23.0,src/transformers/models/albert/__init__.py,183,79,150,1,10,10,10,11,20,33.2192809488736,0.5,34.594316186373,1.9219064547985,69.188632372746,32,59.7286893556405,0,0
transformers_4.23.0,src/transformers/models/albert/modeling_flax_albert.py,1130,452,878,12,85,84,138,97,222,587.817779580359,9.74117647058823,14272.5832823467,792.921293463705,1465.18065096554,88,23.7025219553242,0,0
transformers_4.23.0,src/transformers/models/albert/configuration_albert.py,172,39,72,1,2,1,2,3,3,2,0.5,2.37744375108173,0.13208020839343,4.75488750216347,4,83.6917548443619,0,0
transformers_4.23.0,src/transformers/models/albert/tokenization_albert_fast.py,242,57,122,5,33,23,43,38,66,178.074646413266,3.25757575757576,1128.30441539037,62.6835786327984,346.363215887277,14,70.9045626182638,0,0
transformers_4.23.0,src/transformers/models/vit/modeling_tf_vit.py,819,309,565,14,77,57,103,91,160,535.845532542314,9.36363636363636,9749.85960640677,541.658867022599,1041.24714243179,75,36.2536483787462,0,0
transformers_4.23.0,src/transformers/models/vit/__init__.py,123,65,91,1,8,8,8,9,16,24,0.5,25.3594000115385,1.40885555619658,50.718800023077,26,67.3436109156158,0,0
transformers_4.23.0,src/transformers/models/vit/feature_extraction_vit.py,149,40,59,5,20,11,21,25,32,98.0482023721841,2.625,390.083919941077,21.6713288856154,148.603398072791,20,72.030995504123,0,0
transformers_4.23.0,src/transformers/models/vit/convert_vit_timm_to_pytorch.py,250,161,182,4,17,20,29,21,49,77.4868683012558,3.41176470588235,734.292124443367,40.7940069135204,215.223553716159,28,54.8203280607518,0,0
transformers_4.23.0,src/transformers/models/vit/modeling_flax_vit.py,675,293,517,13,60,54,100,73,154,402.519152072345,10.8333333333333,10326.6906390648,573.705035503602,953.232982067523,61,32.1342070066803,0,0
transformers_4.23.0,src/transformers/models/vit/convert_dino_to_pytorch.py,219,124,150,5,11,10,16,16,26,49.6633882794471,3.63636363636364,378.181818181818,21.010101010101,104,21,62.2265837826217,0,0
transformers_4.23.0,src/transformers/models/vit/configuration_vit.py,144,38,59,0,0,0,0,0,0,0,0,0,0,0,4,100,0,0
transformers_4.23.0,src/transformers/models/vit/modeling_vit.py,821,374,558,16,134,112,202,150,314,1010.85595152134,12.0597014925373,27373.7022030312,1520.76123350173,2269.84906881571,96,30.2693986796823,0,0
transformers_4.23.0,src/transformers/models/trocr/configuration_trocr.py,153,31,66,0,0,0,0,0,0,0,0,0,0,0,2,100,0,0
transformers_4.23.0,src/transformers/models/trocr/__init__.py,63,24,36,1,2,2,2,3,4,2,0.5,3.16992500144231,0.176106944524573,6.33985000288463,8,91.9167547932775,0,0
transformers_4.23.0,src/transformers/models/trocr/processing_trocr.py,107,50,47,4,7,8,16,11,24,27.6514844544032,4.57142857142857,379.549069016206,21.0860593897892,83.0263588472952,14,73.56470321431,0,0
transformers_4.23.0,src/transformers/models/trocr/convert_trocr_unilm_to_pytorch.py,238,116,163,8,52,45,65,60,110,320.422865343337,5,3248.78982758469,180.488323754705,649.757965516937,22,57.1282003791488,0,0
transformers_4.23.0,src/transformers/models/trocr/modeling_trocr.py,1013,391,570,17,146,145,258,163,403,1119.20125389774,15.0205479452055,44483.9152014944,2471.32862230525,2961.53744615512,123,31.4277327828255,0,0
transformers_4.23.0,src/transformers/models/qdqbert/__init__.py,75,23,48,1,2,2,2,3,4,2,0.5,3.16992500144231,0.176106944524573,6.33985000288463,8,90.8165051883758,0,0
transformers_4.23.0,src/transformers/models/qdqbert/modeling_qdqbert.py,1753,776,1258,16,191,224,388,207,612,1511.28890615483,16.2513089005236,76517.8906379041,4250.993924328,4708.41401798959,218,4.38881001483466,0,0
transformers_4.23.0,src/transformers/models/qdqbert/configuration_qdqbert.py,123,24,44,0,0,0,0,0,0,0,0,0,0,0,2,100,0,0
transformers_4.23.0,src/transformers/models/phobert/tokenization_phobert.py,362,166,191,12,85,58,109,97,167,587.817779580359,7.69411764705882,8480.3444799764,471.130248887578,1102.18544464525,44,53.5304816363404,0,0
transformers_4.23.0,src/transformers/models/phobert/__init__.py,33,9,8,0,0,0,0,0,0,0,0,0,0,0,2,100,0,0
transformers_4.23.0,src/transformers/models/bort/__init__.py,0,0,0,0,0,0,0,0,0,0,0,0,0,0,1,100,0,0
transformers_4.23.0,src/transformers/models/bort/convert_bort_original_gluonnlp_checkpoint_to_pytorch.py,319,105,207,3,10,5,10,13,15,37.9741684510371,1.5,83.2598936581746,4.62554964767637,55.5065957721164,6,69.6035940930104,0,0
transformers_4.23.0,src/transformers/models/plbart/modeling_plbart.py,1741,636,1145,16,180,221,394,196,615,1412.53355733934,17.5111111111111,82005.3485478914,4555.85269710508,4683.04655413085,209,11.007929597779,0,0
transformers_4.23.0,src/transformers/models/plbart/__init__.py,85,37,56,1,4,4,4,5,8,8,0.5,9.28771237954945,0.51598402108608,18.5754247590989,14,81.1815199643737,0,0
transformers_4.23.0,src/transformers/models/plbart/tokenization_plbart.py,462,171,266,12,98,62,121,110,183,691.261114731944,7.40816326530612,9193.44784509652,510.747102505362,1240.98882757501,55,51.0014910657313,0,0
transformers_4.23.0,src/transformers/models/plbart/convert_plbart_original_checkpoint_to_torch.py,94,44,65,2,3,2,3,5,5,6.75488750216347,1,11.6096404744368,0.644980026357601,11.6096404744368,7,79.7328658111599,0,0
transformers_4.23.0,src/transformers/models/plbart/configuration_plbart.py,192,50,96,0,0,0,0,0,0,0,0,0,0,0,5,100,0,0
transformers_4.23.0,src/transformers/models/dit/__init__.py,0,0,0,0,0,0,0,0,0,0,0,0,0,0,1,100,0,0
transformers_4.23.0,src/transformers/models/dit/convert_dit_unilm_to_pytorch.py,228,112,155,5,14,12,23,19,35,64.9126093832433,4.10714285714286,610.639580057515,33.9244211143064,148.677462970525,21,61.3909289643245,0,0
transformers_4.23.0,src/transformers/models/donut/processing_donut.py,156,96,88,8,34,25,49,42,74,196.973736602512,5.76470588235294,2300.29917352892,127.794398529384,399.031489285628,32,63.4421122623057,0,0
transformers_4.23.0,src/transformers/models/donut/feature_extraction_donut.py,208,71,100,11,49,33,62,60,95,313.174530166655,6.95918367346939,3905.17797642322,216.954332023512,561.154606582809,38,64.1661722440081,0,0
transformers_4.23.0,src/transformers/models/donut/convert_donut_to_pytorch.py,234,125,179,9,42,38,71,51,109,255.006656769689,7.60714285714286,4703.45354159115,261.302974532842,618.294362274893,33,50.3923960979287,0,0
transformers_4.23.0,src/transformers/models/donut/__init__.py,76,38,48,1,4,4,4,5,8,8,0.5,9.28771237954945,0.51598402108608,18.5754247590989,14,81.9838688722816,0,0
transformers_4.23.0,src/transformers/models/donut/configuration_donut_swin.py,140,32,54,3,6,3,6,9,9,20.2646625064904,1.5,42.7939875194712,2.37744375108173,28.5293250129808,2,77.3218581581907,0,0
transformers_4.23.0,src/transformers/models/donut/modeling_donut_swin.py,941,492,611,18,197,181,327,215,508,1576.60285845887,14.9390862944162,58801.4681757443,3266.74823198579,3936.08196759145,105,27.4468707397113,0,0
transformers_4.23.0,src/transformers/models/tapex/__init__.py,34,9,8,0,0,0,0,0,0,0,0,0,0,0,2,100,0,0
transformers_4.23.0,src/transformers/models/tapex/tokenization_tapex.py,1488,435,1089,19,227,145,284,246,429,1857.33712937047,11.8854625550661,40497.7968021536,2249.87760011964,3407.33872279053,155,21.477777250025,0,0
transformers_4.23.0,src/transformers/models/xlm_roberta_xl/configuration_xlm_roberta_xl.py,155,39,64,1,2,1,2,3,3,2,0.5,2.37744375108173,0.13208020839343,4.75488750216347,4,83.4281056551258,0,0
transformers_4.23.0,src/transformers/models/xlm_roberta_xl/__init__.py,78,23,52,1,2,2,2,3,4,2,0.5,3.16992500144231,0.176106944524573,6.33985000288463,8,90.2847497769009,0,0
transformers_4.23.0,src/transformers/models/xlm_roberta_xl/modeling_xlm_roberta_xl.py,1540,673,1106,15,174,216,372,189,588,1353.67552721181,16.0344827586207,71298.9077113974,3961.05042841097,4446.59854544199,192,9.78084708367457,0,0
transformers_4.23.0,src/transformers/models/xlm_roberta_xl/convert_xlm_roberta_xl_original_pytorch_checkpoint_to_pytorch.py,183,104,126,4,9,10,17,13,27,36.5293250129808,3.77777777777778,377.444851250391,20.9691584027995,99.9118723898095,14,65.8541243962747,0,0
transformers_4.23.0,src/transformers/models/mvp/tokenization_mvp.py,404,175,211,15,104,68,133,119,201,755.449089620801,9.59134615384615,13292.2473509503,738.458186163907,1385.8583704249,56,50.7661655714477,0,0
transformers_4.23.0,src/transformers/models/mvp/__init__.py,83,38,56,1,4,4,4,5,8,8,0.5,9.28771237954945,0.51598402108608,18.5754247590989,14,80.928873413069,0,0
transformers_4.23.0,src/transformers/models/mvp/configuration_mvp.py,182,41,81,2,4,2,4,6,6,10,1,15.5097750043269,0.861654166907052,15.5097750043269,4,80.8437780780212,0,0
transformers_4.23.0,src/transformers/models/mvp/modeling_mvp.py,2056,748,1398,17,202,256,451,219,707,1616.44558781712,18.9777227722772,104316.261675434,5795.34787085744,5496.77445113803,244,3.03567040126771,0,0
transformers_4.23.0,src/transformers/models/mvp/tokenization_mvp_fast.py,287,86,133,7,41,26,50,48,76,239.311116643745,4.26829268292683,1811.70734779491,100.650408210828,424.457150054808,25,64.4750947599492,0,0
transformers_4.23.0,src/transformers/models/segformer/modeling_segformer.py,831,399,554,15,109,102,180,124,282,796.335450334813,12.3853211009174,24288.6471134338,1349.36928407966,1961.0833595291,100,31.2989932463601,0,0
transformers_4.23.0,src/transformers/models/segformer/__init__.py,117,51,88,1,6,6,6,7,12,15.5097750043269,0.5,16.8441295323456,0.935784974019201,33.6882590646913,20,71.9676260652893,0,0
transformers_4.23.0,src/transformers/models/segformer/configuration_segformer.py,176,49,80,3,6,3,6,9,9,20.2646625064904,1.5,42.7939875194712,2.37744375108173,28.5293250129808,7,78.987398037054,0,0
transformers_4.23.0,src/transformers/models/segformer/modeling_tf_segformer.py,900,392,622,15,89,83,144,104,227,634.943634290137,12.1348314606742,18457.0764190952,1025.39313439418,1520.99981601803,89,32.2652517030118,0,0
transformers_4.23.0,src/transformers/models/segformer/convert_segformer_original_to_pytorch.py,388,201,314,7,450,440,492,457,932,3985.85302050207,3.82666666666667,31513.361242298,1750.74229123878,8235.19893091412,56,34.5148431800765,0,0
transformers_4.23.0,src/transformers/models/segformer/feature_extraction_segformer.py,258,89,126,7,37,27,51,44,78,212.401258982674,4.82432432432432,2054.36936287262,114.131631270701,425.835666253709,45,61.8283871502036,0,0
transformers_4.23.0,src/transformers/models/realm/configuration_realm.py,189,33,76,0,0,0,0,0,0,0,0,0,0,0,2,100,0,0
transformers_4.23.0,src/transformers/models/realm/__init__.py,89,40,60,1,4,4,4,5,8,8,0.5,9.28771237954945,0.51598402108608,18.5754247590989,14,79.9339278310666,0,0
transformers_4.23.0,src/transformers/models/realm/retrieval_realm.py,165,90,98,8,30,26,46,38,72,171.206717868256,6.13333333333333,2317.48478993669,128.749154996483,377.850780967938,20,62.2446443857778,0,0
transformers_4.23.0,src/transformers/models/realm/tokenization_realm.py,608,264,335,17,144,89,182,161,271,1101.95606850895,10.7430555555556,21342.997216876,1185.72206760422,1986.67847396906,94,40.6387634108578,0,0
transformers_4.23.0,src/transformers/models/realm/tokenization_realm_fast.py,321,75,163,6,39,23,47,45,70,221.640461539955,3.61538461538462,1389.86128360959,77.2145157560882,384.429716743077,18,67.5940587514377,0,0
transformers_4.23.0,src/transformers/models/realm/modeling_realm.py,1857,813,1197,18,220,212,375,238,587,1786.95778700139,15.3409090909091,71093.7310969702,3949.65172760946,4634.25802706176,203,9.85011343190848,0,0
transformers_4.23.0,src/transformers/models/conditional_detr/modeling_conditional_detr.py,2647,1176,1496,21,388,376,684,409,1060,3429.00484864696,18.5103092783505,170230.326843358,9457.24038018656,9196.51445491826,266,0,0,0
transformers_4.23.0,src/transformers/models/conditional_detr/convert_conditional_detr_original_pytorch_checkpoint_to_pytorch.py,325,169,252,7,30,22,39,37,61,166.858202322659,4.55,1445.88378163032,80.3268767572397,317.776655303366,32,51.0656098026008,0,0
transformers_4.23.0,src/transformers/models/conditional_detr/__init__.py,87,37,58,1,4,4,4,5,8,8,0.5,9.28771237954945,0.51598402108608,18.5754247590989,14,80.9249967887991,0,0
transformers_4.23.0,src/transformers/models/conditional_detr/configuration_conditional_detr.py,240,70,115,0,0,0,0,0,0,0,0,0,0,0,7,100,0,0
transformers_4.23.0,src/transformers/models/conditional_detr/feature_extraction_conditional_detr.py,973,528,556,21,227,195,343,248,538,1868.86517249339,15.8656387665198,67894.7420721576,3771.93011511987,4279.35761498814,156,22.9881716255864,0,0
transformers_4.23.0,src/transformers/models/ibert/__init__.py,66,23,40,1,2,2,2,3,4,2,0.5,3.16992500144231,0.176106944524573,6.33985000288463,8,91.8578971704303,0,0
transformers_4.23.0,src/transformers/models/ibert/quant_modules.py,823,402,467,16,240,212,387,256,599,1961.65374294604,12.9,61816.8,3434.26666666667,4792,71,36.5586583362483,0,0
transformers_4.23.0,src/transformers/models/ibert/modeling_ibert.py,1373,571,1039,14,116,143,247,130,390,848.828764343605,14.9051724137931,40821.1451724415,2267.84139846897,2738.7234470811,132,17.5443882578094,0,0
transformers_4.23.0,src/transformers/models/ibert/configuration_ibert.py,147,39,66,1,2,1,2,3,3,2,0.5,2.37744375108173,0.13208020839343,4.75488750216347,4,85.6555289355881,0,0
transformers_4.23.0,src/transformers/models/reformer/modeling_reformer.py,2720,1107,1784,20,446,498,831,466,1329,4011.6399172622,18.6322869955157,219497.720044171,12194.3177802317,11780.5033862455,298,0,0,0
transformers_4.23.0,src/transformers/models/reformer/__init__.py,107,51,76,1,6,6,6,7,12,15.5097750043269,0.5,16.8441295323456,0.935784974019201,33.6882590646913,20,73.1622139871993,0,0
transformers_4.23.0,src/transformers/models/reformer/convert_reformer_trax_checkpoint_to_pytorch.py,222,91,154,6,18,19,31,24,50,90.5684250302886,5.16666666666667,1184.44864601963,65.8027025566462,229.248125036058,12,62.5579455967732,0,0
transformers_4.23.0,src/transformers/models/reformer/tokenization_reformer.py,179,72,86,6,15,9,15,21,24,74.1131339384547,3,316.246854440071,17.569269691115,105.41561814669,20,71.8688539355058,0,0
transformers_4.23.0,src/transformers/models/reformer/configuration_reformer.py,238,43,87,0,0,0,0,0,0,0,0,0,0,0,3,100,0,0
transformers_4.23.0,src/transformers/models/reformer/tokenization_reformer_fast.py,132,39,67,3,9,6,9,12,15,33.2842125151443,1.5,80.661656266226,4.48120312590145,53.7744375108174,9,81.1902706401068,0,0
transformers_4.23.0,src/transformers/models/mobilevit/convert_mlcvnets_to_pytorch.py,312,207,240,9,133,123,181,142,304,966.881888934639,6.12406015037594,13310.7863516264,739.488130645913,2173.52312432942,63,35.1348572130307,0,0
transformers_4.23.0,src/transformers/models/mobilevit/modeling_tf_mobilevit.py,1166,488,827,17,104,98,182,121,280,766.332598987929,14.875,28817.0653832487,1600.94807684715,1937.28170643689,115,23.6263305815742,0,0
transformers_4.23.0,src/transformers/models/mobilevit/configuration_mobilevit.py,185,53,85,1,2,1,2,3,3,2,0.5,2.37744375108173,0.13208020839343,4.75488750216347,6,83.8989425786344,0,0
transformers_4.23.0,src/transformers/models/mobilevit/modeling_mobilevit.py,1087,491,786,17,123,121,222,140,343,923.416152457982,15.3414634146341,37515.1566599226,2084.1753699957,2445.34407481212,125,20.3748587044368,0,0
transformers_4.23.0,src/transformers/models/mobilevit/__init__.py,120,58,89,1,7,7,7,8,14,19.6514844544032,0.5,21,1.16666666666667,42,23,69.5824312048386,0,0
transformers_4.23.0,src/transformers/models/mobilevit/feature_extraction_mobilevit.py,199,62,81,6,24,13,25,30,38,125.548875021635,3.125,582.693258228512,32.3718476793618,186.461842633124,29,66.9220240209899,0,0
transformers_4.23.0,src/transformers/models/imagegpt/feature_extraction_imagegpt.py,176,60,66,10,29,17,30,39,47,174.100729807573,5.17241379310345,1284.89950493031,71.3833058294614,248.413904286526,19,66.1256091868112,0,0
transformers_4.23.0,src/transformers/models/imagegpt/__init__.py,79,37,50,1,4,4,4,5,8,8,0.5,9.28771237954945,0.51598402108608,18.5754247590989,14,81.9700739406769,0,0
transformers_4.23.0,src/transformers/models/imagegpt/configuration_imagegpt.py,142,31,56,0,0,0,0,0,0,0,0,0,0,0,2,100,0,0
transformers_4.23.0,src/transformers/models/imagegpt/convert_imagegpt_original_tf2_to_pytorch.py,72,27,41,2,8,5,10,10,15,26,1.25,62.2861517791381,3.46034176550767,49.8289214233104,2,85.4866750136756,0,0
transformers_4.23.0,src/transformers/models/imagegpt/modeling_imagegpt.py,1208,572,829,19,251,244,426,270,670,2081.56805479707,16.1235059760956,87251.8116464038,4847.32286924466,5411.46645002406,181,13.7150212898511,0,0
transformers_4.23.0,src/transformers/models/flaubert/__init__.py,105,38,76,1,4,4,4,5,8,8,0.5,9.28771237954945,0.51598402108608,18.5754247590989,14,78.5670625626584,0,0
transformers_4.23.0,src/transformers/models/flaubert/modeling_flaubert.py,446,166,293,13,54,55,99,67,154,358.869641452662,11.9166666666667,11132.2846793551,618.460259964172,934.177735330497,46,50.5922758871237,0,0
transformers_4.23.0,src/transformers/models/flaubert/modeling_tf_flaubert.py,915,384,645,16,98,89,164,114,253,712.241564723291,13.3877551020408,23143.6957116509,1285.76087286949,1728.72117358368,91,32.0958274790202,0,0
transformers_4.23.0,src/transformers/models/flaubert/tokenization_flaubert.py,605,284,367,13,99,66,129,112,195,704.412021723716,8.46969696969697,11242.9655042256,624.6091946792,1327.43420980123,64,44.3348768525651,0,0
transformers_4.23.0,src/transformers/models/flaubert/configuration_flaubert.py,238,62,108,2,4,2,4,6,6,10,1,15.5097750043269,0.861654166907052,15.5097750043269,5,77.3983396436384,0,0
transformers_4.23.0,src/transformers/models/speech_encoder_decoder/modeling_flax_speech_encoder_decoder.py,932,275,624,12,93,77,144,105,221,651.161319441701,9.29032258064516,13785.428990594,765.85716614411,1483.84825940421,83,38.5763060527886,0,0
transformers_4.23.0,src/transformers/models/speech_encoder_decoder/convert_mbart_wav2vec2_seq2seq_original_to_pytorch.py,358,177,290,9,58,60,114,67,174,368.29222273038,8.8448275862069,9335.71126411451,518.65062578414,1055.49951913965,53,39.0794074004351,0,0
transformers_4.23.0,src/transformers/models/speech_encoder_decoder/modeling_speech_encoder_decoder.py,608,181,389,11,76,66,125,87,191,512.896238826723,9.04605263157895,11132.0923394557,618.449574414208,1230.60220770711,73,45.8785284835706,1,1
transformers_4.23.0,src/transformers/models/speech_encoder_decoder/__init__.py,64,37,36,1,4,4,4,5,8,8,0.5,9.28771237954945,0.51598402108608,18.5754247590989,14,83.7399613756134,0,0
transformers_4.23.0,src/transformers/models/speech_encoder_decoder/configuration_speech_encoder_decoder.py,121,34,36,2,5,3,6,7,9,13.6096404744368,1.2,30.3194331582221,1.68441295323456,25.2661942985184,6,69.1170415408439,0,0
transformers_4.23.0,src/transformers/models/speech_encoder_decoder/convert_speech_to_text_wav2vec2_seq2seq_original_to_pytorch.py,317,154,245,8,53,46,87,61,133,327.57978409185,6.56603773584906,5179.21220625964,287.734011458869,788.788065895864,38,43.8970171618603,0,0
transformers_4.23.0,src/transformers/models/deberta/modeling_deberta.py,1470,762,1054,19,210,243,404,229,647,1700.70218146531,18.2761904761905,92696.1957035681,5149.78865019823,5071.96485089872,200,5.1539937638482,0,0
transformers_4.23.0,src/transformers/models/deberta/__init__.py,124,52,92,1,6,6,6,7,12,15.5097750043269,0.5,16.8441295323456,0.935784974019201,33.6882590646913,20,71.4191641741579,0,0
transformers_4.23.0,src/transformers/models/deberta/tokenization_deberta_fast.py,211,51,105,3,28,18,36,31,54,139.360825319776,1.92857142857143,515.94415861029,28.6635643672384,267.526600760891,11,72.841007352305,0,0
transformers_4.23.0,src/transformers/models/deberta/tokenization_deberta.py,223,55,112,7,57,33,65,64,98,352.126215261793,3.99122807017544,2346.84210526316,130.380116959064,588,21,68.5851200728429,0,0
transformers_4.23.0,src/transformers/models/deberta/configuration_deberta.py,184,59,97,4,12,6,12,16,18,51.0195500086539,2,144,8,72,12,75.6573206659985,0,0
transformers_4.23.0,src/transformers/models/deberta/modeling_tf_deberta.py,1476,651,1085,16,187,191,324,203,515,1475.26926399899,13.8609625668449,54718.2011183537,3039.90006213076,3947.64799735037,168,9.94365890628988,0,0
transformers_4.23.0,src/transformers/models/cvt/__init__.py,59,23,32,1,2,2,2,3,4,2,0.5,3.16992500144231,0.176106944524573,6.33985000288463,8,92.6799652842344,0,0
transformers_4.23.0,src/transformers/models/cvt/convert_cvt_original_pytorch_checkpoint_to_pytorch.py,362,115,290,3,12,9,16,15,25,47.7744375108174,2,195.344529780426,10.8524738766903,97.672264890213,11,59.9814725928404,0,0
transformers_4.23.0,src/transformers/models/cvt/modeling_cvt.py,734,346,530,13,75,69,124,88,193,515.267118123025,10.7466666666667,13397.5501830931,744.308343505171,1246.670302397,84,33.401648710331,0,0
transformers_4.23.0,src/transformers/models/cvt/configuration_cvt.py,147,32,56,0,0,0,0,0,0,0,0,0,0,0,2,100,0,0
transformers_4.23.0,src/transformers/models/longformer/convert_longformer_original_pytorch_lightning_to_pytorch.py,87,32,49,1,2,1,2,3,3,2,0.5,2.37744375108173,0.13208020839343,4.75488750216347,4,90.2397471354111,0,0
transformers_4.23.0,src/transformers/models/longformer/tokenization_longformer.py,432,175,236,15,104,68,133,119,201,755.449089620801,9.59134615384615,13292.2473509503,738.458186163907,1385.8583704249,56,50.7503645047142,0,0
transformers_4.23.0,src/transformers/models/longformer/__init__.py,139,52,108,1,6,6,6,7,12,15.5097750043269,0.5,16.8441295323456,0.935784974019201,33.6882590646913,20,70.1068985562834,0,0
transformers_4.23.0,src/transformers/models/longformer/modeling_longformer.py,2347,864,1401,16,251,307,540,267,847,2064.85743204164,17.2111553784861,117507.604947737,6528.20027487429,6827.40945413936,196,11.1274269294721,0,0
transformers_4.23.0,src/transformers/models/longformer/tokenization_longformer_fast.py,96,16,66,0,0,0,0,0,0,0,0,0,0,0,1,100,0,0
transformers_4.23.0,src/transformers/models/longformer/configuration_longformer.py,227,72,114,1,4,2,4,5,6,8,0.5,6.96578428466209,0.38698801581456,13.9315685693242,11,78.6047191239632,0,0
transformers_4.23.0,src/transformers/models/longformer/modeling_tf_longformer.py,2707,904,1802,15,254,303,540,269,843,2087.72926937426,15.9448818897638,108492.847343003,6027.3804079446,6804.24277163524,198,7.91601427090701,0,0
transformers_4.23.0,src/transformers/models/trajectory_transformer/configuration_trajectory_transformer.py,167,36,70,0,0,0,0,0,0,0,0,0,0,0,2,100,0,0
transformers_4.23.0,src/transformers/models/trajectory_transformer/__init__.py,68,23,40,1,2,2,2,3,4,2,0.5,3.16992500144231,0.176106944524573,6.33985000288463,8,92.1383550729973,0,0
transformers_4.23.0,src/transformers/models/trajectory_transformer/convert_trajectory_transformer_original_pytorch_checkpoint_to_pytorch.py,70,31,28,1,2,1,2,3,3,2,0.5,2.37744375108173,0.13208020839343,4.75488750216347,3,89.8138998348558,0,0
transformers_4.23.0,src/transformers/models/trajectory_transformer/modeling_trajectory_transformer.py,617,315,415,17,125,96,177,142,273,940.209903884017,12.036,23492.8392781878,1305.1577376771,1951.88096362478,75,37.1673413384071,0,0
transformers_4.23.0,src/transformers/models/mluke/__init__.py,48,21,21,1,2,2,2,3,4,2,0.5,3.16992500144231,0.176106944524573,6.33985000288463,8,92.8814536032276,0,0
transformers_4.23.0,src/transformers/models/mluke/convert_mluke_original_pytorch_checkpoint_to_pytorch.py,229,132,159,7,42,35,61,49,96,246.128816211111,5.08333333333333,2739.97840392822,152.221022440457,539.01214503506,26,54.5497934499181,0,0
transformers_4.23.0,src/transformers/models/mluke/tokenization_mluke.py,1632,527,1106,18,431,293,577,449,870,3846.97413949336,12.0487238979118,92355.8461584997,5130.88034213887,7665.1973222248,221,9.88311281567391,1,1
transformers_4.23.0,src/transformers/models/retribert/modeling_retribert.py,220,84,135,7,21,16,32,28,48,111.890150332757,5.33333333333333,1230.68286004675,68.371270002597,230.753036258765,17,67.351432807122,0,0
transformers_4.23.0,src/transformers/models/retribert/__init__.py,77,38,48,1,4,4,4,5,8,8,0.5,9.28771237954945,0.51598402108608,18.5754247590989,14,81.9838688722816,0,0
transformers_4.23.0,src/transformers/models/retribert/configuration_retribert.py,111,25,44,0,0,0,0,0,0,0,0,0,0,0,2,100,0,0
transformers_4.23.0,src/transformers/models/retribert/tokenization_retribert_fast.py,205,50,88,5,32,18,37,37,55,171.609640474437,2.890625,828.221687426165,46.0123159681203,286.519935109592,10,70.5151890393385,0,0
transformers_4.23.0,src/transformers/models/retribert/tokenization_retribert.py,524,239,281,17,137,84,172,154,256,1041.91726366685,10.6715328467153,19852.2243223282,1102.90135124046,1860.2973544179,86,42.8862296847106,0,0
transformers_4.23.0,src/transformers/models/vit_msn/configuration_vit_msn.py,117,24,40,0,0,0,0,0,0,0,0,0,0,0,2,100,0,0
transformers_4.23.0,src/transformers/models/vit_msn/__init__.py,57,23,32,1,2,2,2,3,4,2,0.5,3.16992500144231,0.176106944524573,6.33985000288463,8,92.6799652842344,0,0
transformers_4.23.0,src/transformers/models/vit_msn/modeling_vit_msn.py,698,325,441,15,107,90,162,122,252,779.94032647905,11.3551401869159,19832.2725048131,1101.79291693406,1746.54580906585,84,36.9438374955971,0,0
transformers_4.23.0,src/transformers/models/vit_msn/convert_msn_to_pytorch.py,245,131,175,4,19,22,33,23,55,88.7106227554281,3.47368421052632,864.238415815103,48.0132453230613,248.795907583136,22,56.1985804985394,0,0
transformers_4.23.0,src/transformers/models/levit/__init__.py,75,37,48,1,4,4,4,5,8,8,0.5,9.28771237954945,0.51598402108608,18.5754247590989,14,82.2365154235863,0,0
transformers_4.23.0,src/transformers/models/levit/feature_extraction_levit.py,158,44,67,7,20,11,21,27,32,106.090046352151,3.675,559.174770254424,31.0652650141347,152.156400069231,20,72.6529581343469,0,0
transformers_4.23.0,src/transformers/models/levit/configuration_levit.py,146,39,62,1,4,2,4,5,6,8,0.5,6.96578428466209,0.38698801581456,13.9315685693242,4,82.149169584657,0,0
transformers_4.23.0,src/transformers/models/levit/convert_levit_timm_to_pytorch.py,181,81,138,3,12,9,17,15,26,47.7744375108174,2.125,215.855705407371,11.9919836337428,101.579155485821,14,60.890817718116,0,0
transformers_4.23.0,src/transformers/models/levit/modeling_levit.py,744,390,552,17,127,122,223,144,345,957.049823521321,14.9251968503937,36919.3270069346,2051.07372260748,2473.6241254976,92,27.8851069153136,0,0
transformers_4.23.0,src/transformers/models/barthez/tokenization_barthez.py,300,100,130,8,65,39,75,73,114,415.45390784685,4.61538461538462,3256.79999867225,180.93333325957,705.639999712322,31,60.1882086552957,0,0
transformers_4.23.0,src/transformers/models/barthez/__init__.py,64,35,35,1,4,4,4,5,8,8,0.5,9.28771237954945,0.51598402108608,18.5754247590989,14,84.368768912279,0,0
transformers_4.23.0,src/transformers/models/barthez/tokenization_barthez_fast.py,216,55,99,5,35,24,45,40,69,191.134546067511,3.21428571428571,1180.3276239018,65.5737568834336,367.213038547228,14,70.475531785257,0,0
transformers_4.23.0,src/transformers/models/t5/modeling_t5.py,1858,847,1358,19,305,287,532,324,819,2597.77357965275,16.5704918032787,113182.045796853,6287.89143315849,6830.33715236251,268,0,0,0
transformers_4.23.0,src/transformers/models/t5/modeling_tf_t5.py,1661,627,1212,13,207,198,362,220,560,1640.65751653819,11.3671497584541,49533.0534653004,2751.8363036278,4357.56143957381,177,12.7497172389788,1,1
transformers_4.23.0,src/transformers/models/t5/__init__.py,158,79,122,1,10,10,10,11,20,33.2192809488736,0.5,34.594316186373,1.9219064547985,69.188632372746,32,61.3564632464777,0,0
transformers_4.23.0,src/transformers/models/t5/configuration_t5.py,165,59,90,7,15,9,17,22,26,78.254843388531,3.96666666666667,459.916047602127,25.5508915334515,115.94522208457,11,74.5876240195466,0,0
transformers_4.23.0,src/transformers/models/t5/modeling_flax_t5.py,1800,675,1341,16,193,181,331,209,512,1529.34420819274,13.720207253886,54142.2411122077,3007.90228401154,3946.16787562541,152,12.8272770940735,0,0
transformers_4.23.0,src/transformers/models/t5/tokenization_t5_fast.py,237,73,128,9,44,32,61,53,93,268.744316233022,6.23863636363636,3323.30039373447,184.627799651915,532.696602274378,24,66.2527519218281,0,0
transformers_4.23.0,src/transformers/models/t5/convert_t5_original_tf_checkpoint_to_pytorch.py,60,19,30,1,2,1,2,3,3,2,0.5,2.37744375108173,0.13208020839343,4.75488750216347,2,96.3176030216455,0,0
transformers_4.23.0,src/transformers/models/t5/convert_t5x_checkpoint_to_flax.py,234,92,159,2,6,3,6,8,9,17.5097750043269,1,27,1.5,27,9,69.8514594568958,0,0
transformers_4.23.0,src/transformers/models/t5/tokenization_t5.py,339,132,177,13,87,54,104,100,158,608.641800474674,7.77011494252874,8156.51714847654,453.13984158203,1049.72927798441,44,55.9072944602496,0,0
transformers_4.23.0,src/transformers/models/maskformer/feature_extraction_maskformer.py,881,329,423,18,136,106,191,154,297,1038.95359643601,12.6397058823529,27279.4632415147,1515.52573563971,2158.23560258639,92,37.7923105012679,0,0
transformers_4.23.0,src/transformers/models/maskformer/__init__.py,74,37,46,1,4,4,4,5,8,8,0.5,9.28771237954945,0.51598402108608,18.5754247590989,14,82.5026769126246,0,0
transformers_4.23.0,src/transformers/models/maskformer/configuration_maskformer.py,205,59,94,2,7,4,8,9,12,21.6514844544032,1.14285714285714,43.4732571626374,2.41518095347986,38.0391000173078,8,76.0328775309955,0,0
transformers_4.23.0,src/transformers/models/maskformer/convert_maskformer_original_pytorch_checkpoint_to_pytorch.py,737,321,564,9,34,29,50,43,79,201.503061615492,6.61764705882353,2836.81929455382,157.601071919657,428.674915621466,40,39.001827116844,0,0
transformers_4.23.0,src/transformers/models/maskformer/modeling_maskformer.py,2599,1200,1461,20,384,378,682,404,1060,3383.06416217467,17.7604166666667,162999.850133097,9055.5472296165,9177.7041717169,271,0,0,0
transformers_4.23.0,src/transformers/models/blenderbot/configuration_blenderbot.py,400,162,274,6,25,17,31,31,48,131.606179748695,3.72,884.621293182681,49.1456273990378,237.80142289857,34,57.7089291080966,0,0
transformers_4.23.0,src/transformers/models/blenderbot/__init__.py,146,66,111,1,8,8,8,9,16,24,0.5,25.3594000115385,1.40885555619658,50.718800023077,26,65.5742131178831,0,0
transformers_4.23.0,src/transformers/models/blenderbot/convert_blenderbot_original_pytorch_checkpoint_to_pytorch.py,114,60,76,3,10,5,10,13,15,37.9741684510371,1.5,83.2598936581746,4.62554964767637,55.5065957721164,12,72.5411890301915,0,0
transformers_4.23.0,src/transformers/models/blenderbot/modeling_flax_blenderbot.py,1507,609,1140,14,146,146,261,160,407,1103.01735450529,12.513698630137,37291.1314393781,2071.72952440989,2980.02473461916,146,14.7638030694853,0,0
transformers_4.23.0,src/transformers/models/blenderbot/modeling_blenderbot.py,1619,579,1032,16,158,187,335,174,522,1217.99735821198,16.9620253164557,65901.1407148895,3661.17448416053,3885.21650483304,189,15.9578421840469,0,0
transformers_4.23.0,src/transformers/models/blenderbot/tokenization_blenderbot.py,427,188,218,15,98,64,124,113,188,706.844923657418,9.48979591836735,12167.7560182518,675.986445458431,1282.19364493406,60,49.6816659915356,0,0
transformers_4.23.0,src/transformers/models/blenderbot/tokenization_blenderbot_fast.py,312,99,138,9,36,24,45,45,69,214.646625064904,5.625,2131.52548301296,118.418082389609,378.937863646748,27,62.2137428173594,0,0
transformers_4.23.0,src/transformers/models/blenderbot/modeling_tf_blenderbot.py,1476,502,1027,14,124,143,251,138,394,915.623311396779,14.1693548387097,39684.9429306479,2204.71905170266,2800.7586359706,144,22.2442852347088,1,1
transformers_4.23.0,src/transformers/models/pegasus_x/__init__.py,62,23,34,1,2,2,2,3,4,2,0.5,3.16992500144231,0.176106944524573,6.33985000288463,8,92.6799652842344,0,0
transformers_4.23.0,src/transformers/models/pegasus_x/configuration_pegasus_x.py,183,43,80,0,0,0,0,0,0,0,0,0,0,0,4,100,0,0
transformers_4.23.0,src/transformers/models/pegasus_x/modeling_pegasus_x.py,1692,667,1067,16,166,189,336,182,525,1288.25654560359,16.1927710843373,63825.2999774,3545.84999874444,3941.59218610432,169,17.7060544881202,0,0
transformers_4.23.0,src/transformers/models/nezha/__init__.py,74,23,46,1,2,2,2,3,4,2,0.5,3.16992500144231,0.176106944524573,6.33985000288463,8,91.4389435481603,0,0
transformers_4.23.0,src/transformers/models/nezha/configuration_nezha.py,110,25,47,0,0,0,0,0,0,0,0,0,0,0,2,100,0,0
transformers_4.23.0,src/transformers/models/nezha/modeling_nezha.py,1719,771,1227,16,182,214,371,198,585,1430.41862451616,16.3076923076923,72784.0621555595,4043.55900864219,4463.17362274657,205,6.49259030425104,0,0
transformers_4.23.0,src/transformers/models/dpr/modeling_tf_dpr.py,792,246,515,9,25,41,72,34,113,144.625729757349,12.96,7450.4875817543,413.915976764128,574.883301061288,60,45.9715914795052,1,1
transformers_4.23.0,src/transformers/models/dpr/modeling_dpr.py,676,231,415,9,30,55,100,39,155,175.736042881236,15,12288.5601588547,682.69778660304,819.237343923649,60,47.2598690345134,0,0
transformers_4.23.0,src/transformers/models/dpr/__init__.py,152,52,120,1,6,6,6,7,12,15.5097750043269,0.5,16.8441295323456,0.935784974019201,33.6882590646913,20,69.2537504963292,0,0
transformers_4.23.0,src/transformers/models/dpr/configuration_dpr.py,132,25,59,0,0,0,0,0,0,0,0,0,0,0,2,100,0,0
transformers_4.23.0,src/transformers/models/dpr/tokenization_dpr_fast.py,411,123,296,13,49,41,74,62,115,323.226498697479,9.81632653061224,6721.55854916429,373.419919398016,684.732575694491,32,54.2639028222691,0,0
transformers_4.23.0,src/transformers/models/dpr/convert_dpr_original_checkpoint_to_pytorch.py,143,94,103,6,14,10,17,20,27,68.8127439131334,3.64285714285714,425.092499047136,23.6162499470631,116.692058561959,23,61.668448329815,0,0
transformers_4.23.0,src/transformers/models/dpr/tokenization_dpr.py,411,122,297,14,49,41,74,63,115,328.423751270452,10.5714285714286,7266.66459271204,403.703588484002,687.38719120249,32,54.3023534383743,0,0
transformers_4.23.0,src/transformers/models/nystromformer/modeling_nystromformer.py,1127,533,841,15,136,176,292,151,468,1022.49830534417,16.1029411764706,54549.895481096,3030.54974894978,3387.57341800414,138,16.6347113834966,0,0
transformers_4.23.0,src/transformers/models/nystromformer/__init__.py,72,23,44,1,2,2,2,3,4,2,0.5,3.16992500144231,0.176106944524573,6.33985000288463,8,91.6811790568426,0,0
transformers_4.23.0,src/transformers/models/nystromformer/convert_nystromformer_original_pytorch_checkpoint_to_pytorch.py,112,65,76,6,31,25,49,37,74,169.08986062632,4.74193548387097,1828.01399068747,101.556332815971,385.499549056542,22,62.6595934697162,0,0
transformers_4.23.0,src/transformers/models/nystromformer/configuration_nystromformer.py,133,27,49,0,0,0,0,0,0,0,0,0,0,0,2,100,0,0
transformers_4.23.0,src/transformers/models/wavlm/convert_wavlm_original_s3prl_checkpoint_to_pytorch.py,110,59,70,1,2,1,2,3,3,2,0.5,2.37744375108173,0.13208020839343,4.75488750216347,7,80.6205714250733,1,1
transformers_4.23.0,src/transformers/models/wavlm/modeling_wavlm.py,1844,855,1287,19,232,273,477,251,750,1903.76221362502,19.5323275862069,116777.100047612,6487.61666931177,5978.65766546308,222,2.19936571055682,1,1
transformers_4.23.0,src/transformers/models/wavlm/convert_wavlm_original_pytorch_checkpoint_to_pytorch.py,208,107,154,9,53,46,88,62,134,332.10910910483,7.47169811320755,5961.38628328999,331.188126849444,797.862305591841,37,50.6882652383361,0,0
transformers_4.23.0,src/transformers/models/wavlm/__init__.py,63,23,38,1,2,2,2,3,4,2,0.5,3.16992500144231,0.176106944524573,6.33985000288463,8,92.0976746936954,1,1
transformers_4.23.0,src/transformers/models/wavlm/configuration_wavlm.py,339,73,141,2,9,5,11,11,16,30.5293250129808,1.22222222222222,67.6511072089072,3.75839484493929,55.3509058981968,7,68.360102025498,1,1
transformers_4.23.0,src/transformers/models/x_clip/modeling_x_clip.py,1497,615,941,17,172,185,323,189,508,1346.80440611002,15.9622093023256,61320.7289561341,3406.70716422967,3841.61915150431,135,22.1225497122306,0,0
transformers_4.23.0,src/transformers/models/x_clip/processing_x_clip.py,109,31,26,3,7,9,18,10,27,24.4063719565667,3.85714285714286,345.955083024698,19.2197268347055,89.6920585619588,12,47.5288313941766,0,0
transformers_4.23.0,src/transformers/models/x_clip/__init__.py,73,24,48,1,2,2,2,3,4,2,0.5,3.16992500144231,0.176106944524573,6.33985000288463,8,90.4133088412504,0,0
transformers_4.23.0,src/transformers/models/x_clip/configuration_x_clip.py,368,100,154,5,16,10,22,21,32,75.6096404744368,3.4375,483.154916505664,26.8419398058702,140.55415752892,18,64.169285615364,0,0
transformers_4.23.0,src/transformers/models/x_clip/convert_x_clip_original_pytorch_to_hf.py,387,253,322,8,71,77,146,79,223,460.632045484832,8.22535211267606,11562.7320337549,642.374001875274,1405.74310684349,67,33.8097659700391,0,0
transformers_4.23.0,src/transformers/models/sew/__init__.py,60,23,34,1,2,2,2,3,4,2,0.5,3.16992500144231,0.176106944524573,6.33985000288463,8,92.5173434722518,0,0
transformers_4.23.0,src/transformers/models/sew/modeling_sew.py,1218,569,838,19,173,188,327,192,515,1366.90130613658,17.9566473988439,70143.2560368352,3896.84755760196,3906.2556878714,148,17.586609778638,0,0
transformers_4.23.0,src/transformers/models/sew/convert_sew_original_pytorch_checkpoint_to_pytorch.py,305,180,243,10,65,54,102,75,156,424.673188795723,7.84615384615385,7624.07407716696,423.55967095372,971.695715717357,51,40.0969604825372,0,0
transformers_4.23.0,src/transformers/models/sew/configuration_sew.py,252,53,102,2,7,4,9,9,13,21.6514844544032,1.28571428571429,52.9830321669644,2.94350178705358,41.2090250187501,6,71.4766935552031,0,0
transformers_4.23.0,src/transformers/models/clip/modeling_flax_clip.py,1180,460,872,15,91,100,176,106,276,650.812671192209,14.5054945054945,26935.3404396315,1496.40780220175,1856.90604545944,106,22.3932465352785,0,0
transformers_4.23.0,src/transformers/models/clip/__init__.py,177,81,142,1,10,10,10,11,20,33.2192809488736,0.5,34.594316186373,1.9219064547985,69.188632372746,32,59.9171783034246,1,1
transformers_4.23.0,src/transformers/models/clip/tokenization_clip.py,523,281,311,17,168,110,222,185,332,1311.39619532809,11.2321428571429,28085.0594220839,1560.28107900466,2500.41864489142,96,38.4720873612017,0,0
transformers_4.23.0,src/transformers/models/clip/processing_clip.py,107,31,26,3,7,9,18,10,27,24.4063719565667,3.85714285714286,345.955083024698,19.2197268347055,89.6920585619588,12,48.9891926560218,0,0
transformers_4.23.0,src/transformers/models/clip/tokenization_clip_fast.py,175,49,86,4,25,19,37,29,56,124.096404744368,2.96,805.258929752346,44.7366072084637,272.046935727144,9,73.8619689295218,0,0
transformers_4.23.0,src/transformers/models/clip/configuration_clip.py,373,112,176,5,16,10,22,21,32,75.6096404744368,3.4375,483.154916505664,26.8419398058702,140.55415752892,24,65.4978343534348,1,1
transformers_4.23.0,src/transformers/models/clip/modeling_clip.py,1076,418,683,13,126,127,224,139,351,927.242986696824,11.5555555555556,28874.4249909665,1604.13472172036,2498.74831652595,97,32.0622993740294,1,1
transformers_4.23.0,src/transformers/models/clip/feature_extraction_clip.py,165,47,71,5,25,14,28,30,42,127.706045218805,2.8,577.050334043562,32.058351891309,206.089405015558,26,70.2537102930574,0,0
transformers_4.23.0,src/transformers/models/clip/convert_clip_original_pytorch_to_hf.py,148,75,75,2,4,2,4,6,6,10,1,15.5097750043269,0.861654166907052,15.5097750043269,6,78.0359973581544,0,0
transformers_4.23.0,src/transformers/models/clip/modeling_tf_clip.py,1415,449,921,13,104,96,165,117,261,744.951447022508,10.3125,18492.0160405537,1027.33422447521,1793.16519181127,91,31.5204861113578,1,1
transformers_4.23.0,src/transformers/models/squeezebert/tokenization_squeezebert.py,517,238,288,17,137,84,172,154,256,1041.91726366685,10.6715328467153,19852.2243223282,1102.90135124046,1860.2973544179,86,42.8911161215739,0,0
transformers_4.23.0,src/transformers/models/squeezebert/tokenization_squeezebert_fast.py,212,49,101,5,32,18,37,37,55,171.609640474437,2.890625,828.221687426165,46.0123159681203,286.519935109592,10,72.7343760300529,0,0
transformers_4.23.0,src/transformers/models/squeezebert/__init__.py,97,38,68,1,4,4,4,5,8,8,0.5,9.28771237954945,0.51598402108608,18.5754247590989,14,79.4552471452037,0,0
transformers_4.23.0,src/transformers/models/squeezebert/configuration_squeezebert.py,176,44,76,1,2,1,2,3,3,2,0.5,2.37744375108173,0.13208020839343,4.75488750216347,4,84.1227710719319,0,0
transformers_4.23.0,src/transformers/models/squeezebert/modeling_squeezebert.py,1098,469,767,13,86,119,202,99,321,600.764485240215,15.2674418604651,32489.4746829629,1804.97081572016,2128.02347504555,123,24.4007811010333,0,0
transformers_4.23.0,src/transformers/models/herbert/__init__.py,49,23,22,1,2,2,2,3,4,2,0.5,3.16992500144231,0.176106944524573,6.33985000288463,8,92.2814655295801,0,0
transformers_4.23.0,src/transformers/models/herbert/tokenization_herbert_fast.py,174,45,74,3,44,27,54,47,81,244.969878722205,1.84090909090909,828.264942178568,46.0147190099204,449.921696985889,10,70.7663990533407,0,0
transformers_4.23.0,src/transformers/models/herbert/tokenization_herbert.py,649,351,413,16,159,103,207,175,310,1226.74838989021,10.4150943396226,24057.5706689952,1336.53170383307,2309.87544466802,105,34.3796221891146,0,0
transformers_4.23.0,src/transformers/models/big_bird/tokenization_big_bird.py,278,100,132,6,59,35,67,65,102,362.585714916676,3.40677966101695,2092.72177801202,116.262321000668,614.281516928902,33,61.1882287152221,0,0
transformers_4.23.0,src/transformers/models/big_bird/__init__.py,151,65,120,1,8,8,8,9,16,24,0.5,25.3594000115385,1.40885555619658,50.718800023077,26,65.0885508848959,0,0
transformers_4.23.0,src/transformers/models/big_bird/modeling_flax_big_bird.py,2582,1062,1850,20,299,363,637,319,1000,2545.41506248298,21.304347826087,177197.05133673,9844.28062981832,8317.41261376487,219,0.354200151779616,0,0
transformers_4.23.0,src/transformers/models/big_bird/tokenization_big_bird_fast.py,258,73,125,7,55,35,67,62,102,337.626268698259,4.26363636363636,2589.42584632989,143.856991462771,607.328023659461,25,65.1746927275884,0,0
transformers_4.23.0,src/transformers/models/big_bird/modeling_big_bird.py,3162,1350,2133,21,455,583,1020,476,1603,4109.76251034251,23.5384615384615,335620.632278637,18645.5906821465,14258.3928745826,339,0,0,0
transformers_4.23.0,src/transformers/models/big_bird/configuration_big_bird.py,180,44,82,1,2,1,2,3,3,2,0.5,2.37744375108173,0.13208020839343,4.75488750216347,4,85.3609652734538,0,0
transformers_4.23.0,src/transformers/models/big_bird/convert_bigbird_original_tf_checkpoint_to_pytorch.py,71,23,39,1,2,1,2,3,3,2,0.5,2.37744375108173,0.13208020839343,4.75488750216347,3,94.0021979131326,0,0
transformers_4.23.0,src/transformers/models/openai/convert_openai_original_tf_checkpoint_to_pytorch.py,75,27,44,2,10,6,12,12,18,35.2192809488736,1.2,77.435190015577,4.30195500086539,64.5293250129808,3,84.0639376134171,0,0
transformers_4.23.0,src/transformers/models/openai/modeling_openai.py,856,414,600,17,128,142,243,145,385,965.486868301256,16.13671875,44606.1668499137,2478.12038055076,2764.26499965575,106,28.523651497381,0,0
transformers_4.23.0,src/transformers/models/openai/tokenization_openai_fast.py,76,27,28,0,0,0,0,0,0,0,0,0,0,0,4,100,0,0
transformers_4.23.0,src/transformers/models/openai/__init__.py,123,52,92,1,6,6,6,7,12,15.5097750043269,0.5,16.8441295323456,0.935784974019201,33.6882590646913,20,71.4191641741579,0,0
transformers_4.23.0,src/transformers/models/openai/configuration_openai.py,161,30,51,0,0,0,0,0,0,0,0,0,0,0,2,100,0,0
transformers_4.23.0,src/transformers/models/openai/tokenization_openai.py,393,248,247,15,105,70,141,120,211,763.599138289071,10.0714285714286,14677.6358649964,815.42421472202,1457.3539156734,84,41.8736709521676,0,0
transformers_4.23.0,src/transformers/models/openai/modeling_tf_openai.py,920,367,667,14,93,106,173,107,279,661.444738341853,13.0215053763441,24491.7495615954,1360.65275342196,1880.86928920592,87,31.7335026861135,1,1
transformers_4.23.0,src/transformers/models/mbart/modeling_mbart.py,1898,693,1269,17,197,242,430,214,672,1571.03107673416,18.5532994923858,96519.1957021271,5362.17753900706,5202.26581486157,223,7.49982216591628,0,0
transformers_4.23.0,src/transformers/models/mbart/convert_mbart_original_checkpoint_to_pytorch.py,83,36,54,2,4,2,4,6,6,10,1,15.5097750043269,0.861654166907052,15.5097750043269,6,82.3436322371481,0,0
transformers_4.23.0,src/transformers/models/mbart/__init__.py,152,79,118,1,10,10,10,11,20,33.2192809488736,0.5,34.594316186373,1.9219064547985,69.188632372746,32,61.624608595515,0,0
transformers_4.23.0,src/transformers/models/mbart/modeling_flax_mbart.py,1777,709,1351,14,170,172,304,184,476,1312.89942805222,12.5176470588235,44828.3915589701,2490.46619772056,3581.21549108314,164,9.4422964847129,0,0
transformers_4.23.0,src/transformers/models/mbart/configuration_mbart.py,390,151,263,8,32,19,35,40,54,184,4.375,1257.30551241714,69.8503062453966,287.384117123918,32,58.3970310746081,0,0
transformers_4.23.0,src/transformers/models/mbart/tokenization_mbart_fast.py,292,108,170,8,57,40,77,65,117,356.47473080739,5.40350877192982,3807.40432474199,211.522462485666,704.617034124329,29,59.6523475722994,0,0
transformers_4.23.0,src/transformers/models/mbart/tokenization_mbart.py,355,154,199,11,84,52,101,95,153,575.008411318426,6.61309523809524,6647.40336827928,369.300187126627,1005.18790807464,47,53.3349878124428,0,0
transformers_4.23.0,src/transformers/models/mbart/modeling_tf_mbart.py,1491,498,1029,14,132,154,270,146,424,983.162992664122,14.3181818181818,43648.7712765462,2424.9317375859,3048.48561296513,147,21.7085958411166,1,1
transformers_4.23.0,src/transformers/models/xglm/tokenization_xglm_fast.py,205,54,88,6,32,22,41,38,63,175.509775004327,3.84375,1270.81844692732,70.6010248292957,330.619433346946,16,69.9624183302324,0,0
transformers_4.23.0,src/transformers/models/xglm/__init__.py,143,79,105,1,10,10,10,11,20,33.2192809488736,0.5,34.594316186373,1.9219064547985,69.188632372746,32,63.0679857480712,0,0
transformers_4.23.0,src/transformers/models/xglm/tokenization_xglm.py,313,107,130,9,67,40,77,76,117,434.957300773652,5.17164179104478,3780.50903520537,210.028279733632,731.0075190729,34,58.3702013069251,0,0
transformers_4.23.0,src/transformers/models/xglm/convert_xglm_original_ckpt_to_trfms.py,68,35,53,2,3,2,3,5,5,6.75488750216347,1,11.6096404744368,0.644980026357601,11.6096404744368,4,66.5342362045567,0,0
transformers_4.23.0,src/transformers/models/xglm/modeling_tf_xglm.py,1001,353,743,16,128,126,223,144,349,960,13.9375,34875.8595679532,1937.54775377518,2502.30382550337,97,27.9670205328571,1,1
transformers_4.23.0,src/transformers/models/xglm/modeling_flax_xglm.py,818,369,617,15,115,94,167,130,261,845.834714792731,10.8913043478261,19961.9964695525,1108.99980386403,1832.83799920043,81,29.3797380699329,0,0
transformers_4.23.0,src/transformers/models/xglm/configuration_xglm.py,140,28,58,0,0,0,0,0,0,0,0,0,0,0,2,100,0,0
transformers_4.23.0,src/transformers/models/xglm/modeling_xglm.py,951,385,617,16,144,147,260,160,407,1096.46920020769,14.4444444444444,43044.8017222767,2391.37787345982,2980.02473461916,115,29.9531238688346,0,0
transformers_4.23.0,src/transformers/models/pegasus/modeling_tf_pegasus.py,1503,513,1033,16,136,152,269,152,421,1027.89494641005,15.8235294117647,48283.5613511749,2682.42007506527,3051.37748315975,148,21.4509496746326,1,1
transformers_4.23.0,src/transformers/models/pegasus/modeling_flax_pegasus.py,1529,619,1153,16,154,151,273,170,424,1183.08512726701,14.1818181818182,44553.3412799902,2475.18562666612,3141.58175692239,148,14.2572294518168,0,0
transformers_4.23.0,src/transformers/models/pegasus/tokenization_pegasus.py,298,124,158,10,55,39,74,65,113,351.19406519273,6.72727272727273,4578.09451386763,254.338584103757,680.527562872215,44,57.7821802296221,0,0
transformers_4.23.0,src/transformers/models/pegasus/__init__.py,144,79,110,1,10,10,10,11,20,33.2192809488736,0.5,34.594316186373,1.9219064547985,69.188632372746,32,62.1930992384778,0,0
transformers_4.23.0,src/transformers/models/pegasus/configuration_pegasus.py,169,40,73,0,0,0,0,0,0,0,0,0,0,0,4,100,0,0
transformers_4.23.0,src/transformers/models/pegasus/convert_pegasus_tf_to_pytorch.py,132,76,93,8,30,17,34,38,51,171.206717868256,4.53333333333333,1213.32084110816,67.4067133948976,267.644303185623,21,63.1177563168072,0,0
transformers_4.23.0,src/transformers/models/pegasus/modeling_pegasus.py,1716,618,1046,18,167,194,349,185,543,1308.13726686913,18.8083832335329,76917.6380715125,4273.20211508403,4089.54013306036,200,14.8132679379197,0,0
transformers_4.23.0,src/transformers/models/pegasus/tokenization_pegasus_fast.py,218,70,115,9,41,28,52,50,80,248.188957202322,5.70731707317073,2576.90214323373,143.161230179652,451.508495181978,26,66.9040778688273,0,0
transformers_4.23.0,src/transformers/models/layoutlm/modeling_tf_layoutlm.py,1542,513,1010,11,114,118,207,125,325,817.003209419791,9.98684210526316,22609.0110318292,1256.05616843496,2263.87989251518,140,24.2283906909127,0,0
transformers_4.23.0,src/transformers/models/layoutlm/tokenization_layoutlm.py,63,18,27,0,0,0,0,0,0,0,0,0,0,0,1,100,0,0
transformers_4.23.0,src/transformers/models/layoutlm/__init__.py,124,52,94,1,6,6,6,7,12,15.5097750043269,0.5,16.8441295323456,0.935784974019201,33.6882590646913,20,71.2427478278226,0,0
transformers_4.23.0,src/transformers/models/layoutlm/configuration_layoutlm.py,196,51,94,4,8,5,8,12,13,32,2,93.2090250187501,5.17827916770834,46.604512509375,7,78.3257001073671,0,0
transformers_4.23.0,src/transformers/models/layoutlm/tokenization_layoutlm_fast.py,73,20,37,0,0,0,0,0,0,0,0,0,0,0,1,100,0,0
transformers_4.23.0,src/transformers/models/layoutlm/modeling_layoutlm.py,1368,558,891,14,165,176,308,179,484,1268.74613425937,13.0666666666667,47329.6466596264,2629.42481442369,3622.1668361959,155,20.3728466931184,0,0
transformers_4.23.0,src/transformers/models/convbert/__init__.py,134,52,102,1,6,6,6,7,12,15.5097750043269,0.5,16.8441295323456,0.935784974019201,33.6882590646913,20,70.5734836890522,0,0
transformers_4.23.0,src/transformers/models/convbert/convert_convbert_original_tf1_checkpoint_to_pytorch_and_tf2.py,57,19,31,1,2,1,2,3,3,2,0.5,2.37744375108173,0.13208020839343,4.75488750216347,2,96.0901158808716,0,0
transformers_4.23.0,src/transformers/models/convbert/modeling_tf_convbert.py,1332,535,1012,14,92,119,205,106,324,653.470668866052,15.5978260869565,34000.862349398,1888.93679718878,2179.84622727848,138,15.7291976282997,1,1
transformers_4.23.0,src/transformers/models/convbert/modeling_convbert.py,1351,647,1068,16,128,171,290,144,461,960,18.125,59909.2045901764,3328.28914389869,3305.33542566491,159,9.2821254916945,0,0
transformers_4.23.0,src/transformers/models/convbert/tokenization_convbert_fast.py,198,49,88,5,32,18,37,37,55,171.609640474437,2.890625,828.221687426165,46.0123159681203,286.519935109592,10,71.4560943447924,0,0
transformers_4.23.0,src/transformers/models/convbert/tokenization_convbert.py,515,238,286,17,137,84,172,154,256,1041.91726366685,10.6715328467153,19852.2243223282,1102.90135124046,1860.2973544179,86,42.9061925674413,0,0
transformers_4.23.0,src/transformers/models/convbert/configuration_convbert.py,165,41,79,1,2,1,2,3,3,2,0.5,2.37744375108173,0.13208020839343,4.75488750216347,4,86.8456558531749,0,0
transformers_4.23.0,src/transformers/models/gpt2/modeling_gpt2.py,1544,716,1124,18,218,248,421,236,669,1768.52283282733,17.3807339449541,91657.0953664561,5092.060853692,5273.48820002307,196,7.76421977005667,0,0
transformers_4.23.0,src/transformers/models/gpt2/tokenization_gpt2.py,361,181,223,15,78,52,100,93,152,548.864732005383,9.61538461538462,9557.23210854251,530.957339363473,993.952139288421,55,50.0305445388402,0,0
transformers_4.23.0,src/transformers/models/gpt2/modeling_flax_gpt2.py,779,369,597,12,102,83,149,114,232,723.606934889746,8.76470588235294,13894.0789417439,771.893274541329,1585.23048328622,79,28.6981454635937,0,0
transformers_4.23.0,src/transformers/models/gpt2/convert_gpt2_original_tf_checkpoint_to_pytorch.py,69,27,38,2,10,6,12,12,18,35.2192809488736,1.2,77.435190015577,4.30195500086539,64.5293250129808,3,84.63504312428,0,0
transformers_4.23.0,src/transformers/models/gpt2/configuration_gpt2.py,274,85,138,3,6,4,6,9,10,20.2646625064904,1.5,47.5488750216347,2.64160416786859,31.6992500144231,14,74.3541382992479,0,0
transformers_4.23.0,src/transformers/models/gpt2/__init__.py,141,66,109,1,8,8,8,9,16,24,0.5,25.3594000115385,1.40885555619658,50.718800023077,26,65.7220303882475,0,0
transformers_4.23.0,src/transformers/models/gpt2/modeling_tf_gpt2.py,1232,462,889,14,136,149,247,150,396,1017.19791531885,12.7132352941176,36393.0624726727,2021.83680403737,2862.61220143637,124,24.0537290642265,1,1
transformers_4.23.0,src/transformers/models/gpt2/tokenization_gpt2_fast.py,190,53,99,6,12,8,13,18,21,58.5293250129808,3.25,284.597381348438,15.8109656304688,87.5684250302886,12,76.4019380811255,0,0
transformers_4.23.0,src/transformers/models/vision_text_dual_encoder/configuration_vision_text_dual_encoder.py,128,41,37,2,6,4,8,8,12,17.5097750043269,1.33333333333333,48,2.66666666666667,36,8,66.9393787053133,0,0
transformers_4.23.0,src/transformers/models/vision_text_dual_encoder/__init__.py,72,38,40,1,4,4,4,5,8,8,0.5,9.28771237954945,0.51598402108608,18.5754247590989,14,83.3057187569031,0,0
transformers_4.23.0,src/transformers/models/vision_text_dual_encoder/processing_vision_text_dual_encoder.py,110,31,26,3,7,9,18,10,27,24.4063719565667,3.85714285714286,345.955083024698,19.2197268347055,89.6920585619588,12,47.5288313941766,0,0
transformers_4.23.0,src/transformers/models/vision_text_dual_encoder/modeling_flax_vision_text_dual_encoder.py,603,169,402,10,52,42,74,62,116,329.64214629221,7.11538461538462,4914.50203157317,273.027890642954,690.686772004878,43,50.2877113536836,1,1
transformers_4.23.0,src/transformers/models/vision_text_dual_encoder/modeling_vision_text_dual_encoder.py,538,128,293,11,40,30,56,51,86,250.930871600505,7.7,3756.28006145352,208.682225636307,487.828579409549,32,60.0051078610637,2,1
transformers_4.23.0,src/transformers/models/rag/__init__.py,86,39,57,1,4,4,4,5,8,8,0.5,9.28771237954945,0.51598402108608,18.5754247590989,14,80.55404780271,0,0
transformers_4.23.0,src/transformers/models/rag/tokenization_rag.py,120,52,87,1,6,4,8,7,12,15.5097750043269,0.666666666666667,22.4588393764608,1.24771329869227,33.6882590646913,15,72.5498154265381,0,0
transformers_4.23.0,src/transformers/models/rag/modeling_rag.py,1728,510,1005,15,156,183,332,171,515,1195.12610507664,15.9615384615385,60976.1741824611,3387.56523235895,3820.19404516624,144,25.5874885726905,1,1
transformers_4.23.0,src/transformers/models/rag/modeling_tf_rag.py,1826,531,1061,15,170,187,338,185,525,1318.19981807754,14.9117647058824,58960.7488309685,3275.59715727603,3953.97526677106,143,25.2176454842779,2,1
transformers_4.23.0,src/transformers/models/rag/retrieval_rag.py,652,278,368,14,70,43,81,84,124,482.352780094954,8.1,6420.44361943899,356.691312191055,792.647360424566,85,44.0303880779056,0,0
transformers_4.23.0,src/transformers/models/rag/configuration_rag.py,194,51,146,3,7,4,8,10,12,24.4063719565667,1.71428571428571,68.3368065233972,3.79648925129984,39.8631371386484,6,72.8469665143728,0,0
transformers_4.23.0,src/transformers/models/megatron_bert/convert_megatron_bert_checkpoint.py,338,156,160,11,69,56,112,80,168,459.541935322704,8.92753623188406,9481.79267657541,526.766259809745,1062.08391994108,30,55.9513446418277,0,0
transformers_4.23.0,src/transformers/models/megatron_bert/__init__.py,73,23,48,1,2,2,2,3,4,2,0.5,3.16992500144231,0.176106944524573,6.33985000288463,8,90.8165051883758,0,0
transformers_4.23.0,src/transformers/models/megatron_bert/modeling_megatron_bert.py,1845,781,1279,16,197,237,409,213,646,1565.54420843291,16.6091370558376,82989.5865014558,4610.53258341421,4996.62241466589,222,4.9306572053256,0,0
transformers_4.23.0,src/transformers/models/megatron_bert/configuration_megatron_bert.py,127,24,42,0,0,0,0,0,0,0,0,0,0,0,2,100,0,0
transformers_4.23.0,src/transformers/models/data2vec/convert_data2vec_vision_original_pytorch_checkpoint_to_pytorch.py,374,198,278,12,38,25,46,50,71,242.44079551951,7.26315789473684,2910.44752354804,161.691529086002,400.713789474005,28,49.5585286129199,0,0
transformers_4.23.0,src/transformers/models/data2vec/__init__.py,139,33,112,1,2,2,2,3,4,2,0.5,3.16992500144231,0.176106944524573,6.33985000288463,10,80.5435554716329,0,0
transformers_4.23.0,src/transformers/models/data2vec/configuration_data2vec_audio.py,284,59,115,2,9,5,11,11,16,30.5293250129808,1.22222222222222,67.6511072089072,3.75839484493929,55.3509058981968,7,69.338744611581,0,0
transformers_4.23.0,src/transformers/models/data2vec/modeling_data2vec_audio.py,1543,715,1052,19,184,213,368,203,581,1465.04602266992,19,84617.6431898072,4700.98017721151,4453.56016788459,192,9.91982275222786,0,0
transformers_4.23.0,src/transformers/models/data2vec/configuration_data2vec_text.py,151,39,62,1,2,1,2,3,3,2,0.5,2.37744375108173,0.13208020839343,4.75488750216347,4,83.6240648105622,0,0
transformers_4.23.0,src/transformers/models/data2vec/modeling_tf_data2vec_vision.py,1482,654,1013,16,186,164,298,202,462,1466.28353886609,12.8172043010753,45348.4698537349,2519.3594363186,3538.09370503133,159,16.0951608203911,0,0
transformers_4.23.0,src/transformers/models/data2vec/modeling_data2vec_vision.py,1218,583,810,16,190,174,318,206,492,1502.27256558288,13.3894736842105,50635.7526939359,2813.09737188533,3781.75825937414,153,19.2919702409173,0,0
transformers_4.23.0,src/transformers/models/data2vec/convert_data2vec_text_original_pytorch_checkpoint_to_pytorch.py,204,106,147,4,11,10,19,15,29,46.0537478050103,3.45454545454545,391.399403305508,21.7444112947504,113.299827272647,16,64.0620679495186,0,0
transformers_4.23.0,src/transformers/models/data2vec/convert_data2vec_audio_original_pytorch_checkpoint_to_pytorch.py,286,175,211,10,51,48,81,61,129,322.51297338942,7.94117647058824,6075.51710197986,337.52872788777,765.065116545612,37,44.7127095271232,0,0
transformers_4.23.0,src/transformers/models/data2vec/configuration_data2vec_vision.py,202,52,88,0,0,0,0,0,0,0,0,0,0,0,4,100,0,0
transformers_4.23.0,src/transformers/models/data2vec/modeling_data2vec_text.py,1570,674,1107,15,178,215,373,193,588,1389.28390964615,15.7162921348315,70163.2604174909,3897.95891208283,4464.36473791363,197,9.4976543765851,0,0
transformers_4.23.0,src/transformers/models/luke/tokenization_luke.py,1391,450,1023,18,365,252,497,383,749,3181.84836865105,12.2547945205479,78765.4765534515,4375.85980852508,6427.31923586179,195,12.9000601121994,1,1
transformers_4.23.0,src/transformers/models/luke/__init__.py,77,24,50,1,2,2,2,3,4,2,0.5,3.16992500144231,0.176106944524573,6.33985000288463,8,90.1468673583409,0,0
transformers_4.23.0,src/transformers/models/luke/modeling_luke.py,2236,849,1407,14,125,227,370,139,597,924.026004491567,20.72,88060.1620390182,4892.2312243899,4250.00782041593,199,11.1773414435457,0,0
transformers_4.23.0,src/transformers/models/luke/configuration_luke.py,137,28,49,0,0,0,0,0,0,0,0,0,0,0,2,100,0,0
transformers_4.23.0,src/transformers/models/luke/convert_luke_original_pytorch_checkpoint_to_pytorch.py,170,85,114,7,42,36,56,49,92,246.128816211111,4.66666666666667,2410.58209307346,133.92122739297,516.553305658599,19,61.379505334579,0,0
transformers_4.23.0,src/transformers/models/bloom/tokenization_bloom_fast.py,170,50,81,6,14,10,15,20,25,68.8127439131334,3.21428571428571,347.297793339163,19.2943218521757,108.048202372184,14,75.7184916205729,0,0
transformers_4.23.0,src/transformers/models/bloom/__init__.py,81,37,54,1,4,4,4,5,8,8,0.5,9.28771237954945,0.51598402108608,18.5754247590989,14,81.4416407607028,0,0
transformers_4.23.0,src/transformers/models/bloom/modeling_bloom.py,1262,521,861,18,205,201,378,223,579,1649.35207042458,16.5951219512195,74955.536512523,4164.19647291795,4516.72104205386,137,21.0173279771659,0,0
transformers_4.23.0,src/transformers/models/bloom/convert_bloom_original_checkpoint_to_pytorch.py,254,129,184,11,52,37,72,63,109,334.476613148347,7.61538461538462,4961.60212726828,275.644562626015,651.523511661491,38,51.1224403747277,0,0
transformers_4.23.0,src/transformers/models/bloom/configuration_bloom.py,244,86,132,5,9,7,12,14,19,40.1389654874176,3.33333333333333,241.132478396982,13.3962487998323,72.3397435190945,17,71.729277646712,0,0
transformers_4.23.0,src/transformers/models/vision_encoder_decoder/configuration_vision_encoder_decoder.py,222,84,94,2,5,3,6,7,9,13.6096404744368,1.2,30.3194331582221,1.68441295323456,25.2661942985184,15,73.7441929690962,0,0
transformers_4.23.0,src/transformers/models/vision_encoder_decoder/__init__.py,88,51,58,1,6,6,6,7,12,15.5097750043269,0.5,16.8441295323456,0.935784974019201,33.6882590646913,20,75.2675016620353,0,0
transformers_4.23.0,src/transformers/models/vision_encoder_decoder/modeling_tf_vision_encoder_decoder.py,744,234,457,11,81,72,136,92,208,551.581598038665,9.23456790123457,12530.3933749528,696.132965275154,1356.90088685986,91,41.6253103768739,0,0
transformers_4.23.0,src/transformers/models/vision_encoder_decoder/modeling_vision_encoder_decoder.py,562,167,347,11,69,60,113,80,173,459.541935322704,9.00724637681159,9851.16735939481,547.287075521934,1093.69356041551,67,48.5099309100924,1,1
transformers_4.23.0,src/transformers/models/vision_encoder_decoder/modeling_flax_vision_encoder_decoder.py,864,253,553,11,82,68,126,93,194,559.373012183693,8.45121951219512,10721.1901083291,595.62167268495,1268.59680935496,72,42.7583201377015,1,1
transformers_4.23.0,src/transformers/models/dpt/convert_dpt_to_pytorch.py,283,182,214,8,62,60,120,70,180,393.160171243986,7.74193548387097,8541.45246232331,474.525136795739,1103.27094305009,59,42.9545918344874,0,0
transformers_4.23.0,src/transformers/models/dpt/__init__.py,78,38,49,1,4,4,4,5,8,8,0.5,9.28771237954945,0.51598402108608,18.5754247590989,14,81.8505861253324,0,0
transformers_4.23.0,src/transformers/models/dpt/feature_extraction_dpt.py,245,89,113,11,47,32,63,58,95,299.119423833859,7.37234042553192,4102.76785972579,227.931547762544,556.508194537119,37,61.7697482017867,0,0
transformers_4.23.0,src/transformers/models/dpt/modeling_dpt.py,1130,510,684,15,106,99,175,121,274,771.762927117827,12.3820754716981,23473.5489783479,1304.08605435266,1895.76852701324,130,26.7532691481304,0,0
transformers_4.23.0,src/transformers/models/dpt/configuration_dpt.py,170,37,64,1,2,1,2,3,3,2,0.5,2.37744375108173,0.13208020839343,4.75488750216347,3,79.4406723539531,0,0
transformers_4.23.0,src/transformers/models/deberta_v2/tokenization_deberta_v2.py,530,269,300,16,148,91,183,164,274,1130.99909811308,9.89189189189189,19941.7498711114,1107.87499283952,2015.96924926536,105,38.4997672978829,0,0
transformers_4.23.0,src/transformers/models/deberta_v2/modeling_tf_deberta_v2.py,1574,661,1153,18,208,220,376,226,596,1676.75011139931,16.2692307692308,75828.064532945,4212.67025183027,4660.82666159945,176,9.36253170657106,0,0
transformers_4.23.0,src/transformers/models/deberta_v2/__init__.py,129,52,98,1,6,6,6,7,12,15.5097750043269,0.5,16.8441295323456,0.935784974019201,33.6882590646913,20,70.9010452241784,0,0
transformers_4.23.0,src/transformers/models/deberta_v2/tokenization_deberta_v2_fast.py,247,64,110,6,55,33,63,61,96,333.484559248183,3.43636363636364,1956.49633186802,108.694240659334,569.350784406037,16,66.143566971775,0,0
transformers_4.23.0,src/transformers/models/deberta_v2/modeling_deberta_v2.py,1679,836,1214,21,244,311,516,265,827,2027.3385762437,22.2049180327869,147823.129908375,8212.39610602082,6657.22475039562,228,0,0,0
transformers_4.23.0,src/transformers/models/deberta_v2/configuration_deberta_v2.py,185,59,99,4,12,6,12,16,18,51.0195500086539,2,144,8,72,12,75.7774013462065,0,0
transformers_4.23.0,src/transformers/models/yoso/modeling_yoso.py,1318,654,993,17,180,218,370,197,588,1418.0204256406,17.4722222222222,78306.419709155,4350.35665050861,4481.76646984035,161,9.38050836030232,0,0
transformers_4.23.0,src/transformers/models/yoso/__init__.py,70,23,42,1,2,2,2,3,4,2,0.5,3.16992500144231,0.176106944524573,6.33985000288463,8,91.9155709627847,0,0
transformers_4.23.0,src/transformers/models/yoso/convert_yoso_pytorch_to_pytorch.py,109,65,74,6,29,24,46,35,70,156.391223863027,4.75862068965517,1708.58186012719,94.9212144515103,359.049811186148,21,63.227193639309,0,0
transformers_4.23.0,src/transformers/models/yoso/configuration_yoso.py,145,30,55,0,0,0,0,0,0,0,0,0,0,0,2,100,0,0
transformers_4.23.0,src/transformers/models/poolformer/feature_extraction_poolformer.py,171,51,74,7,29,19,36,36,55,160.532933313103,4.3448275862069,1235.4338020688,68.6352112260445,284.345875079327,26,68.9941648123304,0,0
transformers_4.23.0,src/transformers/models/poolformer/configuration_poolformer.py,127,27,46,0,0,0,0,0,0,0,0,0,0,0,2,100,0,0
transformers_4.23.0,src/transformers/models/poolformer/__init__.py,76,37,46,1,4,4,4,5,8,8,0.5,9.28771237954945,0.51598402108608,18.5754247590989,14,82.8589537833708,0,0
transformers_4.23.0,src/transformers/models/poolformer/modeling_poolformer.py,458,236,309,13,72,66,118,85,184,492.340316439681,10.6527777777778,12563.1183893784,697.951021632131,1179.32793224934,69,40.7236707303008,0,0
transformers_4.23.0,src/transformers/models/poolformer/convert_poolformer_original_to_pytorch.py,214,145,146,7,45,41,70,52,111,266.784873789239,5.44444444444444,3444.96573632993,191.386985351663,632.748808713661,30,54.0339704136428,0,0
transformers_4.23.0,src/transformers/models/opt/modeling_opt.py,1230,479,793,16,138,164,285,154,449,1044.97637503539,16.5217391304348,53906.9182423202,2994.82879124001,3262.78715677201,149,22.8650327519078,0,0
transformers_4.23.0,src/transformers/models/opt/__init__.py,105,51,75,1,6,6,6,7,12,15.5097750043269,0.5,16.8441295323456,0.935784974019201,33.6882590646913,20,73.2690734500327,0,0
transformers_4.23.0,src/transformers/models/opt/modeling_flax_opt.py,804,359,590,13,88,75,132,101,207,616.535698775916,9.75,13437.9353250638,746.551962503545,1378.24977692962,80,30.9955826704569,0,0
transformers_4.23.0,src/transformers/models/opt/convert_opt_original_pytorch_checkpoint_to_pytorch.py,93,42,53,3,9,5,10,12,15,33.2842125151443,1.66666666666667,89.6240625180289,4.97911458433494,53.7744375108174,8,79.3486149321168,0,0
transformers_4.23.0,src/transformers/models/opt/modeling_tf_opt.py,1030,356,678,13,87,106,184,100,290,608.641800474674,13.7471264367816,26486.8400099019,1471.49111166122,1926.71829503467,104,32.5796906771373,1,1
transformers_4.23.0,src/transformers/models/opt/configuration_opt.py,141,27,57,1,2,1,2,3,3,2,0.5,2.37744375108173,0.13208020839343,4.75488750216347,3,86.1376467293454,0,0
transformers_4.23.0,src/transformers/models/wav2vec2_conformer/convert_wav2vec2_conformer_original_pytorch_checkpoint_to_pytorch.py,307,165,250,10,70,62,116,80,178,462.269092135021,8.28571428571429,9323.94080737388,517.996711520771,1125.30320088995,54,39.8621355696522,0,0
transformers_4.23.0,src/transformers/models/wav2vec2_conformer/configuration_wav2vec2_conformer.py,357,74,145,2,9,5,11,11,16,30.5293250129808,1.22222222222222,67.6511072089072,3.75839484493929,55.3509058981968,7,66.9464114991139,0,0
transformers_4.23.0,src/transformers/models/wav2vec2_conformer/modeling_wav2vec2_conformer.py,2142,990,1379,19,305,333,579,324,912,2597.77357965275,18.0344262295082,137168.821593674,7620.49008853745,7605.94320263078,226,2.87541609016606,0,0
transformers_4.23.0,src/transformers/models/wav2vec2_conformer/__init__.py,74,23,48,1,2,2,2,3,4,2,0.5,3.16992500144231,0.176106944524573,6.33985000288463,8,90.8165051883758,0,0
transformers_4.23.0,src/transformers/models/bigbird_pegasus/convert_bigbird_pegasus_tf_to_pytorch.py,171,78,133,7,24,19,37,31,56,129.690584471711,5.39583333333333,1496.9929851219,83.1662769512167,277.434993381665,32,56.5661720107043,0,0
transformers_4.23.0,src/transformers/models/bigbird_pegasus/__init__.py,75,23,48,1,2,2,2,3,4,2,0.5,3.16992500144231,0.176106944524573,6.33985000288463,8,90.8165051883758,0,0
transformers_4.23.0,src/transformers/models/bigbird_pegasus/configuration_bigbird_pegasus.py,423,155,283,8,32,19,35,40,54,184,4.375,1257.30551241714,69.8503062453966,287.384117123918,32,58.2768502048416,0,0
transformers_4.23.0,src/transformers/models/bigbird_pegasus/modeling_bigbird_pegasus.py,3102,1209,2091,20,443,589,1035,463,1624,3980.92372152762,23.3634311512415,335973.295108784,18665.1830615991,14380.3062544146,330,0,0,0
transformers_4.23.0,src/transformers/models/deit/feature_extraction_deit.py,160,44,65,5,25,14,28,30,42,127.706045218805,2.8,577.050334043562,32.058351891309,206.089405015558,24,69.9036865962272,0,0
transformers_4.23.0,src/transformers/models/deit/__init__.py,115,51,84,1,6,6,6,7,12,15.5097750043269,0.5,16.8441295323456,0.935784974019201,33.6882590646913,20,72.3484103684974,0,0
transformers_4.23.0,src/transformers/models/deit/modeling_tf_deit.py,1070,416,714,16,102,83,153,118,236,744.587384881092,12,19491.6451157927,1082.8691730996,1624.30375964939,104,31.0354472364132,0,0
transformers_4.23.0,src/transformers/models/deit/convert_deit_timm_to_pytorch.py,219,124,152,4,12,11,17,16,28,51.0195500086539,2.83333333333333,317.333333333333,17.6296296296296,112,17,62.6497930502229,0,0
transformers_4.23.0,src/transformers/models/deit/configuration_deit.py,146,38,61,0,0,0,0,0,0,0,0,0,0,0,4,100,0,0
transformers_4.23.0,src/transformers/models/deit/modeling_deit.py,890,389,569,16,114,102,183,130,285,842.949461614781,12.8421052631579,25701.8661956841,1427.88145531579,2001.37482671311,96,32.9358897533538,0,0
transformers_4.23.0,src/transformers/models/whisper/configuration_whisper.py,216,38,97,0,0,0,0,0,0,0,0,0,0,0,2,100,0,0
transformers_4.23.0,src/transformers/models/whisper/english_normalizer.py,602,352,477,17,168,170,337,185,507,1311.39619532809,17.0505952380952,65106.1701915478,3617.00945508599,3818.41040048177,125,23.8578639524402,0,0
transformers_4.23.0,src/transformers/models/whisper/__init__.py,92,40,64,1,4,4,4,5,8,8,0.5,9.28771237954945,0.51598402108608,18.5754247590989,14,79.4422295128452,0,0
transformers_4.23.0,src/transformers/models/whisper/processing_whisper.py,124,53,62,6,19,16,32,25,48,96.2203977597551,5.05263157894737,1126.25733276221,62.5698518201226,222.905097109187,20,72.1451139085537,0,0
transformers_4.23.0,src/transformers/models/whisper/feature_extraction_whisper.py,306,131,147,18,86,65,123,104,188,627.717418930342,12.8720930232558,16214.7524695425,900.819581641248,1259.68266701053,33,56.6281337082853,0,0
transformers_4.23.0,src/transformers/models/whisper/modeling_whisper.py,1230,461,788,15,143,159,283,158,442,1082.46496009344,14.8426573426573,47916.1216083819,2662.00675602122,3228.27109069428,151,23.4182332333924,0,0
transformers_4.23.0,src/transformers/models/whisper/tokenization_whisper.py,401,217,255,16,90,60,116,106,176,648.266778669671,10.3111111111111,12209.5310222544,678.307279014135,1184.11400000312,67,45.8612808914001,0,0
transformers_4.23.0,src/transformers/models/whisper/modeling_tf_whisper.py,1401,484,939,15,120,141,249,135,390,887.43023040715,15.5625,42951.8476643504,2386.21375913058,2759.95808284982,147,23.26484435477,0,0
transformers_4.23.0,src/transformers/models/splinter/__init__.py,83,38,54,1,4,4,4,5,8,8,0.5,9.28771237954945,0.51598402108608,18.5754247590989,14,81.1889942093981,0,0
transformers_4.23.0,src/transformers/models/splinter/modeling_splinter.py,1111,501,780,14,149,165,303,163,468,1128.95907845767,14.2348993288591,48956.7337602556,2719.81854223642,3439.20477618014,138,21.8103000629035,0,0
transformers_4.23.0,src/transformers/models/splinter/tokenization_splinter.py,531,251,300,17,161,102,208,178,310,1249.76448567771,10.9813664596273,25449.068191578,1413.83712175434,2317.47736359958,89,41.2639191443678,0,0
transformers_4.23.0,src/transformers/models/splinter/configuration_splinter.py,127,25,46,0,0,0,0,0,0,0,0,0,0,0,2,100,0,0
transformers_4.23.0,src/transformers/models/splinter/tokenization_splinter_fast.py,216,61,103,6,56,38,76,62,114,340.721650639553,4.07142857142857,2763.59768749242,153.53320486069,678.778379384104,12,67.6380332170768,0,0
transformers_4.23.0,src/transformers/models/nllb/tokenization_nllb.py,401,154,195,11,84,52,101,95,153,575.008411318426,6.61309523809524,6647.40336827928,369.300187126627,1005.18790807464,47,54.095944279878,0,0
transformers_4.23.0,src/transformers/models/nllb/__init__.py,68,35,41,1,4,4,4,5,8,8,0.5,9.28771237954945,0.51598402108608,18.5754247590989,14,83.6796997015283,0,0
transformers_4.23.0,src/transformers/models/nllb/tokenization_nllb_fast.py,336,108,168,8,57,40,77,65,117,356.47473080739,5.40350877192982,3807.40432474199,211.522462485666,704.617034124329,29,61.0294069034708,0,0
transformers_4.23.0,src/transformers/models/visual_bert/modeling_visual_bert.py,1605,590,1006,13,129,195,322,142,517,952.554032285434,16.2248062015504,59973.6861458973,3331.87145254985,3696.41926078392,145,21.6058299287894,0,0
transformers_4.23.0,src/transformers/models/visual_bert/__init__.py,69,23,42,1,2,2,2,3,4,2,0.5,3.16992500144231,0.176106944524573,6.33985000288463,8,91.6061716488424,0,0
transformers_4.23.0,src/transformers/models/visual_bert/configuration_visual_bert.py,151,26,61,0,0,0,0,0,0,0,0,0,0,0,2,100,0,0
transformers_4.23.0,src/transformers/models/visual_bert/convert_visual_bert_original_pytorch_checkpoint_to_pytorch.py,150,84,102,3,18,19,36,21,55,79.8135375281251,3,724.732374758496,40.2629097088053,241.577458252832,20,63.33234655745,0,0
transformers_4.23.0,src/transformers/models/distilbert/modeling_distilbert.py,1137,479,739,14,110,126,219,124,345,799.252537396519,13.9363636363636,33436.0919601724,1857.56066445402,2399.19772708347,125,28.7790339550664,0,0
transformers_4.23.0,src/transformers/models/distilbert/tokenization_distilbert.py,76,19,42,0,0,0,0,0,0,0,0,0,0,0,1,100,0,0
transformers_4.23.0,src/transformers/models/distilbert/modeling_flax_distilbert.py,903,397,704,12,75,73,124,87,197,510.180951795845,9.92,12591.0578973274,699.50321651819,1269.2598686822,76,27.7398258946154,0,0
transformers_4.23.0,src/transformers/models/distilbert/__init__.py,170,66,137,1,8,8,8,9,16,24,0.5,25.3594000115385,1.40885555619658,50.718800023077,26,63.8895548984596,0,0
transformers_4.23.0,src/transformers/models/distilbert/modeling_tf_distilbert.py,1086,437,801,11,73,86,149,84,235,489.910940603252,11.2260273972603,16863.6776722232,936.870981790175,1502.19459435301,108,28.7950843272908,1,1
transformers_4.23.0,src/transformers/models/distilbert/tokenization_distilbert_fast.py,94,21,60,0,0,0,0,0,0,0,0,0,0,0,1,100,0,0
transformers_4.23.0,src/transformers/models/distilbert/configuration_distilbert.py,154,39,75,1,2,1,2,3,3,2,0.5,2.37744375108173,0.13208020839343,4.75488750216347,4,87.8308781969521,0,0
transformers_4.23.0,src/transformers/models/xlnet/configuration_xlnet.py,242,59,100,5,10,10,19,15,29,44.8289214233104,4.75,538.174179545073,29.8985655302819,113.299827272647,8,70.3276281232757,0,0
transformers_4.23.0,src/transformers/models/xlnet/__init__.py,146,65,113,1,8,8,8,9,16,24,0.5,25.3594000115385,1.40885555619658,50.718800023077,26,65.5739506771058,0,0
transformers_4.23.0,src/transformers/models/xlnet/convert_xlnet_original_tf_checkpoint_to_pytorch.py,114,39,79,3,6,4,8,9,12,20.2646625064904,2,76.0782000346155,4.22656666858975,38.0391000173078,5,77.9856094274419,0,0
transformers_4.23.0,src/transformers/models/xlnet/tokenization_xlnet.py,351,131,163,10,69,46,84,79,130,454.707468466567,6.08695652173913,4988.20911377493,277.122728543051,819.491497263023,40,56.7344363495669,0,0
transformers_4.23.0,src/transformers/models/xlnet/modeling_tf_xlnet.py,1788,709,1215,16,169,192,349,185,541,1314.74862473169,16.5207100591716,67313.2592747278,3739.62551526265,4074.47737013932,192,11.9031253781972,1,1
transformers_4.23.0,src/transformers/models/xlnet/tokenization_xlnet_fast.py,246,64,109,5,33,23,43,38,66,178.074646413266,3.25757575757576,1128.30441539037,62.6835786327984,346.363215887277,14,68.4700484045409,0,0
transformers_4.23.0,src/transformers/models/xlnet/modeling_xlnet.py,2092,869,1356,18,247,292,514,265,806,2038.30535622738,18.7287449392713,121515.429587632,6750.85719931291,6488.17793085715,227,5.77636845053867,1,1
transformers_4.23.0,src/transformers/models/time_series_transformer/modeling_time_series_transformer.py,1954,733,1165,17,217,229,402,234,631,1753.74348574171,15.7465437788018,78200.4878882083,4344.47154934491,4966.20013805713,207,11.7353482174392,0,0
transformers_4.23.0,src/transformers/models/time_series_transformer/configuration_time_series_transformer.py,229,58,105,7,26,15,30,33,45,141.862917126072,4.03846153846154,916.72162361418,50.9289790896767,226.99773537113,11,69.3362497810579,0,0
transformers_4.23.0,src/transformers/models/time_series_transformer/__init__.py,67,23,40,1,2,2,2,3,4,2,0.5,3.16992500144231,0.176106944524573,6.33985000288463,8,92.1383550729973,0,0
transformers_4.23.0,src/transformers/models/deformable_detr/configuration_deformable_detr.py,227,56,98,2,6,3,6,8,9,17.5097750043269,1,27,1.5,27,6,74.2381369495588,0,0
transformers_4.23.0,src/transformers/models/deformable_detr/feature_extraction_deformable_detr.py,970,528,556,21,227,195,343,248,538,1868.86517249339,15.8656387665198,67894.7420721576,3771.93011511987,4279.35761498814,156,22.9738916499739,0,0
transformers_4.23.0,src/transformers/models/deformable_detr/__init__.py,77,37,48,1,4,4,4,5,8,8,0.5,9.28771237954945,0.51598402108608,18.5754247590989,14,82.2365154235863,0,0
transformers_4.23.0,src/transformers/models/deformable_detr/convert_deformable_detr_to_pytorch.py,237,141,167,6,74,69,89,80,158,475.009324060869,3.60810810810811,3604.01160285025,200.222866825014,998.864638992203,35,50.9322103480444,0,0
transformers_4.23.0,src/transformers/models/deformable_detr/modeling_deformable_detr.py,2469,1178,1496,22,434,408,710,456,1118,3900.62073049092,17.9953917050691,177707.570944425,9872.64283024585,9875.17103583618,268,0,0,0
transformers_4.23.0,src/transformers/models/deformable_detr/load_custom.py,51,9,29,0,0,0,0,0,0,0,0,0,0,0,2,100,0,0
transformers_4.23.0,src/transformers/models/groupvit/configuration_groupvit.py,399,123,196,5,18,11,24,23,35,86.6682905003984,3.33333333333333,527.748894873318,29.3193830485177,158.324668461995,25,64.4121508759443,1,1
transformers_4.23.0,src/transformers/models/groupvit/modeling_groupvit.py,1607,682,1032,17,216,209,370,233,579,1744.54256876857,14.5601851851852,66297.8198196247,3683.21221220137,4553.36377775483,167,15.9640937398785,2,1
transformers_4.23.0,src/transformers/models/groupvit/__init__.py,101,37,74,1,4,4,4,5,8,8,0.5,9.28771237954945,0.51598402108608,18.5754247590989,14,79.0346038006344,1,1
transformers_4.23.0,src/transformers/models/groupvit/convert_groupvit_nvlab_to_hf.py,217,143,161,7,66,57,113,73,170,418.581496332061,5.99242424242424,6305.64930630755,350.313850350419,1052.2701750096,46,48.7065620864064,0,0
transformers_4.23.0,src/transformers/models/groupvit/modeling_tf_groupvit.py,1993,737,1316,16,191,157,279,207,436,1511.28890615483,11.6858638743456,39198.598008714,2177.699889373,3354.36031346971,171,14.5322508464287,0,0
transformers_4.23.0,src/transformers/models/ernie/__init__.py,74,23,48,1,2,2,2,3,4,2,0.5,3.16992500144231,0.176106944524573,6.33985000288463,8,90.8165051883758,0,0
transformers_4.23.0,src/transformers/models/ernie/configuration_ernie.py,169,41,75,1,2,1,2,3,3,2,0.5,2.37744375108173,0.13208020839343,4.75488750216347,4,85.1817460038282,0,0
transformers_4.23.0,src/transformers/models/ernie/modeling_ernie.py,1822,748,1269,15,174,228,392,189,620,1353.67552721181,16.8965517241379,79221.0085682194,4401.16714267885,4688.59030301706,213,6.95537704171732,0,0
transformers_4.23.0,src/transformers/models/yolos/modeling_yolos.py,1318,644,765,18,223,178,322,241,500,1814.65932770819,12.9955156950673,51416.0387811534,2856.44659895297,3956.44466811498,152,21.3650494783088,0,0
transformers_4.23.0,src/transformers/models/yolos/__init__.py,75,37,46,1,4,4,4,5,8,8,0.5,9.28771237954945,0.51598402108608,18.5754247590989,14,82.5026769126246,0,0
transformers_4.23.0,src/transformers/models/yolos/feature_extraction_yolos.py,938,509,540,21,224,193,338,245,531,1841.08616841926,15.84375,66771.1830007642,3709.51016670912,4214.35474561037,151,23.9334670562979,0,0
transformers_4.23.0,src/transformers/models/yolos/configuration_yolos.py,180,49,77,0,0,0,0,0,0,0,0,0,0,0,5,100,0,0
transformers_4.23.0,src/transformers/models/yolos/convert_yolos_to_pytorch.py,266,177,204,5,82,82,115,87,197,532.92890485312,3.50609756097561,4450.14892983088,247.230496101716,1269.2598686822,37,43.9654412069495,0,0
transformers_4.23.0,src/transformers/models/xlm_prophetnet/__init__.py,80,37,52,1,4,4,4,5,8,8,0.5,9.28771237954945,0.51598402108608,18.5754247590989,14,81.7047600121114,0,0
transformers_4.23.0,src/transformers/models/xlm_prophetnet/modeling_xlm_prophetnet.py,179,22,25,0,0,0,0,0,0,0,0,0,0,0,1,100,0,0
transformers_4.23.0,src/transformers/models/xlm_prophetnet/tokenization_xlm_prophetnet.py,339,123,156,8,58,35,67,66,102,363.762897717399,4.62068965517241,2848.78547666867,158.265859814926,616.528200174562,35,58.8663594950995,0,0
transformers_4.23.0,src/transformers/models/xlm_prophetnet/configuration_xlm_prophetnet.py,184,41,83,1,2,1,2,3,3,2,0.5,2.37744375108173,0.13208020839343,4.75488750216347,4,85.0048974293054,0,0
transformers_4.23.0,src/transformers/models/wav2vec2_with_lm/__init__.py,31,9,8,0,0,0,0,0,0,0,0,0,0,0,2,100,0,0
transformers_4.23.0,src/transformers/models/wav2vec2_with_lm/processing_wav2vec2_with_lm.py,552,178,246,11,44,36,65,55,101,278.268739025051,8.125,4744.32831491117,263.573795272843,583.917331065991,53,51.5668636410048,0,0
transformers_4.23.0,src/transformers/models/funnel/convert_funnel_original_tf_checkpoint_to_pytorch.py,65,21,34,1,2,1,2,3,3,2,0.5,2.37744375108173,0.13208020839343,4.75488750216347,3,95.1938074543363,0,0
transformers_4.23.0,src/transformers/models/funnel/tokenization_funnel.py,143,31,88,3,20,12,24,23,36,91.1934493999107,1.8,293.126814752494,16.2848230418052,162.848230418052,6,79.5366453739235,0,0
transformers_4.23.0,src/transformers/models/funnel/__init__.py,138,52,107,1,6,6,6,7,12,15.5097750043269,0.5,16.8441295323456,0.935784974019201,33.6882590646913,20,70.1826899778745,0,0
transformers_4.23.0,src/transformers/models/funnel/tokenization_funnel_fast.py,171,33,116,3,20,12,24,23,36,91.1934493999107,1.8,293.126814752494,16.2848230418052,162.848230418052,6,77.321664793263,0,0
transformers_4.23.0,src/transformers/models/funnel/modeling_tf_funnel.py,1712,772,1242,15,213,211,378,228,589,1706.09650804223,13.3098591549296,61405.9964272418,3411.44424595788,4613.57221834303,193,7.32283416296295,1,1
transformers_4.23.0,src/transformers/models/funnel/configuration_funnel.py,188,50,99,4,10,5,10,14,15,41.2192809488736,2,114.220647661728,6.34559153676267,57.1103238308641,10,77.8240023147002,0,0
transformers_4.23.0,src/transformers/models/funnel/modeling_funnel.py,1612,815,1187,20,274,279,504,294,783,2305.29935262893,18.3941605839416,118096.828349907,6560.93490832819,6420.34344600687,222,1.87119149932476,0,0
transformers_4.23.0,src/transformers/models/flava/configuration_flava.py,646,165,268,5,28,20,44,33,64,146.21557829205,3.92857142857143,1268.30480715298,70.4613781751657,322.841223638941,32,54.8981249855463,0,0
transformers_4.23.0,src/transformers/models/flava/modeling_flava.py,2095,927,1487,17,250,256,461,267,717,2060.93293946678,15.674,90588.1805398551,5032.67669665862,5779.51898301998,233,0,0,0
transformers_4.23.0,src/transformers/models/flava/__init__.py,99,39,72,1,4,4,4,5,8,8,0.5,9.28771237954945,0.51598402108608,18.5754247590989,14,78.7555039254676,0,0
transformers_4.23.0,src/transformers/models/flava/convert_dalle_to_flava_codebook.py,102,59,58,4,9,5,10,13,15,36.5293250129808,2.22222222222222,123.347990604703,6.85266614470573,55.5065957721164,15,73.8796550334777,0,0
transformers_4.23.0,src/transformers/models/flava/processing_flava.py,124,34,73,3,7,9,18,10,27,24.4063719565667,3.85714285714286,345.955083024698,19.2197268347055,89.6920585619588,12,80.4609086403139,0,0
transformers_4.23.0,src/transformers/models/flava/convert_flava_original_pytorch_to_hf.py,99,59,58,6,13,7,14,19,21,63.6154913401611,3.23076923076923,288.205543604403,16.0114190891335,89.2064777823153,11,72.9748893216327,0,0
transformers_4.23.0,src/transformers/models/flava/feature_extraction_flava.py,351,134,197,15,65,48,95,80,143,450.057266780977,10.9615384615385,9909.62228873594,550.534571596441,904.035717568893,51,55.2310365781255,0,0
transformers_4.23.0,src/transformers/models/bart/configuration_bart.py,405,155,274,10,36,21,39,46,60,219.336581000797,5.41666666666667,1795.15763571853,99.7309797621405,331.413717363421,34,57.3274036403836,0,0
transformers_4.23.0,src/transformers/models/bart/tokenization_bart_fast.py,304,86,150,7,41,26,50,48,76,239.311116643745,4.26829268292683,1811.70734779491,100.650408210828,424.457150054808,25,65.0331986017644,0,0
transformers_4.23.0,src/transformers/models/bart/__init__.py,140,66,109,1,8,8,8,9,16,24,0.5,25.3594000115385,1.40885555619658,50.718800023077,26,65.7220303882475,0,0
transformers_4.23.0,src/transformers/models/bart/convert_bart_original_pytorch_checkpoint_to_pytorch.py,150,87,104,4,13,8,15,17,23,56.1057163358342,2.30769230769231,216.949950804826,12.0527750447125,94.0116453487578,13,65.9619092932222,0,0
transformers_4.23.0,src/transformers/models/bart/modeling_tf_bart.py,1466,492,1022,14,131,150,264,145,414,974.681382110212,14.1068702290076,41932.42295661,2329.579053145,2972.48236326618,143,22.0220598452099,1,1
transformers_4.23.0,src/transformers/models/bart/modeling_flax_bart.py,2000,804,1528,14,177,186,330,191,516,1375.0691512735,13.0508474576271,51028.2037619519,2834.90020899733,3909.95327526645,181,5.39208290418152,0,0
transformers_4.23.0,src/transformers/models/bart/tokenization_bart.py,417,175,223,15,104,68,133,119,201,755.449089620801,9.59134615384615,13292.2473509503,738.458186163907,1385.8583704249,56,50.7771250178582,0,0
transformers_4.23.0,src/transformers/models/bart/modeling_bart.py,1906,695,1286,17,196,242,431,213,673,1561.96999774784,18.6913265306122,97296.9446472363,5405.38581373535,5205.45957441199,225,6.81652038077268,0,0
transformers_4.23.0,src/transformers/models/gptj/modeling_flax_gptj.py,722,349,538,15,104,77,134,119,211,755.449089620801,9.66346153846154,14058.4671230603,781.025951281125,1454.80654805798,61,31.2962791173061,0,0
transformers_4.23.0,src/transformers/models/gptj/__init__.py,116,51,86,1,6,6,6,7,12,15.5097750043269,0.5,16.8441295323456,0.935784974019201,33.6882590646913,20,72.1559285160581,0,0
transformers_4.23.0,src/transformers/models/gptj/configuration_gptj.py,223,78,125,3,6,4,6,9,10,20.2646625064904,1.5,47.5488750216347,2.64160416786859,31.6992500144231,14,75.566314648821,0,0
transformers_4.23.0,src/transformers/models/gptj/modeling_gptj.py,1121,536,835,17,173,187,316,190,503,1355.67755168241,15.5260115606936,59117.4218409271,3284.30121338484,3807.63737099047,139,17.2400734192129,0,0
transformers_4.23.0,src/transformers/models/gptj/modeling_tf_gptj.py,1075,441,825,14,130,133,216,144,349,966.210784602506,11.6307692307692,29103.7183397007,1616.87324109448,2502.30382550337,106,23.0021708677244,1,1
transformers_4.23.0,src/transformers/models/longt5/modeling_flax_longt5.py,2448,1022,1762,19,322,324,588,341,912,2763.26585750833,17.3478260869565,133113.836514641,7395.21313970229,7673.22867127005,194,3.25469570001573,0,0
transformers_4.23.0,src/transformers/models/longt5/convert_longt5x_checkpoint_to_flax.py,214,112,128,3,22,19,38,25,57,102.862383112184,2.59090909090909,685.813125480822,38.100729193379,264.699802817159,20,62.4317587169564,0,0
transformers_4.23.0,src/transformers/models/longt5/__init__.py,88,37,58,1,4,4,4,5,8,8,0.5,9.28771237954945,0.51598402108608,18.5754247590989,14,80.9249967887991,0,0
transformers_4.23.0,src/transformers/models/longt5/configuration_longt5.py,178,62,93,7,15,9,17,22,26,78.254843388531,3.96666666666667,459.916047602127,25.5508915334515,115.94522208457,11,73.8266629924866,0,0
transformers_4.23.0,src/transformers/models/longt5/modeling_longt5.py,2214,1015,1531,19,373,390,702,392,1092,3267.26149171063,17.8793565683646,168195.812187243,9344.21178818015,9407.26314977381,246,0,0,0
transformers_4.23.0,src/transformers/models/prophetnet/convert_prophetnet_original_pytorch_checkpoint_to_pytorch.py,160,99,117,8,36,31,57,44,88,210.117300051923,6.33333333333333,3042.72322212052,169.040179006696,480.429982440082,26,56.2894471244228,0,0
transformers_4.23.0,src/transformers/models/prophetnet/__init__.py,69,24,42,1,2,2,2,3,4,2,0.5,3.16992500144231,0.176106944524573,6.33985000288463,8,91.2029753017169,0,0
transformers_4.23.0,src/transformers/models/prophetnet/configuration_prophetnet.py,182,41,83,1,2,1,2,3,3,2,0.5,2.37744375108173,0.13208020839343,4.75488750216347,4,85.1817460038282,0,0
transformers_4.23.0,src/transformers/models/prophetnet/modeling_prophetnet.py,2354,884,1472,15,292,343,609,307,952,2450.03213012709,15.6421232876712,123033.344288799,6835.18579382217,7865.51429279241,238,3.62814009453879,0,0
transformers_4.23.0,src/transformers/models/prophetnet/tokenization_prophetnet.py,511,235,280,17,126,78,160,143,238,948.624138662245,10.7936507936508,18392.913922924,1021.82855127356,1704.04937815326,85,43.456468431233,0,0
transformers_4.23.0,src/transformers/models/regnet/__init__.py,86,37,56,1,4,4,4,5,8,8,0.5,9.28771237954945,0.51598402108608,18.5754247590989,14,81.6115974707885,0,0
transformers_4.23.0,src/transformers/models/regnet/convert_regnet_seer_10b_to_pytorch.py,304,168,205,7,22,18,36,29,54,117.758980064424,5.72727272727273,1502.44103140218,83.4689461890101,262.330973736889,27,55.8549981165134,0,0
transformers_4.23.0,src/transformers/models/regnet/convert_regnet_to_pytorch.py,459,193,354,12,46,30,59,58,89,297.103399987276,7.69565217391304,4012.20759201064,222.900421778369,521.360308566354,39,45.0137589673159,0,0
transformers_4.23.0,src/transformers/models/regnet/configuration_regnet.py,94,22,31,1,2,1,2,3,3,2,0.5,2.37744375108173,0.13208020839343,4.75488750216347,3,79.1740404999655,0,0
transformers_4.23.0,src/transformers/models/regnet/modeling_tf_regnet.py,523,215,370,13,43,40,76,56,116,281.435100788024,11.4883720930233,7739.17828961835,429.954349423242,673.653170958682,65,43.6161081405721,0,0
transformers_4.23.0,src/transformers/models/regnet/modeling_regnet.py,455,206,324,14,51,46,86,65,132,342.596661349353,11.8039215686275,9383.55756655869,521.308753697705,794.952551319756,61,43.1991678113699,0,0
transformers_4.23.0,src/transformers/models/wav2vec2_phoneme/tokenization_wav2vec2_phoneme.py,631,231,322,12,67,39,76,79,115,449.447525769325,6.80597014925373,4933.88451394638,274.104695219243,724.934786040367,77,47.2647578558423,0,0
transformers_4.23.0,src/transformers/models/wav2vec2_phoneme/__init__.py,31,9,8,0,0,0,0,0,0,0,0,0,0,0,2,100,0,0
transformers_4.23.0,src/transformers/models/rembert/modeling_rembert.py,1532,679,1111,16,166,197,339,182,536,1288.25654560359,16.3373493975904,65744.4008338633,3652.46671299241,4024.1779271465,197,8.71687002373985,0,0
transformers_4.23.0,src/transformers/models/rembert/tokenization_rembert_fast.py,241,65,105,7,54,34,66,61,100,330.415409571231,4.27777777777778,2537.03763884635,140.946535491464,593.073733756289,18,65.3039488311525,0,0
transformers_4.23.0,src/transformers/models/rembert/tokenization_rembert.py,269,88,118,7,53,33,65,60,98,323.231268546253,4.29245283018868,2484.794826964,138.044157053556,578.875278369635,24,63.043503505675,0,0
transformers_4.23.0,src/transformers/models/rembert/configuration_rembert.py,138,28,51,0,0,0,0,0,0,0,0,0,0,0,2,100,0,0
transformers_4.23.0,src/transformers/models/rembert/__init__.py,152,65,117,1,8,8,8,9,16,24,0.5,25.3594000115385,1.40885555619658,50.718800023077,26,65.2925564513968,0,0
transformers_4.23.0,src/transformers/models/rembert/modeling_tf_rembert.py,1639,618,1210,12,119,149,255,131,404,863.502863842299,12.8571428571429,36533.6086194145,2029.64492330081,2841.50289262113,180,12.0388770103868,1,1
transformers_4.23.0,src/transformers/models/rembert/convert_rembert_tf_checkpoint_to_pytorch.py,63,20,32,1,2,1,2,3,3,2,0.5,2.37744375108173,0.13208020839343,4.75488750216347,2,95.8446982931609,0,0
transformers_4.23.0,src/transformers/models/roformer/tokenization_utils.py,68,29,34,2,4,2,4,6,6,10,1,15.5097750043269,0.861654166907052,15.5097750043269,9,87.3699243116885,0,0
transformers_4.23.0,src/transformers/models/roformer/convert_roformer_original_tf_checkpoint_to_pytorch.py,63,20,32,1,2,1,2,3,3,2,0.5,2.37744375108173,0.13208020839343,4.75488750216347,2,95.8446982931609,0,0
transformers_4.23.0,src/transformers/models/roformer/modeling_tf_roformer.py,1410,559,1043,11,96,120,203,107,323,670.210147874241,11.6302083333333,25324.7069642953,1406.92816468307,2177.49383660757,144,16.6117308397582,1,1
transformers_4.23.0,src/transformers/models/roformer/__init__.py,174,66,139,1,8,8,8,9,16,24,0.5,25.3594000115385,1.40885555619658,50.718800023077,26,63.7757499963944,0,0
transformers_4.23.0,src/transformers/models/roformer/tokenization_roformer.py,335,117,186,7,64,38,75,71,113,403.651484454403,4.1015625,2850.26365519231,158.347980844017,694.921424504029,34,59.6238965144661,0,0
transformers_4.23.0,src/transformers/models/roformer/modeling_flax_roformer.py,1098,463,851,13,83,81,133,96,214,577.233989137629,10.4156626506024,14677.5640665171,815.420225917615,1409.18197515433,87,22.9227446389611,0,0
transformers_4.23.0,src/transformers/models/roformer/modeling_roformer.py,1581,725,1148,17,193,222,381,210,603,1534.831076494,16.779792746114,78054.394910383,4336.35527279906,4651.69004715267,204,6.69607773972282,0,0
transformers_4.23.0,src/transformers/models/roformer/configuration_roformer.py,162,41,76,2,4,2,4,6,6,10,1,15.5097750043269,0.861654166907052,15.5097750043269,5,83.0203697334454,0,0
transformers_4.23.0,src/transformers/models/roformer/tokenization_roformer_fast.py,213,61,121,5,29,17,34,34,51,152.491089333136,2.93103448275862,760.487979890352,42.2493322161307,259.460604903767,12,71.3983632152913,0,0
transformers_4.23.0,src/transformers/models/canine/convert_canine_original_tf_checkpoint_to_pytorch.py,67,22,33,1,2,1,2,3,3,2,0.5,2.37744375108173,0.13208020839343,4.75488750216347,2,94.9458236569989,0,0
transformers_4.23.0,src/transformers/models/canine/modeling_canine.py,1624,735,1132,19,212,214,374,231,588,1719.02975912283,16.7594339622642,77375.4312941554,4298.63507189752,4616.82843635264,189,10.2830247842318,0,0
transformers_4.23.0,src/transformers/models/canine/__init__.py,73,24,46,1,2,2,2,3,4,2,0.5,3.16992500144231,0.176106944524573,6.33985000288463,8,90.6794703302887,0,0
transformers_4.23.0,src/transformers/models/canine/tokenization_canine.py,243,85,118,4,36,20,40,40,60,194.117300051923,2.22222222222222,709.590412651648,39.4216895917582,319.315685693242,27,65.5261306470346,0,0
transformers_4.23.0,src/transformers/models/canine/configuration_canine.py,139,28,52,0,0,0,0,0,0,0,0,0,0,0,2,100,0,0
transformers_4.23.0,src/transformers/models/hubert/__init__.py,87,37,58,1,4,4,4,5,8,8,0.5,9.28771237954945,0.51598402108608,18.5754247590989,14,80.9249967887991,0,0
transformers_4.23.0,src/transformers/models/hubert/modeling_tf_hubert.py,1694,699,1210,20,213,189,337,233,526,1733.93171100585,15.8215962441315,65447.0124119111,3635.94513399506,4136.56191208815,184,9.23547046527866,1,1
transformers_4.23.0,src/transformers/models/hubert/convert_hubert_original_pytorch_checkpoint_to_pytorch.py,249,134,196,9,61,53,98,70,151,390.304302604317,7.22950819672131,6691.06697346528,371.725942970293,925.52173555869,45,44.3583112419699,0,0
transformers_4.23.0,src/transformers/models/hubert/modeling_hubert.py,1343,613,908,19,162,190,331,181,521,1269.76632322274,19.4104938271605,75844.9461061553,4213.60811700863,3907.41970717035,169,14.7115740133561,0,0
transformers_4.23.0,src/transformers/models/hubert/convert_distilhubert_original_s3prl_checkpoint_to_pytorch.py,223,134,171,8,47,42,81,55,123,285.065676028849,6.8936170212766,4902.10100645499,272.338944803055,711.107244763533,39,46.1574368693691,0,0
transformers_4.23.0,src/transformers/models/hubert/configuration_hubert.py,257,54,104,2,7,4,9,9,13,21.6514844544032,1.28571428571429,52.9830321669644,2.94350178705358,41.2090250187501,6,71.0362989401765,0,0
transformers_4.23.0,src/transformers/models/hubert/convert_hubert_original_s3prl_checkpoint_to_pytorch.py,69,33,35,2,4,2,4,6,6,10,1,15.5097750043269,0.861654166907052,15.5097750043269,4,87.0059392706859,0,0
transformers_4.23.0,src/transformers/models/lxmert/modeling_lxmert.py,1443,707,981,16,146,152,273,162,425,1113.71438559648,14.958904109589,46663.3477580651,2592.4082087814,3119.43625122597,183,13.588880856375,0,0
transformers_4.23.0,src/transformers/models/lxmert/convert_lxmert_original_tf_checkpoint_to_pytorch.py,60,20,29,1,2,1,2,3,3,2,0.5,2.37744375108173,0.13208020839343,4.75488750216347,2,95.7932142485501,0,0
transformers_4.23.0,src/transformers/models/lxmert/__init__.py,121,52,90,1,6,6,6,7,12,15.5097750043269,0.5,16.8441295323456,0.935784974019201,33.6882590646913,20,71.599433744356,0,0
transformers_4.23.0,src/transformers/models/lxmert/modeling_tf_lxmert.py,1438,623,1038,13,101,112,197,114,309,720.585076093766,12.6782178217822,26768.320197125,1487.12889984028,2111.36301437691,158,16.5869133826826,2,1
transformers_4.23.0,src/transformers/models/lxmert/tokenization_lxmert_fast.py,55,17,25,0,0,0,0,0,0,0,0,0,0,0,1,100,0,0
transformers_4.23.0,src/transformers/models/lxmert/configuration_lxmert.py,177,41,69,0,0,0,0,0,0,0,0,0,0,0,2,100,0,0
transformers_4.23.0,src/transformers/models/lxmert/tokenization_lxmert.py,49,15,18,0,0,0,0,0,0,0,0,0,0,0,1,100,0,0
transformers_4.23.0,src/transformers/models/blenderbot_small/__init__.py,142,66,111,1,8,8,8,9,16,24,0.5,25.3594000115385,1.40885555619658,50.718800023077,26,65.5742131178831,0,0
transformers_4.23.0,src/transformers/models/blenderbot_small/modeling_flax_blenderbot_small.py,1518,592,1145,14,138,137,246,152,383,1034.27934394419,12.4782608695652,34639.1060958797,1924.39478310443,2775.95623764889,138,16.2324936441823,0,0
transformers_4.23.0,src/transformers/models/blenderbot_small/tokenization_blenderbot_small.py,238,139,154,10,40,31,56,50,87,246.096404744368,7,3437.10841957281,190.950467754045,491.015488510401,33,55.2277077377934,0,0
transformers_4.23.0,src/transformers/models/blenderbot_small/modeling_blenderbot_small.py,1586,564,1006,16,156,185,331,172,516,1200.52274614251,16.974358974359,65044.9392330308,3613.60773516837,3831.95261342628,185,16.9373755375745,0,0
transformers_4.23.0,src/transformers/models/blenderbot_small/configuration_blenderbot_small.py,395,152,266,8,32,19,35,40,54,184,4.375,1257.30551241714,69.8503062453966,287.384117123918,32,58.2643700498221,0,0
transformers_4.23.0,src/transformers/models/blenderbot_small/modeling_tf_blenderbot_small.py,1448,485,1000,14,123,141,247,137,388,907.232253065533,14.0569105691057,38713.2440562458,2150.73578090255,2754.03644818868,140,23.4013527047832,1,1
transformers_4.23.0,src/transformers/models/blenderbot_small/tokenization_blenderbot_small_fast.py,119,34,69,3,25,16,32,28,48,120.851292246532,1.92,443.045829616829,24.6136572009349,230.753036258765,6,77.9958051986385,0,0
transformers_4.23.0,src/transformers/models/gpt_neox/configuration_gpt_neox.py,122,25,44,0,0,0,0,0,0,0,0,0,0,0,2,100,0,0
transformers_4.23.0,src/transformers/models/gpt_neox/modeling_gpt_neox.py,683,322,446,13,113,104,179,126,283,818.785939088751,10.2964601769912,20331.0836199184,1129.50464555102,1974.57021835048,73,38.4184230044354,0,0
transformers_4.23.0,src/transformers/models/gpt_neox/__init__.py,78,38,49,1,4,4,4,5,8,8,0.5,9.28771237954945,0.51598402108608,18.5754247590989,14,81.8505861253324,0,0
transformers_4.23.0,src/transformers/models/gpt_neox/tokenization_gpt_neox_fast.py,142,41,59,4,6,4,7,10,11,23.5097750043269,2.33333333333333,85.262821102109,4.73682339456161,36.541209043761,8,79.3804058768473,0,0
transformers_4.23.0,src/transformers/models/electra/convert_electra_original_tf_checkpoint_to_pytorch.py,80,26,48,1,5,3,6,6,9,11.6096404744368,0.6,13.9587975038942,0.775488750216347,23.2646625064904,4,86.9434207461231,0,0
transformers_4.23.0,src/transformers/models/electra/modeling_electra.py,1675,739,1223,16,186,223,387,202,610,1466.28353886609,16.6451612903226,77758.0208487405,4319.89004715225,4671.5090044786,208,5.48605273929419,0,0
transformers_4.23.0,src/transformers/models/electra/configuration_electra.py,198,44,82,1,2,1,2,3,3,2,0.5,2.37744375108173,0.13208020839343,4.75488750216347,4,83.0029233475135,0,0
transformers_4.23.0,src/transformers/models/electra/tokenization_electra_fast.py,96,17,65,0,0,0,0,0,0,0,0,0,0,0,1,100,0,0
transformers_4.23.0,src/transformers/models/electra/__init__.py,172,66,139,1,8,8,8,9,16,24,0.5,25.3594000115385,1.40885555619658,50.718800023077,26,63.7757499963944,0,0
transformers_4.23.0,src/transformers/models/electra/modeling_flax_electra.py,1612,675,1224,14,128,124,213,142,337,949.302968908807,11.6484375,28066.4998898137,1559.24999387854,2409.46477927308,144,14.0310363447784,0,0
transformers_4.23.0,src/transformers/models/electra/modeling_tf_electra.py,1663,632,1210,13,120,140,242,133,382,876.932587808857,13.1083333333333,35328.5036794881,1962.69464886045,2695.11789036145,174,13.0515670629943,0,0
transformers_4.23.0,src/transformers/models/electra/tokenization_electra.py,532,237,303,17,137,84,172,154,256,1041.91726366685,10.6715328467153,19852.2243223282,1102.90135124046,1860.2973544179,86,42.8610046414445,0,0
transformers_4.23.0,src/transformers/models/auto/configuration_auto.py,820,176,637,11,63,37,72,74,109,414.622382985505,6.28571428571429,4254.36262022235,236.353478901242,676.830416853556,59,45.6617694422712,0,0
transformers_4.23.0,src/transformers/models/auto/auto_factory.py,655,185,524,11,76,43,80,87,123,512.896238826723,5.78947368421053,4588.05397362281,254.891887423489,792.482049989394,69,36.8045827281062,0,0
transformers_4.23.0,src/transformers/models/auto/processing_auto.py,287,93,150,7,23,18,34,30,52,123.693409443715,5.17391304347826,1320.16691328807,73.3426062937815,255.158310971643,28,65.5913725101613,0,0
transformers_4.23.0,src/transformers/models/auto/__init__.py,333,55,302,1,6,6,6,7,12,15.5097750043269,0.5,16.8441295323456,0.935784974019201,33.6882590646913,20,62.0731684115074,0,0
transformers_4.23.0,src/transformers/models/auto/modeling_flax_auto.py,346,71,258,0,0,0,0,0,0,0,0,0,0,0,1,100,0,0
transformers_4.23.0,src/transformers/models/auto/feature_extraction_auto.py,354,80,164,7,22,16,30,29,46,117.758980064424,4.77272727272727,1066.54764574846,59.2526469860257,223.467125775868,23,66.4731992224026,0,0
transformers_4.23.0,src/transformers/models/auto/tokenization_auto.py,684,151,464,9,52,47,93,61,140,324.952190356318,8.04807692307692,6682.34424245788,371.241346803215,830.303227258804,154,38.457574312143,0,0
transformers_4.23.0,src/transformers/models/auto/modeling_tf_auto.py,607,106,490,0,0,0,0,0,0,0,0,0,0,0,3,100,0,0
transformers_4.23.0,src/transformers/models/auto/modeling_auto.py,1118,159,950,0,0,0,0,0,0,0,0,0,0,0,3,100,1,1
transformers_4.23.0,src/transformers/models/van/modeling_van.py,550,264,382,13,69,60,108,82,168,469.593903853528,10.1739130434783,10866.4384524151,603.691025134169,1068.06873677584,66,41.1425410065531,0,0
transformers_4.23.0,src/transformers/models/van/__init__.py,59,23,32,1,2,2,2,3,4,2,0.5,3.16992500144231,0.176106944524573,6.33985000288463,8,92.7893572469268,0,0
transformers_4.23.0,src/transformers/models/van/convert_van_to_pytorch.py,291,143,222,8,23,14,27,31,41,128.041924989311,4.69565217391304,953.790489669265,52.9883605371814,203.122048725862,23,52.4635109412399,0,0
transformers_4.23.0,src/transformers/models/van/configuration_van.py,112,24,41,0,0,0,0,0,0,0,0,0,0,0,2,100,0,0
transformers_4.23.0,src/transformers/models/fsmt/tokenization_fsmt.py,543,269,316,13,86,59,114,99,173,600.764485240215,8.61627906976744,9881.8268976496,548.990383202755,1146.87869527377,64,45.5550682773037,0,0
transformers_4.23.0,src/transformers/models/fsmt/__init__.py,53,24,26,1,2,2,2,3,4,2,0.5,3.16992500144231,0.176106944524573,6.33985000288463,8,92.3960021243429,0,0
transformers_4.23.0,src/transformers/models/fsmt/configuration_fsmt.py,224,49,91,1,2,1,2,3,3,2,0.5,2.37744375108173,0.13208020839343,4.75488750216347,5,79.7434971709223,0,0
transformers_4.23.0,src/transformers/models/fsmt/modeling_fsmt.py,1328,518,860,19,164,157,286,183,443,1287.34915151279,16.5670731707317,55159.3250734979,3064.40694852766,3329.45502835983,151,22.6600044080745,0,0
transformers_4.23.0,src/transformers/models/fsmt/convert_fsmt_original_pytorch_checkpoint_to_pytorch.py,281,122,189,5,16,9,16,21,25,75.6096404744368,2.5,274.519838923673,15.2511021624263,109.807935569469,18,64.0690166456413,0,0
transformers_4.23.0,src/transformers/models/bert/convert_bert_pytorch_checkpoint_to_original_tf.py,113,48,61,4,7,4,7,11,11,27.6514844544032,2,76.1074956100206,4.2281942005567,38.0537478050103,6,80.2857168365976,0,0
transformers_4.23.0,src/transformers/models/bert/tokenization_bert_fast.py,304,49,195,5,32,18,37,37,55,171.609640474437,2.890625,828.221687426165,46.0123159681203,286.519935109592,10,72.896859417182,0,0
transformers_4.23.0,src/transformers/models/bert/__init__.py,201,80,168,1,10,10,10,11,20,33.2192809488736,0.5,34.594316186373,1.9219064547985,69.188632372746,32,58.7471481743484,0,0
transformers_4.23.0,src/transformers/models/bert/convert_bert_token_dropping_original_tf2_checkpoint_to_pytorch.py,187,90,117,2,10,5,10,12,15,35.2192809488736,1,53.7744375108174,2.98746875060096,53.7744375108174,3,69.6671183359326,0,0
transformers_4.23.0,src/transformers/models/bert/modeling_tf_bert.py,2033,749,1471,12,157,183,320,169,503,1188.27500758464,12.2292993630573,45525.3077986235,2529.18376659019,3722.64235644994,209,6.36061739721066,1,1
transformers_4.23.0,src/transformers/models/bert/convert_bert_original_tf_checkpoint_to_pytorch.py,63,20,32,1,2,1,2,3,3,2,0.5,2.37744375108173,0.13208020839343,4.75488750216347,2,95.8446982931609,0,0
transformers_4.23.0,src/transformers/models/bert/tokenization_bert_tf.py,222,101,137,11,30,29,54,41,83,185.260465673266,9.9,4402.30048219468,244.572249010816,444.676816383301,37,61.8194631498379,0,0
transformers_4.23.0,src/transformers/models/bert/modeling_bert.py,1889,816,1355,16,199,241,417,215,658,1583.68829948819,16.7638190954774,85467.1615367821,4748.17564093234,5098.31089502987,229,2.28037202120005,0,0
transformers_4.23.0,src/transformers/models/bert/convert_bert_original_tf2_checkpoint_to_pytorch.py,245,157,175,11,43,40,79,54,119,271.3831322572,10.1046511627907,6919.98455216542,384.443586231412,684.831612757453,40,53.3024578363243,0,0
transformers_4.23.0,src/transformers/models/bert/modeling_flax_bert.py,1719,690,1330,14,123,126,214,137,340,907.232253065533,12.1788617886179,29391.6235812476,1632.86797673598,2413.33090820658,143,11.6307869880174,0,0
transformers_4.23.0,src/transformers/models/bert/tokenization_bert.py,574,238,349,17,137,84,172,154,256,1041.91726366685,10.6715328467153,19852.2243223282,1102.90135124046,1860.2973544179,86,42.2794535469431,0,0
transformers_4.23.0,src/transformers/models/bert/configuration_bert.py,191,39,101,1,2,1,2,3,3,2,0.5,2.37744375108173,0.13208020839343,4.75488750216347,4,88.7873835052775,0,0
transformers_4.23.0,src/transformers/models/xlm/modeling_tf_xlm.py,1309,505,950,18,123,133,240,141,373,928.987934182688,17.5609756097561,46765.8027122005,2598.10015067781,2663.05265444475,137,21.5131110470186,0,0
transformers_4.23.0,src/transformers/models/xlm/configuration_xlm.py,250,60,111,2,4,2,4,6,6,10,1,15.5097750043269,0.861654166907052,15.5097750043269,5,77.5790936944873,0,0
transformers_4.23.0,src/transformers/models/xlm/__init__.py,109,38,80,1,4,4,4,5,8,8,0.5,9.28771237954945,0.51598402108608,18.5754247590989,14,78.1511852960578,0,0
transformers_4.23.0,src/transformers/models/xlm/convert_xlm_original_pytorch_checkpoint_to_pytorch.py,78,38,41,7,26,17,32,33,49,141.862917126072,4.30769230769231,1064.75518950151,59.1530660834171,247.175311848564,9,76.241564220622,0,0
transformers_4.23.0,src/transformers/models/xlm/modeling_xlm.py,1279,542,910,19,172,195,346,191,541,1358.02816056419,19.1104651162791,78341.2304054921,4352.2905780829,4099.38899596734,152,19.2262464101397,0,0
transformers_4.23.0,src/transformers/models/xlm/tokenization_xlm.py,999,322,754,13,112,76,148,125,224,810.529467606286,8.58928571428571,13402.1689636899,744.564942427214,1560.33567976431,75,36.5029536036439,0,0
transformers_4.23.0,src/transformers/models/vilt/processing_vilt.py,108,24,55,0,0,0,0,0,0,0,0,0,0,0,5,100,0,0
transformers_4.23.0,src/transformers/models/vilt/__init__.py,88,39,58,1,4,4,4,5,8,8,0.5,9.28771237954945,0.51598402108608,18.5754247590989,14,80.8660629831483,0,0
transformers_4.23.0,src/transformers/models/vilt/feature_extraction_vilt.py,292,105,134,11,38,28,54,49,82,237.474993315867,7.81578947368421,3598.43798798899,199.913221554944,460.406207217447,35,60.5057499831076,0,0
transformers_4.23.0,src/transformers/models/vilt/convert_vilt_original_to_pytorch.py,300,163,231,5,27,25,39,32,64,139.991603032851,3.61111111111111,1155.55555555556,64.1975308641975,320,34,51.6234439168956,0,0
transformers_4.23.0,src/transformers/models/vilt/modeling_vilt.py,1489,604,966,16,142,168,298,158,466,1079.26409096966,16.7887323943662,57141.4887288934,3174.52715160519,3403.56182865053,163,18.1331979005829,0,0
transformers_4.23.0,src/transformers/models/vilt/configuration_vilt.py,148,30,53,0,0,0,0,0,0,0,0,0,0,0,2,100,0,0
transformers_4.23.0,src/transformers/models/bartpho/tokenization_bartpho.py,329,118,150,8,75,46,88,83,134,491.161401787191,4.69333333333333,4009.30479863696,222.739155479831,854.255283800488,39,57.6185678021348,0,0
transformers_4.23.0,src/transformers/models/bartpho/__init__.py,46,21,21,1,2,2,2,3,4,2,0.5,3.16992500144231,0.176106944524573,6.33985000288463,8,92.8814536032276,0,0
transformers_4.23.0,src/transformers/models/layoutxlm/__init__.py,71,37,43,1,4,4,4,5,8,8,0.5,9.28771237954945,0.51598402108608,18.5754247590989,14,82.8971939290087,0,0
transformers_4.23.0,src/transformers/models/layoutxlm/tokenization_layoutxlm_fast.py,802,228,546,15,158,117,227,173,344,1212.60071714611,10.7753164556962,27558.0023278337,1531.00012932409,2557.51211030703,96,38.2617827233763,0,0
transformers_4.23.0,src/transformers/models/layoutxlm/tokenization_layoutxlm.py,1176,378,787,18,253,195,363,271,558,2094.75602442362,12.9130434782609,58235.7492185831,3235.3194010324,4509.83916507546,131,27.5718490511829,0,0
transformers_4.23.0,src/transformers/models/layoutxlm/processing_layoutxlm.py,160,41,86,4,18,15,31,22,46,83.0586500259616,3.44444444444444,706.572165352976,39.2540091862765,205.133854457316,21,74.9363533286251,0,0
transformers_4.23.0,src/transformers/models/markuplm/configuration_markuplm.py,162,32,66,0,0,0,0,0,0,0,0,0,0,0,2,100,0,0
transformers_4.23.0,src/transformers/models/markuplm/tokenization_markuplm_fast.py,924,304,651,17,191,139,272,208,411,1516.77577445608,12.1047120418848,38309.9698128201,2128.33165626779,3164.88072415599,106,33.3831429676959,0,0
transformers_4.23.0,src/transformers/models/markuplm/__init__.py,88,40,58,1,4,4,4,5,8,8,0.5,9.28771237954945,0.51598402108608,18.5754247590989,14,80.6262100654024,0,0
transformers_4.23.0,src/transformers/models/markuplm/feature_extraction_markuplm.py,183,80,81,7,26,15,27,33,42,141.862917126072,3.63461538461538,770.046163835912,42.7803424353284,211.864553013055,29,66.8800542570222,0,0
transformers_4.23.0,src/transformers/models/markuplm/modeling_markuplm.py,1300,567,887,14,179,188,330,193,518,1392.90599303911,12.9050279329609,50754.0907354986,2819.6717075277,3932.89274530487,159,17.0982917290571,0,0
transformers_4.23.0,src/transformers/models/markuplm/processing_markuplm.py,140,36,75,4,13,13,27,17,40,56.1057163358342,4.15384615384615,679.147672084672,37.7304262269262,163.498513650014,17,77.2910758081487,0,0
transformers_4.23.0,src/transformers/models/markuplm/tokenization_markuplm.py,1461,519,1077,19,337,255,484,356,739,2910.36643401371,13.6439169139466,85459.5878077632,4747.75487820907,6263.56700548417,175,15.5939582008742,0,0
transformers_4.23.0,src/transformers/models/layoutlmv2/tokenization_layoutlmv2_fast.py,819,235,577,15,152,110,216,167,326,1160.28834097755,10.6578947368421,25654.4862561934,1425.24923645519,2407.08759934654,93,38.5116224893504,0,0
transformers_4.23.0,src/transformers/models/layoutlmv2/tokenization_layoutlmv2.py,1554,534,1131,19,333,239,466,352,705,2871.04361899016,13.2942942942943,79285.8323179389,4404.76846210772,5963.89929113929,199,11.890900627029,1,1
transformers_4.23.0,src/transformers/models/layoutlmv2/__init__.py,107,53,78,1,6,6,6,7,12,15.5097750043269,0.5,16.8441295323456,0.935784974019201,33.6882590646913,20,72.5875669870635,0,0
transformers_4.23.0,src/transformers/models/layoutlmv2/processing_layoutlmv2.py,160,41,86,4,18,15,31,22,46,83.0586500259616,3.44444444444444,706.572165352976,39.2540091862765,205.133854457316,21,74.9363533286251,0,0
transformers_4.23.0,src/transformers/models/layoutlmv2/configuration_layoutlmv2.py,223,40,114,2,3,3,4,5,7,6.75488750216347,1.33333333333333,21.6713288856154,1.20396271586752,16.2534966642115,8,83.5946739141859,0,0
transformers_4.23.0,src/transformers/models/layoutlmv2/feature_extraction_layoutlmv2.py,238,77,96,10,38,27,51,48,78,232.64052645973,6.71052631578947,2923.28695103536,162.404830613076,435.62707505625,37,61.3335650366557,0,0
transformers_4.23.0,src/transformers/models/layoutlmv2/modeling_layoutlmv2.py,1426,640,1000,17,217,207,361,234,568,1753.74348574171,14.1405529953917,63213.4637450676,3511.8590969482,4470.36716072337,151,16.3376570714472,0,0
transformers_4.23.0,src/transformers/models/camembert/__init__.py,146,65,113,1,8,8,8,9,16,24,0.5,25.3594000115385,1.40885555619658,50.718800023077,26,65.5739506771058,0,0
transformers_4.23.0,src/transformers/models/camembert/modeling_camembert.py,1583,671,1114,15,173,211,365,188,576,1344.79404231528,15.8236994219653,68855.9289093948,3825.32938385527,4351.44317856632,193,10.433608876661,0,0
transformers_4.23.0,src/transformers/models/camembert/tokenization_camembert.py,298,102,128,9,72,43,83,81,126,472.763925116827,5.1875,4143.88445813546,230.215803229748,798.821100363463,31,59.1582041288645,0,0
transformers_4.23.0,src/transformers/models/camembert/configuration_camembert.py,61,22,30,1,2,1,2,3,3,2,0.5,2.37744375108173,0.13208020839343,4.75488750216347,3,94.5973913310286,0,0
transformers_4.23.0,src/transformers/models/camembert/tokenization_camembert_fast.py,211,55,91,5,35,24,45,40,69,191.134546067511,3.21428571428571,1180.3276239018,65.5737568834336,367.213038547228,14,69.5602751183308,0,0
transformers_4.23.0,src/transformers/models/camembert/modeling_tf_camembert.py,1736,654,1247,12,133,160,277,145,437,981.372113930312,12.4962406015038,39208.457839273,2178.24765773739,3137.62027233653,184,12.1042294950996,0,0
transformers_4.23.0,src/transformers/models/perceiver/convert_perceiver_haiku_to_pytorch.py,468,287,363,11,97,99,185,108,284,678.245293497162,10.4896907216495,20123.2973350534,1117.96096305852,1918.38805061443,74,35.3993637229935,0,0
transformers_4.23.0,src/transformers/models/perceiver/configuration_perceiver.py,241,72,122,3,10,5,10,13,15,37.9741684510371,1.5,83.2598936581746,4.62554964767637,55.5065957721164,9,74.1091628421535,0,0
transformers_4.23.0,src/transformers/models/perceiver/__init__.py,98,38,70,1,4,4,4,5,8,8,0.5,9.28771237954945,0.51598402108608,18.5754247590989,14,79.2260068991627,0,0
transformers_4.23.0,src/transformers/models/perceiver/modeling_perceiver.py,3423,1237,2087,18,330,374,679,348,1053,2835.94498072708,18.5181818181818,164634.404761811,9146.3558201006,8890.41950112871,361,0,1,1
transformers_4.23.0,src/transformers/models/perceiver/tokenization_perceiver.py,215,88,110,7,56,32,64,63,96,344.863360089629,4,2295.27549062397,127.515305034665,573.818872655992,33,63.0501896489161,0,0
transformers_4.23.0,src/transformers/models/perceiver/feature_extraction_perceiver.py,189,57,79,11,42,25,49,53,74,264.531079561718,6.41666666666667,2719.80756250843,151.100420139357,423.866113637677,26,66.3255637500882,0,0
transformers_4.23.0,src/transformers/models/videomae/__init__.py,77,37,50,1,4,4,4,5,8,8,0.5,9.28771237954945,0.51598402108608,18.5754247590989,14,81.9700739406769,0,0
transformers_4.23.0,src/transformers/models/videomae/modeling_videomae.py,1036,448,616,17,144,138,252,161,390,1101.95606850895,14.875,42528.4815391624,2362.69341884236,2859.0575824647,107,31.1292943863678,0,0
transformers_4.23.0,src/transformers/models/videomae/convert_videomae_to_pytorch.py,288,205,228,7,75,72,135,82,207,486.812886241594,6.3,8290.88356922244,460.60464273458,1316.01326495594,65,37.5125656463838,0,0
transformers_4.23.0,src/transformers/models/videomae/feature_extraction_videomae.py,169,57,70,6,23,15,26,29,41,119.551699993638,3.39130434782609,675.470574887738,37.5261430493188,199.17722080023,29,68.1371647801706,0,0
transformers_4.23.0,src/transformers/models/videomae/configuration_videomae.py,148,32,55,0,0,0,0,0,0,0,0,0,0,0,2,100,0,0
transformers_4.23.0,src/transformers/models/layoutlmv3/tokenization_layoutlmv3.py,1478,461,1049,19,296,222,426,315,648,2510.7088189816,13.6722972972973,73528.0671049589,4084.89261694216,5377.88679591496,167,19.3036870567882,0,0
transformers_4.23.0,src/transformers/models/layoutlmv3/modeling_layoutlmv3.py,1397,589,983,16,185,189,336,201,525,1457.30557019552,14.5297297297297,58363.0494410363,3242.39163561312,4016.80213786894,146,17.269526176133,0,0
transformers_4.23.0,src/transformers/models/layoutlmv3/configuration_layoutlmv3.py,294,61,142,2,7,4,8,9,12,21.6514844544032,1.14285714285714,43.4732571626374,2.41518095347986,38.0391000173078,8,76.68711129794,0,0
transformers_4.23.0,src/transformers/models/layoutlmv3/__init__.py,146,67,113,1,8,8,8,9,16,24,0.5,25.3594000115385,1.40885555619658,50.718800023077,26,65.2868473660974,0,0
transformers_4.23.0,src/transformers/models/layoutlmv3/feature_extraction_layoutlmv3.py,247,79,102,9,40,28,54,49,82,241.406448808475,6.075,2796.96770884599,155.387094935888,460.406207217447,39,60.7737885845327,0,0
transformers_4.23.0,src/transformers/models/layoutlmv3/modeling_tf_layoutlmv3.py,1634,609,1177,17,162,160,294,179,454,1258.54256876857,15.4259259259259,52411.9336718028,2911.77409287793,3397.65236287797,154,16.7568887394131,1,1
transformers_4.23.0,src/transformers/models/layoutlmv3/tokenization_layoutlmv3_fast.py,853,250,594,15,156,114,224,171,338,1195.12610507664,10.7692307692308,27000.9831541847,1500.05461967693,2507.23415003143,98,37.2849905194919,0,0
transformers_4.23.0,src/transformers/models/layoutlmv3/processing_layoutlmv3.py,158,39,84,4,14,12,25,18,37,61.3029689088065,3.57142857142857,551.02580376202,30.6125446534455,154.287225053366,19,76.4401082088454,0,0
transformers_4.23.0,src/transformers/models/wav2vec2/convert_wav2vec2_original_pytorch_checkpoint_to_pytorch.py,270,143,215,10,58,51,94,68,145,372.982178666273,8.10344827586207,7152.76883846915,397.376046581619,882.682111981299,43,44.2126291623201,0,0
transformers_4.23.0,src/transformers/models/wav2vec2/tokenization_wav2vec2.py,927,316,481,14,85,57,107,99,164,598.101198480511,8.81176470588235,9580.2782327541,532.23767959745,1087.21448569306,115,37.9798907112528,0,0
transformers_4.23.0,src/transformers/models/wav2vec2/modeling_tf_wav2vec2.py,1732,714,1235,20,213,189,337,233,526,1733.93171100585,15.8215962441315,65447.0124119111,3635.94513399506,4136.56191208815,184,8.95319516202021,1,1
transformers_4.23.0,src/transformers/models/wav2vec2/__init__.py,136,54,104,1,6,6,6,7,12,15.5097750043269,0.5,16.8441295323456,0.935784974019201,33.6882590646913,20,70.0572117457013,0,0
transformers_4.23.0,src/transformers/models/wav2vec2/convert_wav2vec2_original_s3prl_checkpoint_to_pytorch.py,110,59,70,1,2,1,2,3,3,2,0.5,2.37744375108173,0.13208020839343,4.75488750216347,7,80.6205714250733,0,0
transformers_4.23.0,src/transformers/models/wav2vec2/feature_extraction_wav2vec2.py,237,59,100,11,37,23,43,48,66,230.803522333281,6.39189189189189,2356.09945064207,130.894413924559,368.607525047596,26,65.9722241962226,0,0
transformers_4.23.0,src/transformers/models/wav2vec2/modeling_flax_wav2vec2.py,1428,608,994,18,136,146,260,154,406,1038.95359643601,17.2058823529412,50762.778567072,2820.15436483733,2950.31533552213,134,17.3506592962981,0,0
transformers_4.23.0,src/transformers/models/wav2vec2/modeling_wav2vec2.py,2167,984,1442,19,260,312,536,279,848,2166.52625414283,19.5846153846154,134923.406963152,7495.7448312862,6889.25487243115,248,0,0,0
transformers_4.23.0,src/transformers/models/wav2vec2/processing_wav2vec2.py,163,86,88,5,14,14,28,19,42,64.9126093832433,5,892.064777823153,49.5591543235085,178.412955564631,24,68.0080186255648,0,0
transformers_4.23.0,src/transformers/models/wav2vec2/configuration_wav2vec2.py,338,70,136,2,9,5,11,11,16,30.5293250129808,1.22222222222222,67.6511072089072,3.75839484493929,55.3509058981968,7,66.9811696585913,0,0
transformers_4.23.0,src/transformers/models/tapas/convert_tapas_original_tf_checkpoint_to_pytorch.py,138,58,92,3,12,9,17,15,26,47.7744375108174,2.125,215.855705407371,11.9919836337428,101.579155485821,8,73.0111319921164,0,0
transformers_4.23.0,src/transformers/models/tapas/__init__.py,99,38,70,1,4,4,4,5,8,8,0.5,9.28771237954945,0.51598402108608,18.5754247590989,14,79.2260068991627,0,0
transformers_4.23.0,src/transformers/models/tapas/tokenization_tapas.py,2828,1210,1863,21,579,396,771,600,1167,5405.96457837412,13.9818652849741,150585.128314849,8365.84046193603,10770.0314118087,439,0,0,0
transformers_4.23.0,src/transformers/models/tapas/modeling_tapas.py,2437,911,1382,21,326,286,519,347,805,2813.92404415768,16.7162576687117,113557.34031136,6308.74112840888,6793.2274413255,221,7.99155626946832,0,0
transformers_4.23.0,src/transformers/models/tapas/modeling_tf_tapas.py,2329,794,1362,16,242,218,392,258,610,1980.36490342045,12.9586776859504,63327.096241878,3518.17201343766,4886.84862580818,177,15.7553969762841,1,1
transformers_4.23.0,src/transformers/models/tapas/configuration_tapas.py,244,48,97,0,0,0,0,0,0,0,0,0,0,0,4,100,0,0
transformers_4.23.0,src/transformers/models/mpnet/configuration_mpnet.py,116,23,40,0,0,0,0,0,0,0,0,0,0,0,2,100,0,0
transformers_4.23.0,src/transformers/models/mpnet/__init__.py,134,52,103,1,6,6,6,7,12,15.5097750043269,0.5,16.8441295323456,0.935784974019201,33.6882590646913,20,70.493707269414,0,0
transformers_4.23.0,src/transformers/models/mpnet/modeling_mpnet.py,1074,501,801,16,128,153,266,144,419,960,16.625,49944.801319422,2774.71118441233,3004.19857560433,123,18.5728038529256,0,0
transformers_4.23.0,src/transformers/models/mpnet/tokenization_mpnet_fast.py,216,62,98,5,33,20,40,38,60,178.074646413266,3.03030303030303,954.168638807925,53.0093688226625,314.875650806615,14,69.3448456943972,0,0
transformers_4.23.0,src/transformers/models/mpnet/tokenization_mpnet.py,532,246,290,17,137,85,174,154,259,1041.91726366685,10.7956204379562,20318.4125479207,1128.8006971067,1882.09771403998,93,41.6314487412744,0,0
transformers_4.23.0,src/transformers/models/mpnet/modeling_tf_mpnet.py,1265,514,930,13,95,112,197,108,309,672.241999127274,13.4789473684211,28134.0708944714,1563.00393858174,2087.26023816851,123,20.6822926768545,1,1
transformers_4.23.0,src/transformers/models/led/modeling_tf_led.py,2555,842,1689,16,262,292,521,278,813,2168.75682640281,15.9083969465649,105006.541282342,5833.69673790791,6600.69909212421,177,11.9185046871024,1,1
transformers_4.23.0,src/transformers/models/led/__init__.py,105,52,74,1,6,6,6,7,12,15.5097750043269,0.5,16.8441295323456,0.935784974019201,33.6882590646913,20,73.1931478604875,0,0
transformers_4.23.0,src/transformers/models/led/tokenization_led_fast.py,335,103,163,10,65,41,78,75,119,424.673188795723,6,4447.37654501406,247.076474723003,741.22942416901,32,60.6497797911897,0,0
transformers_4.23.0,src/transformers/models/led/tokenization_led.py,464,193,245,15,128,83,161,143,244,954.603358934128,9.43359375,16480.5694683986,915.587192688809,1747.00860617393,63,48.2018096824062,0,0
transformers_4.23.0,src/transformers/models/led/modeling_led.py,2771,1002,1743,18,326,388,690,344,1078,2796.74402830529,19.0490797546012,173032.571314671,9612.92062859281,9083.51340556886,256,0,0,0
transformers_4.23.0,src/transformers/models/led/configuration_led.py,166,35,74,0,0,0,0,0,0,0,0,0,0,0,2,100,0,0
transformers_4.23.0,src/transformers/models/megatron_gpt2/checkpoint_reshaping_and_interoperability.py,900,400,626,17,140,112,220,157,332,1067.58649067355,13.3571428571429,32348.5167552991,1797.13981973884,2421.81408863202,102,31.2461659363166,0,0
transformers_4.23.0,src/transformers/models/megatron_gpt2/__init__.py,17,0,0,0,0,0,0,0,0,0,0,0,0,0,1,100,0,0
transformers_4.23.0,src/transformers/models/megatron_gpt2/convert_megatron_gpt2_checkpoint.py,364,156,196,13,72,52,103,85,155,492.340316439681,9.29861111111111,9237.75723500486,513.208735278048,993.455595101344,35,55.5850554631313,0,0
transformers_4.23.0,src/transformers/models/dialogpt/__init__.py,0,0,0,0,0,0,0,0,0,0,0,0,0,0,1,100,0,0
transformers_4.23.0,src/transformers/models/dialogpt/convert_dialogpt_original_pytorch_checkpoint_to_pytorch.py,46,20,23,1,2,1,2,3,3,2,0.5,2.37744375108173,0.13208020839343,4.75488750216347,3,95.7118246627005,0,0
transformers_4.23.0,src/transformers/models/bert_generation/configuration_bert_generation.py,117,20,37,0,0,0,0,0,0,0,0,0,0,0,2,100,0,0
transformers_4.23.0,src/transformers/models/bert_generation/__init__.py,75,37,46,1,4,4,4,5,8,8,0.5,9.28771237954945,0.51598402108608,18.5754247590989,14,82.5026769126246,0,0
transformers_4.23.0,src/transformers/models/bert_generation/tokenization_bert_generation.py,172,72,87,5,13,8,13,18,21,59.715356810271,2.5,218.921062575721,12.1622812542067,87.5684250302886,19,72.5080321631986,0,0
transformers_4.23.0,src/transformers/models/bert_generation/modeling_bert_generation.py,992,476,693,14,141,141,251,155,392,1059.97970959704,12.4609929078014,35541.751967278,1974.54177595989,2852.2407668675,143,21.9104618924893,0,0
transformers_4.23.0,src/transformers/models/bertweet/__init__.py,33,9,8,0,0,0,0,0,0,0,0,0,0,0,2,100,0,0
transformers_4.23.0,src/transformers/models/bertweet/tokenization_bertweet.py,771,276,411,17,109,73,137,126,210,807.218959701941,10.6834862385321,15653.7515494705,869.652863859474,1465.22878393498,64,45.2179583856523,1,1
transformers_4.23.0,src/transformers/models/swinv2/configuration_swinv2.py,147,34,58,3,6,3,6,9,9,20.2646625064904,1.5,42.7939875194712,2.37744375108173,28.5293250129808,2,77.7682721665533,0,0
transformers_4.23.0,src/transformers/models/swinv2/__init__.py,65,23,36,1,2,2,2,3,4,2,0.5,3.16992500144231,0.176106944524573,6.33985000288463,8,92.5279837529009,0,0
transformers_4.23.0,src/transformers/models/swinv2/modeling_swinv2.py,1300,620,842,19,265,241,437,284,678,2213.92048835983,15.6660377358491,86563.1387281919,4809.06326267733,5525.52854702418,135,20.9556563405225,0,0
transformers_4.23.0,src/transformers/models/swinv2/convert_swinv2_timm_to_pytorch.py,219,159,168,7,40,37,70,47,107,232.528608249898,6.125,3640.33866866823,202.241037148235,594.341007129507,35,44.816509397374,0,0
transformers_4.23.0,src/transformers/models/swin/modeling_tf_swin.py,1491,688,1000,20,249,236,427,269,663,2068.4790429827,17.14859437751,91768.6372008893,5098.25762227163,5351.37954637504,147,17.3178321477771,0,0
transformers_4.23.0,src/transformers/models/swin/__init__.py,89,37,60,1,4,4,4,5,8,8,0.5,9.28771237954945,0.51598402108608,18.5754247590989,14,81.1208193000924,0,0
transformers_4.23.0,src/transformers/models/swin/modeling_swin.py,1217,597,774,18,235,219,398,253,617,1926.04013246874,15.2425531914894,75077.3029849806,4170.96127694337,4925.50703558639,127,22.6293690633905,0,0
transformers_4.23.0,src/transformers/models/swin/configuration_swin.py,170,46,74,3,6,3,6,9,9,20.2646625064904,1.5,42.7939875194712,2.37744375108173,28.5293250129808,4,78.8378466924435,0,0
transformers_4.23.0,src/transformers/models/swin/convert_swin_timm_to_pytorch.py,173,129,140,5,30,27,51,35,78,158.816358342692,4.25,1700.35732011726,94.4642955620698,400.084075321707,25,37.4712129739398,0,0
transformers_4.23.0,src/transformers/models/codegen/tokenization_codegen.py,387,194,230,15,71,49,94,86,143,495.23540441896,9.92957746478873,9124.84339782101,506.93574432339,918.9558599224,61,49.10494635334,0,0
transformers_4.23.0,src/transformers/models/codegen/configuration_codegen.py,236,79,137,3,6,4,6,9,10,20.2646625064904,1.5,47.5488750216347,2.64160416786859,31.6992500144231,14,75.3047021709593,0,0
transformers_4.23.0,src/transformers/models/codegen/tokenization_codegen_fast.py,254,77,128,7,22,14,24,29,38,117.758980064424,3.81818181818182,704.848878929419,39.1582710516344,184.603277814848,23,69.1226937581492,0,0
transformers_4.23.0,src/transformers/models/codegen/__init__.py,77,38,50,1,4,4,4,5,8,8,0.5,9.28771237954945,0.51598402108608,18.5754247590989,14,81.7174273893722,0,0
transformers_4.23.0,src/transformers/models/codegen/modeling_codegen.py,746,364,533,14,133,137,224,147,361,991.655532830465,11.7894736842105,30641.8054996236,1702.32252775686,2599.08171648593,87,30.3309763113237,0,0
transformers_4.23.0,src/transformers/models/encoder_decoder/configuration_encoder_decoder.py,119,33,34,2,5,3,6,7,9,13.6096404744368,1.2,30.3194331582221,1.68441295323456,25.2661942985184,5,67.4715667454349,0,0
transformers_4.23.0,src/transformers/models/encoder_decoder/modeling_tf_encoder_decoder.py,712,223,450,11,79,70,132,90,202,536.052426911001,9.18987341772152,12051.1802567461,669.510014263671,1311.35432545859,89,41.6813462313836,1,1
transformers_4.23.0,src/transformers/models/encoder_decoder/__init__.py,86,51,56,1,6,6,6,7,12,15.5097750043269,0.5,16.8441295323456,0.935784974019201,33.6882590646913,20,75.5240248376099,0,0
transformers_4.23.0,src/transformers/models/encoder_decoder/modeling_encoder_decoder.py,583,169,369,11,68,59,111,79,170,452.001221010033,8.97794117647059,9621.1453669053,534.508075939184,1071.64272719011,68,47.6256636251434,1,1
transformers_4.23.0,src/transformers/models/encoder_decoder/modeling_flax_encoder_decoder.py,903,262,608,11,87,73,136,98,209,598.58983194385,8.59770114942529,11886.1013718416,660.338965102311,1382.47435742008,77,39.8504349036298,1,1
transformers_4.23.0,src/transformers/models/byt5/tokenization_byt5.py,250,103,124,12,76,46,91,88,137,517.862041030366,7.18421052631579,6357.61057812246,353.20058767347,884.94213175331,39,59.261352934484,0,0
transformers_4.23.0,src/transformers/models/byt5/__init__.py,32,9,8,0,0,0,0,0,0,0,0,0,0,0,2,100,0,0
transformers_4.23.0,src/transformers/models/byt5/convert_byt5_original_tf_checkpoint_to_pytorch.py,60,19,30,1,2,1,2,3,3,2,0.5,2.37744375108173,0.13208020839343,4.75488750216347,2,96.3176030216455,0,0
transformers_4.23.0,src/transformers/models/bert_japanese/tokenization_bert_japanese.py,532,218,336,8,56,45,88,64,133,349.211875635226,6.28571428571429,5016,278.666666666667,798,78,44.9002244844004,1,1
transformers_4.23.0,src/transformers/models/bert_japanese/__init__.py,33,9,8,0,0,0,0,0,0,0,0,0,0,0,2,100,0,0
transformers_4.23.0,src/transformers/models/sew_d/configuration_sew_d.py,288,61,118,2,7,4,9,9,13,21.6514844544032,1.28571428571429,52.9830321669644,2.94350178705358,41.2090250187501,6,70.1818261834333,0,0
transformers_4.23.0,src/transformers/models/sew_d/__init__.py,60,23,34,1,2,2,2,3,4,2,0.5,3.16992500144231,0.176106944524573,6.33985000288463,8,92.5173434722518,0,0
transformers_4.23.0,src/transformers/models/sew_d/convert_sew_d_original_pytorch_checkpoint_to_pytorch.py,317,189,254,10,66,55,103,76,158,432.149292826532,7.8030303030303,7702.93729952886,427.940961084937,987.172547124087,52,39.4535058664043,0,0
transformers_4.23.0,src/transformers/models/sew_d/modeling_sew_d.py,1754,868,1210,21,292,324,552,313,876,2483.66743707132,19.8493150684932,144146.847710464,8008.15820613691,7262.05650991297,234,0.531882605444799,0,0
transformers_4.23.0,src/transformers/models/speech_to_text_2/modeling_speech_to_text_2.py,965,367,539,16,132,134,239,148,373,993.860023755316,14.4848484848485,38951.5841930742,2163.97689961523,2689.1261053796,116,33.380156007441,0,0
transformers_4.23.0,src/transformers/models/speech_to_text_2/tokenization_speech_to_text_2.py,270,143,175,11,47,34,64,58,98,299.119423833859,7.48936170212766,4299.50877463661,238.861598590923,574.082137522502,38,53.5778675747896,0,0
transformers_4.23.0,src/transformers/models/speech_to_text_2/configuration_speech_to_text_2.py,145,31,61,0,0,0,0,0,0,0,0,0,0,0,2,100,0,0
transformers_4.23.0,src/transformers/models/speech_to_text_2/__init__.py,69,25,42,1,2,2,2,3,4,2,0.5,3.16992500144231,0.176106944524573,6.33985000288463,8,90.8162406167882,0,0
transformers_4.23.0,src/transformers/models/speech_to_text_2/processing_speech_to_text_2.py,113,54,51,5,9,9,18,14,27,40.1389654874176,5,513.992914477776,28.555161915432,102.798582895555,15,72.5661259055867,0,0
transformers_4.23.0,src/transformers/models/glpn/__init__.py,78,37,48,1,4,4,4,5,8,8,0.5,9.28771237954945,0.51598402108608,18.5754247590989,14,82.6117773080451,0,0
transformers_4.23.0,src/transformers/models/glpn/feature_extraction_glpn.py,139,45,51,7,23,14,26,30,40,123.693409443715,3.95652173913043,776.568772522392,43.1427095845773,196.275623824341,20,69.3168300757675,0,0
transformers_4.23.0,src/transformers/models/glpn/configuration_glpn.py,137,29,51,0,0,0,0,0,0,0,0,0,0,0,2,100,0,0
transformers_4.23.0,src/transformers/models/glpn/modeling_glpn.py,782,362,500,13,97,79,143,110,222,688.297262027986,9.58247422680412,14426.0494384134,801.447191022967,1505.46185640247,86,35.70700005388,0,0
transformers_4.23.0,src/transformers/models/glpn/convert_glpn_to_pytorch.py,219,126,151,6,46,36,72,52,108,269.593624982949,4.69565217391304,2890.86647271294,160.603692928497,615.647489559238,36,54.3758055078745,0,0
transformers_4.23.0,src/transformers/models/cpm/__init__.py,63,35,35,1,4,4,4,5,8,8,0.5,9.28771237954945,0.51598402108608,18.5754247590989,14,84.368768912279,0,0
transformers_4.23.0,src/transformers/models/cpm/tokenization_cpm.py,115,27,29,0,0,0,0,0,0,0,0,0,0,0,6,100,0,0
transformers_4.23.0,src/transformers/models/cpm/tokenization_cpm_fast.py,120,26,34,0,0,0,0,0,0,0,0,0,0,0,7,100,0,0
transformers_4.23.0,src/transformers/models/owlvit/__init__.py,102,38,74,1,4,4,4,5,8,8,0.5,9.28771237954945,0.51598402108608,18.5754247590989,14,78.7819572493297,1,1
transformers_4.23.0,src/transformers/models/owlvit/convert_owlvit_original_flax_to_hf.py,407,214,268,9,75,48,98,84,146,495.690726800172,5.88,5487.67666110711,304.870925617062,933.278343725699,43,44.5341219938714,0,0
transformers_4.23.0,src/transformers/models/owlvit/modeling_owlvit.py,1410,557,880,15,177,175,302,192,477,1380.36954129882,12.7966101694915,46298.4825457155,2572.13791920642,3618.02711284399,118,26.6904237345923,2,1
transformers_4.23.0,src/transformers/models/owlvit/configuration_owlvit.py,390,121,189,5,20,13,29,25,42,98.0482023721841,3.625,707.027104893202,39.2792836051779,195.041959970538,28,63.5632020963689,1,1
transformers_4.23.0,src/transformers/models/owlvit/processing_owlvit.py,161,67,61,10,32,24,47,42,71,193.219280948874,7.34375,2811.58800622074,156.19933367893,382.854537017292,36,60.2525243365158,0,0
transformers_4.23.0,src/transformers/models/owlvit/feature_extraction_owlvit.py,219,72,91,10,41,28,52,51,80,252.878913138215,6.34146341463415,2877.71822226847,159.87323457047,453.79402735772,29,62.9375574719876,0,0
transformers_4.23.0,src/transformers/models/m2m_100/__init__.py,64,24,36,1,2,2,2,3,4,2,0.5,3.16992500144231,0.176106944524573,6.33985000288463,8,91.9167547932775,0,0
transformers_4.23.0,src/transformers/models/m2m_100/configuration_m2m_100.py,283,94,166,7,17,10,18,24,28,89.138352755659,3.70588235294118,475.757285368948,26.4309602982749,128.378950020192,15,69.3603662307726,0,0
transformers_4.23.0,src/transformers/models/m2m_100/tokenization_m2m_100.py,387,166,218,11,66,41,79,77,120,436.983759682668,6.58333333333333,4950.76136714897,275.042298174943,752.014384883388,46,53.7955327611315,0,0
transformers_4.23.0,src/transformers/models/m2m_100/convert_m2m100_original_checkpoint_to_pytorch.py,85,32,57,2,4,2,4,6,6,10,1,15.5097750043269,0.861654166907052,15.5097750043269,4,83.312669325401,0,0
transformers_4.23.0,src/transformers/models/m2m_100/modeling_m2m_100.py,1387,520,915,17,179,196,350,196,546,1409.08989243156,16.6201117318436,69100.3013144611,3838.90562858117,4157.6315748869,168,18.3736890987157,0,0
transformers_4.23.0,src/transformers/models/unispeech/modeling_unispeech.py,1593,723,1068,19,194,238,404,213,642,1555.09371413973,19.7835051546392,98238.6266257628,5457.70147920905,4965.68357618499,181,11.7929183150074,0,0
transformers_4.23.0,src/transformers/models/unispeech/configuration_unispeech.py,300,63,124,2,7,4,9,9,13,21.6514844544032,1.28571428571429,52.9830321669644,2.94350178705358,41.2090250187501,6,70.2587347101892,0,0
transformers_4.23.0,src/transformers/models/unispeech/convert_unispeech_original_pytorch_checkpoint_to_pytorch.py,274,143,215,9,60,52,97,69,149,382.942760749492,7.275,6621.48779803612,367.860433224229,910.170144059947,45,44.5450275219546,0,0
transformers_4.23.0,src/transformers/models/unispeech/__init__.py,67,23,42,1,2,2,2,3,4,2,0.5,3.16992500144231,0.176106944524573,6.33985000288463,8,91.6061716488424,0,0
transformers_4.23.0,src/transformers/models/ctrl/configuration_ctrl.py,129,31,52,0,0,0,0,0,0,0,0,0,0,0,2,100,0,0
transformers_4.23.0,src/transformers/models/ctrl/modeling_tf_ctrl.py,865,362,647,11,96,108,177,107,285,670.210147874241,10.140625,19483.3662678076,1082.40923710042,1921.31809112433,92,26.5532768664098,0,0
transformers_4.23.0,src/transformers/models/ctrl/__init__.py,93,38,64,1,4,4,4,5,8,8,0.5,9.28771237954945,0.51598402108608,18.5754247590989,14,79.9281659859904,0,0
transformers_4.23.0,src/transformers/models/ctrl/modeling_ctrl.py,823,327,512,15,110,124,211,125,335,804.55292742184,14.3863636363636,33571.1224200913,1865.06235667174,2333.5377353618,86,36.5668748110327,0,0
transformers_4.23.0,src/transformers/models/ctrl/tokenization_ctrl.py,260,128,181,10,38,29,53,48,82,232.64052645973,6.97368421052632,3193.71671422818,177.42870634601,457.966925059135,31,54.5682196376813,0,0
transformers_4.23.0,src/transformers/models/speech_to_text/configuration_speech_to_text.py,194,42,88,1,2,1,2,3,3,2,0.5,2.37744375108173,0.13208020839343,4.75488750216347,3,84.7519626372366,0,0
transformers_4.23.0,src/transformers/models/speech_to_text/modeling_speech_to_text.py,1420,532,908,17,184,194,348,201,542,1453.82226821575,16.0760869565217,66665.4429845595,3703.63572136441,4146.87001661898,171,18.8778843056607,0,0
transformers_4.23.0,src/transformers/models/speech_to_text/feature_extraction_speech_to_text.py,258,75,126,10,27,18,32,37,50,161.601243507287,5.92592592592593,1543.54173796413,85.7523187757852,260.472668281447,31,66.6138752612344,0,0
transformers_4.23.0,src/transformers/models/speech_to_text/__init__.py,131,69,97,1,8,8,8,9,16,24,0.5,25.3594000115385,1.40885555619658,50.718800023077,28,65.9851461328265,0,0
transformers_4.23.0,src/transformers/models/speech_to_text/convert_s2t_fairseq_to_tfms.py,123,46,89,6,12,7,13,18,20,58.5293250129808,3.25,271.04512509375,15.0580625052084,83.3985000288462,10,70.3464041166548,0,0
transformers_4.23.0,src/transformers/models/speech_to_text/processing_speech_to_text.py,114,54,51,5,9,9,18,14,27,40.1389654874176,5,513.992914477776,28.555161915432,102.798582895555,15,72.3012788928104,0,0
transformers_4.23.0,src/transformers/models/speech_to_text/tokenization_speech_to_text.py,290,126,161,8,46,29,56,54,85,278.083849978623,4.8695652173913,2382.02300089549,132.33461116086,489.165437683895,33,59.420560967057,0,0
transformers_4.23.0,src/transformers/models/speech_to_text/modeling_tf_speech_to_text.py,1501,523,1020,16,162,174,304,178,478,1253.05570046731,15.0123456790123,53645.1247565723,2980.28470869846,3573.40058000194,151,20.6373575018755,1,1
transformers_4.23.0,src/transformers/models/mobilebert/modeling_mobilebert.py,1627,742,1178,15,160,191,329,175,520,1230.11185411611,15.421875,59754.0561099504,3319.66978388613,3874.62977815281,198,7.79097915452248,0,0
transformers_4.23.0,src/transformers/models/mobilebert/tokenization_mobilebert_fast.py,54,19,19,0,0,0,0,0,0,0,0,0,0,0,1,100,0,0
transformers_4.23.0,src/transformers/models/mobilebert/tokenization_mobilebert.py,49,17,14,0,0,0,0,0,0,0,0,0,0,0,1,100,0,0
transformers_4.23.0,src/transformers/models/mobilebert/__init__.py,149,52,118,1,6,6,6,7,12,15.5097750043269,0.5,16.8441295323456,0.935784974019201,33.6882590646913,20,69.3891000509103,0,0
transformers_4.23.0,src/transformers/models/mobilebert/configuration_mobilebert.py,187,51,80,1,2,1,2,3,3,2,0.5,2.37744375108173,0.13208020839343,4.75488750216347,5,82.227326998986,0,0
transformers_4.23.0,src/transformers/models/mobilebert/convert_mobilebert_original_tf_checkpoint_to_pytorch.py,58,19,32,1,2,1,2,3,3,2,0.5,2.37744375108173,0.13208020839343,4.75488750216347,2,96.2811944471052,0,0
transformers_4.23.0,src/transformers/models/mobilebert/modeling_tf_mobilebert.py,1746,694,1284,14,130,145,255,144,400,966.210784602506,13.7307692307692,39379.4342386909,2187.74634659394,2867.97000057692,181,10.3793726848179,0,0
transformers_4.23.0,src/transformers/models/decision_transformer/__init__.py,70,23,42,1,2,2,2,3,4,2,0.5,3.16992500144231,0.176106944524573,6.33985000288463,8,91.9155709627847,0,0
transformers_4.23.0,src/transformers/models/decision_transformer/modeling_decision_transformer.py,952,486,630,17,168,162,285,185,447,1311.39619532809,14.4196428571429,48544.1244040538,2696.89580022521,3366.52751285079,129,25.3402536594033,0,0
transformers_4.23.0,src/transformers/models/decision_transformer/configuration_decision_transformer.py,176,42,78,0,0,0,0,0,0,0,0,0,0,0,2,100,0,0
transformers_4.23.0,src/transformers/models/convnext/configuration_convnext.py,126,35,53,1,3,2,4,4,6,4.75488750216347,0.666666666666667,8,0.444444444444444,12,6,83.3183841323111,0,0
transformers_4.23.0,src/transformers/models/convnext/convert_convnext_to_pytorch.py,243,171,180,7,96,89,154,103,243,651.807884523634,5.61458333333333,9122.68520363413,506.81584464634,1624.81962810552,57,43.5584890285265,0,0
transformers_4.23.0,src/transformers/models/convnext/modeling_convnext.py,467,222,313,14,83,67,124,97,191,582.431241710601,10.4578313253012,13182.9680756689,732.38711531494,1260.58335285774,66,43.0570497973338,0,0
transformers_4.23.0,src/transformers/models/convnext/__init__.py,103,51,72,1,6,6,6,7,12,15.5097750043269,0.5,16.8441295323456,0.935784974019201,33.6882590646913,20,74.0776854364209,0,0
transformers_4.23.0,src/transformers/models/convnext/feature_extraction_convnext.py,167,48,71,8,24,15,29,32,44,134.039100017308,4.83333333333333,1063.33333333333,59.0740740740741,220,24,70.1246365759281,0,0
transformers_4.23.0,src/transformers/models/convnext/modeling_tf_convnext.py,614,203,401,11,53,43,82,64,125,341.63353189686,8.50943396226415,6382.07547169811,354.559748427673,750,65,46.783488976698,0,0
transformers_4.23.0,src/transformers/models/mmbt/__init__.py,49,23,22,1,2,2,2,3,4,2,0.5,3.16992500144231,0.176106944524573,6.33985000288463,8,92.2814655295801,0,0
transformers_4.23.0,src/transformers/models/mmbt/modeling_mmbt.py,408,128,289,7,29,36,63,36,99,160.532933313103,7.60344827586207,3891.61647651672,216.20091536204,511.822575142789,30,53.2238155039058,0,0
transformers_4.23.0,src/transformers/models/mmbt/configuration_mmbt.py,42,10,8,0,0,0,0,0,0,0,0,0,0,0,3,100,0,0
transformers_4.23.0,src/transformers/models/unispeech_sat/convert_unispeech_sat_original_pytorch_checkpoint_to_pytorch.py,225,119,175,10,58,52,97,68,149,372.982178666273,8.36206896551724,7584.66383143027,421.370212857237,907.031963346301,41,46.9484587167599,0,0
transformers_4.23.0,src/transformers/models/unispeech_sat/__init__.py,73,23,48,1,2,2,2,3,4,2,0.5,3.16992500144231,0.176106944524573,6.33985000288463,8,90.8165051883758,0,0
transformers_4.23.0,src/transformers/models/unispeech_sat/modeling_unispeech_sat.py,1917,881,1293,19,207,266,453,226,719,1673.26242295779,20.7898550724638,116895.298446657,6494.18324703649,5622.70867397652,218,4.53922292175293,0,0
transformers_4.23.0,src/transformers/models/unispeech_sat/configuration_unispeech_sat.py,318,66,130,2,7,4,9,9,13,21.6514844544032,1.28571428571429,52.9830321669644,2.94350178705358,41.2090250187501,6,69.3144879754363,0,0
transformers_4.23.0,src/transformers/models/unispeech_sat/convert_unispeech_original_s3prl_checkpoint_to_pytorch.py,110,59,70,1,2,1,2,3,3,2,0.5,2.37744375108173,0.13208020839343,4.75488750216347,7,80.6205714250733,0,0
transformers_4.23.0,src/transformers/models/mctct/feature_extraction_mctct.py,364,147,205,17,88,62,117,105,179,637.916850741338,11.3011363636364,13582.2701471602,754.57056373112,1201.84994766224,45,54.0656615661383,0,0
transformers_4.23.0,src/transformers/models/mctct/__init__.py,75,38,45,1,4,4,4,5,8,8,0.5,9.28771237954945,0.51598402108608,18.5754247590989,14,82.3824487234529,0,0
transformers_4.23.0,src/transformers/models/mctct/processing_mctct.py,140,75,70,5,14,14,28,19,42,64.9126093832433,5,892.064777823153,49.5591543235085,178.412955564631,22,68.9397689133428,0,0
transformers_4.23.0,src/transformers/models/mctct/modeling_mctct.py,823,393,566,17,119,112,203,136,315,889.970182134901,14.5,32371.9865274109,1798.44369596727,2232.55079499386,103,27.9632321758834,0,0
transformers_4.23.0,src/transformers/models/mctct/configuration_mctct.py,185,39,73,1,2,1,2,3,3,2,0.5,2.37744375108173,0.13208020839343,4.75488750216347,3,80.6659788211909,0,0
transformers_4.23.0,src/transformers/models/resnet/modeling_tf_resnet.py,501,215,357,11,41,36,69,52,105,257.713379994352,9.25609756097561,5540.2017480153,307.78898600085,598.546170404815,60,43.697420982616,0,0
transformers_4.23.0,src/transformers/models/resnet/modeling_resnet.py,418,197,297,12,49,43,80,61,123,318.140332370299,9.79591836734694,7145.93331448394,396.996295249108,729.480692520235,60,43.8023775535024,0,0
transformers_4.23.0,src/transformers/models/resnet/__init__.py,88,37,58,1,4,4,4,5,8,8,0.5,9.28771237954945,0.51598402108608,18.5754247590989,14,81.3647930898523,0,0
transformers_4.23.0,src/transformers/models/resnet/configuration_resnet.py,114,34,46,1,2,1,2,3,3,2,0.5,2.37744375108173,0.13208020839343,4.75488750216347,5,85.8304231258495,0,0
transformers_4.23.0,src/transformers/models/resnet/convert_resnet_to_pytorch.py,200,112,144,6,19,10,21,25,31,96.2203977597551,3.31578947368421,477.339533612107,26.5188629784504,143.959541883016,19,58.4279040268427,0,0
transformers_4.23.0,src/transformers/models/marian/configuration_marian.py,398,154,266,9,33,19,35,42,54,194.99433095181,4.77272727272727,1389.74726305253,77.2081812806959,291.185140830053,33,58.2271147812018,0,0
transformers_4.23.0,src/transformers/models/marian/__init__.py,117,65,86,1,8,8,8,9,16,24,0.5,25.3594000115385,1.40885555619658,50.718800023077,26,67.8067680912418,0,0
transformers_4.23.0,src/transformers/models/marian/tokenization_marian.py,399,176,223,7,41,27,51,48,78,239.311116643745,4.35365853658537,1896.57153408636,105.36508522702,435.62707505625,57,53.815283310203,0,0
transformers_4.23.0,src/transformers/models/marian/modeling_flax_marian.py,1501,603,1128,16,146,145,261,162,406,1113.71438559648,14.3013698630137,42617.7833098998,2367.65462832777,2979.97910117116,141,15.5007350799419,0,0
transformers_4.23.0,src/transformers/models/marian/modeling_tf_marian.py,1509,521,1041,16,149,162,289,165,451,1139.65610954886,15.5167785234899,51550.0172393334,2863.88984662964,3322.21131862486,153,20.2812984342742,1,1
transformers_4.23.0,src/transformers/models/marian/modeling_marian.py,1737,659,1102,18,185,205,370,203,575,1468.36422022148,18,79336.2267428666,4407.56815238148,4407.56815238148,223,9.73847808933663,0,0
transformers_4.23.0,src/transformers/models/marian/convert_marian_to_pytorch.py,708,411,543,13,134,90,160,147,250,994.961667857176,7.76119402985075,13969.5135049064,776.08408360591,1799.91808620909,91,25.4391470338939,0,0
transformers_4.23.0,src/transformers/models/marian/convert_marian_tatoeba_to_pytorch.py,1324,228,1238,11,115,81,150,126,231,825.285103663614,7.17391304347826,11562.5662732261,642.364792957003,1611.75166232848,71,27.1973364267182,0,0
transformers_4.23.0,src/transformers/models/xlm_roberta/tokenization_xlm_roberta_fast.py,239,54,119,5,35,24,45,40,69,191.134546067511,3.21428571428571,1180.3276239018,65.5737568834336,367.213038547228,14,71.4402494925059,0,0
transformers_4.23.0,src/transformers/models/xlm_roberta/modeling_tf_xlm_roberta.py,181,35,100,0,0,0,0,0,0,0,0,0,0,0,1,100,0,0
transformers_4.23.0,src/transformers/models/xlm_roberta/__init__.py,178,79,144,1,10,10,10,11,20,33.2192809488736,0.5,34.594316186373,1.9219064547985,69.188632372746,32,60.0450089597118,0,0
transformers_4.23.0,src/transformers/models/xlm_roberta/configuration_xlm_roberta.py,68,22,37,1,2,1,2,3,3,2,0.5,2.37744375108173,0.13208020839343,4.75488750216347,3,94.8099617382993,0,0
transformers_4.23.0,src/transformers/models/xlm_roberta/tokenization_xlm_roberta.py,328,103,145,8,72,43,83,80,126,468.234600103846,4.61111111111111,3673.04022312956,204.057790173864,796.562939955808,31,59.7529536621182,0,0
transformers_4.23.0,src/transformers/models/xlm_roberta/modeling_flax_xlm_roberta.py,151,31,84,0,0,0,0,0,0,0,0,0,0,0,1,100,0,0
transformers_4.23.0,src/transformers/models/xlm_roberta/modeling_xlm_roberta.py,161,35,87,0,0,0,0,0,0,0,0,0,0,0,1,100,0,0
transformers_4.23.0,src/transformers/models/detr/modeling_detr.py,2338,1009,1289,21,320,301,542,341,843,2755.25565624231,17.784375,126139.029270802,7007.72384837787,7092.68834416738,245,3.64543663428921,1,1
transformers_4.23.0,src/transformers/models/detr/configuration_detr.py,237,69,112,0,0,0,0,0,0,0,0,0,0,0,7,100,0,0
transformers_4.23.0,src/transformers/models/detr/__init__.py,77,37,48,1,4,4,4,5,8,8,0.5,9.28771237954945,0.51598402108608,18.5754247590989,14,82.2365154235863,0,0
transformers_4.23.0,src/transformers/models/detr/convert_detr_original_pytorch_checkpoint_to_pytorch.py,278,177,206,7,30,26,43,37,69,166.858202322659,5.01666666666667,1803.25228251246,100.180682361803,359.452282228398,33,51.970656651581,0,0
transformers_4.23.0,src/transformers/models/detr/feature_extraction_detr.py,1368,692,754,22,290,251,438,312,689,2470.28113171435,16.6137931034483,94842.1992294468,5269.0110683026,5708.64212879609,195,14.672567755731,0,0
transformers_4.23.0,src/transformers/models/vit_mae/modeling_vit_mae.py,1028,468,595,15,143,113,205,158,318,1082.46496009344,10.7517482517483,24972.0349811363,1387.33527672979,2322.60227792032,98,33.432441738827,0,0
transformers_4.23.0,src/transformers/models/vit_mae/convert_vit_mae_to_pytorch.py,178,133,132,6,66,71,111,72,182,414.439786881985,5.04545454545455,5665.67385814262,314.759658785701,1122.9263502625,36,47.2634584527661,0,0
transformers_4.23.0,src/transformers/models/vit_mae/__init__.py,86,37,58,1,4,4,4,5,8,8,0.5,9.28771237954945,0.51598402108608,18.5754247590989,14,80.9249967887991,0,0
transformers_4.23.0,src/transformers/models/vit_mae/configuration_vit_mae.py,142,30,53,0,0,0,0,0,0,0,0,0,0,0,2,100,0,0
transformers_4.23.0,src/transformers/models/vit_mae/modeling_tf_vit_mae.py,1184,452,731,13,116,92,169,129,261,843.631511770633,9.4698275862069,17329.1245651855,962.729142510306,1829.93031366547,88,34.9220278863772,0,0
transformers_4.23.0,src/transformers/models/beit/modeling_flax_beit.py,952,446,708,15,137,110,203,152,313,1031.03375429972,11.1131386861314,25211.2810005488,1400.62672225271,2268.60131170784,90,25.0667084513147,0,0
transformers_4.23.0,src/transformers/models/beit/configuration_beit.py,203,52,89,0,0,0,0,0,0,0,0,0,0,0,4,100,0,0
transformers_4.23.0,src/transformers/models/beit/__init__.py,112,51,80,1,6,6,6,7,12,15.5097750043269,0.5,16.8441295323456,0.935784974019201,33.6882590646913,20,72.7463367205987,0,0
transformers_4.23.0,src/transformers/models/beit/convert_beit_unilm_to_pytorch.py,370,222,286,6,78,93,109,84,202,505.771148075582,4.19230769230769,5413.30942364395,300.739412424664,1291.24811940131,51,41.4068310533378,0,0
transformers_4.23.0,src/transformers/models/beit/modeling_beit.py,1290,611,855,16,194,180,329,210,509,1538.3830913843,13.5670103092784,53271.5574694386,2959.53097052437,3926.55096849206,159,17.8408148326498,0,0
transformers_4.23.0,src/transformers/models/beit/feature_extraction_beit.py,268,95,134,7,42,31,60,49,91,246.128816211111,5,2554.69297907242,141.927387726246,510.938595814484,51,59.9625203203428,0,0
transformers_4.23.0,src/transformers/models/transfo_xl/modeling_transfo_xl.py,1298,708,898,20,252,241,442,272,683,2096.71310261973,17.5396825396825,96884.5955275278,5382.4775293071,5523.73712057398,208,7.85851182438833,0,0
transformers_4.23.0,src/transformers/models/transfo_xl/tokenization_transfo_xl.py,805,473,519,19,150,114,225,169,339,1165.03342632981,14.25,35751.7983368202,1986.21101871223,2508.89812889966,151,23.6327177373399,0,0
transformers_4.23.0,src/transformers/models/transfo_xl/modeling_transfo_xl_utilities.py,248,167,151,15,59,63,113,74,176,405.679298846476,14.364406779661,15698.3400680884,872.130003782688,1092.8637923507,35,52.7007862679462,0,0
transformers_4.23.0,src/transformers/models/transfo_xl/__init__.py,101,38,72,1,4,4,4,5,8,8,0.5,9.28771237954945,0.51598402108608,18.5754247590989,14,79.0015874808669,0,0
transformers_4.23.0,src/transformers/models/transfo_xl/modeling_tf_transfo_xl.py,1174,512,837,18,138,133,236,156,369,1056.03502506135,15.3913043478261,41376.6500104826,2298.70277836015,2688.31341876017,119,23.5268913554541,1,1
transformers_4.23.0,src/transformers/models/transfo_xl/modeling_tf_transfo_xl_utilities.py,178,111,136,12,43,38,73,55,111,276.348934460844,10.1860465116279,6536.70108260795,363.150060144886,641.730928201237,24,54.1419115615541,0,0
transformers_4.23.0,src/transformers/models/transfo_xl/convert_transfo_xl_original_tf_checkpoint_to_pytorch.py,121,54,84,2,10,6,12,12,18,35.2192809488736,1.2,77.435190015577,4.30195500086539,64.5293250129808,5,74.0228423597346,0,0
transformers_4.23.0,src/transformers/models/transfo_xl/configuration_transfo_xl.py,188,50,84,3,9,5,9,12,14,33.2842125151443,1.5,75.2842125151443,4.18245625084135,50.1894750100962,5,75.6485691060952,0,0
transformers_4.23.0,src/transformers/models/mt5/modeling_mt5.py,116,25,36,0,0,0,0,0,0,0,0,0,0,0,1,100,0,0
transformers_4.23.0,src/transformers/models/mt5/modeling_tf_mt5.py,95,19,15,0,0,0,0,0,0,0,0,0,0,0,1,100,0,0
transformers_4.23.0,src/transformers/models/mt5/__init__.py,109,62,74,1,6,6,6,7,12,15.5097750043269,0.5,16.8441295323456,0.935784974019201,33.6882590646913,22,71.2578093828785,0,0
transformers_4.23.0,src/transformers/models/mt5/modeling_flax_mt5.py,119,29,22,2,4,3,4,6,7,10,1,18.0947375050481,1.00526319472489,18.0947375050481,1,48.7267313762144,0,0
transformers_4.23.0,src/transformers/models/mt5/configuration_mt5.py,178,67,100,7,15,9,17,22,26,78.254843388531,3.96666666666667,459.916047602127,25.5508915334515,115.94522208457,15,72.9335976710853,0,0
transformers_4.23.0,src/transformers/sagemaker/training_args_sm.py,136,75,84,6,16,11,18,22,29,79.5097750043269,3.375,436.466869674126,24.2481594263403,129.323516940482,22,68.9907778486426,0,0
transformers_4.23.0,src/transformers/sagemaker/__init__.py,20,2,2,0,0,0,0,0,0,0,0,0,0,0,1,100,0,0
transformers_4.23.0,src/transformers/sagemaker/trainer_sm.py,30,8,12,0,0,0,0,0,0,0,0,0,0,0,2,100,0,0
transformers_4.23.0,src/transformers/utils/dummy_detectron2_objects.py,14,8,8,0,0,0,0,0,0,0,0,0,0,0,3,100,0,0
transformers_4.23.0,src/transformers/utils/logging.py,348,173,157,6,16,9,17,22,26,79.5097750043269,3.1875,369.575395394566,20.5319664108092,115.94522208457,25,62.4798043610327,1,1
transformers_4.23.0,src/transformers/utils/hp_naming.py,162,110,113,9,40,22,44,49,66,241.406448808475,4.95,1834.32570607244,101.906983670691,370.570849711604,34,53.9592253299035,0,0
transformers_4.23.0,src/transformers/utils/hub.py,1126,490,695,17,181,137,249,198,386,1426.95897386332,11.6933701657459,34436.1759588388,1913.12088660215,2944.93165535073,154,24.619335687082,1,1
transformers_4.23.0,src/transformers/utils/sentencepiece_model_pb2.py,1512,50,1468,1,1,1,1,2,2,0,0.5,1,0.055555555555556,2,1,68.352905440374,0,0
transformers_4.23.0,src/transformers/utils/dummy_sentencepiece_and_tokenizers_objects.py,10,4,4,0,0,0,0,0,0,0,0,0,0,0,1,100,0,0
transformers_4.23.0,src/transformers/utils/fx.py,1160,660,852,16,315,224,418,331,642,2678.25052579199,10.615873015873,57049.5032315215,3169.41684619564,5373.98131517023,198,6.05317196280431,0,0
transformers_4.23.0,src/transformers/utils/dummy_timm_and_vision_objects.py,89,48,48,0,0,0,0,0,0,0,0,0,0,0,12,100,0,0
transformers_4.23.0,src/transformers/utils/dummy_tokenizers_objects.py,395,225,225,0,0,0,0,0,0,0,0,0,0,0,57,100,0,0
transformers_4.23.0,src/transformers/utils/constants.py,4,4,4,0,0,0,0,0,0,0,0,0,0,0,1,100,0,0
transformers_4.23.0,src/transformers/utils/generic.py,337,204,193,8,56,35,65,64,100,349.211875635226,4.64285714285714,2785.71428571429,154.761904761905,600,77,47.6183297355147,0,0
transformers_4.23.0,src/transformers/utils/__init__.py,193,32,165,4,9,5,10,13,15,36.5293250129808,2.22222222222222,123.347990604703,6.85266614470573,55.5065957721164,3,73.8604042613442,0,0
transformers_4.23.0,src/transformers/utils/versions.py,123,54,69,7,16,11,19,23,30,83.6514844544032,4.15625,564.031631395859,31.3350906331033,135.70685868171,17,73.9530747435117,0,0
transformers_4.23.0,src/transformers/utils/dummy_sentencepiece_objects.py,192,109,109,0,0,0,0,0,0,0,0,0,0,0,28,100,0,0
transformers_4.23.0,src/transformers/utils/dummy_vision_objects.py,199,113,113,0,0,0,0,0,0,0,0,0,0,0,29,100,0,0
transformers_4.23.0,src/transformers/utils/doc.py,1158,180,853,12,90,69,136,102,205,627.286328678325,9.06666666666667,12401.8145689444,688.989698274686,1367.84719510416,15,38.5814648629267,0,0
transformers_4.23.0,src/transformers/utils/notebook.py,359,213,222,18,109,77,152,127,229,812.790741426647,12.5504587155963,20085.8644880228,1115.88136044571,1600.40879327083,73,45.2198696246973,0,0
transformers_4.23.0,src/transformers/utils/dummy_tensorflow_text_objects.py,10,5,5,0,0,0,0,0,0,0,0,0,0,0,2,100,0,0
transformers_4.23.0,src/transformers/utils/bitsandbytes.py,163,77,83,12,40,28,52,52,80,255.896673804148,7.8,3557.07438412004,197.615243562225,456.035177451287,27,65.6903448639122,0,0
transformers_4.23.0,src/transformers/utils/dummy_speech_objects.py,17,9,9,0,0,0,0,0,0,0,0,0,0,0,3,100,0,0
transformers_4.23.0,src/transformers/utils/dummy_flax_objects.py,1131,637,637,0,0,0,0,0,0,0,0,0,0,0,157,100,0,0
transformers_4.23.0,src/transformers/utils/dummy_sentencepiece_and_speech_objects.py,10,5,5,0,0,0,0,0,0,0,0,0,0,0,2,100,0,0
transformers_4.23.0,src/transformers/utils/import_utils.py,1075,533,715,11,194,122,234,205,356,1512.43683918931,6.6340206185567,18136.7152378897,1007.59529099387,2733.89491542394,111,21.3981643318535,0,0
transformers_4.23.0,src/transformers/utils/dummy_pt_objects.py,5969,3297,3297,0,0,0,0,0,0,0,0,0,0,0,773,100,1,1
transformers_4.23.0,src/transformers/utils/dummy_scatter_objects.py,45,24,24,0,0,0,0,0,0,0,0,0,0,0,6,100,0,0
transformers_4.23.0,src/transformers/utils/dummy_tf_objects.py,2637,1461,1461,0,0,0,0,0,0,0,0,0,0,0,349,100,0,0
transformers_4.23.0,src/transformers/utils/model_parallel_utils.py,58,23,32,6,22,13,26,28,39,113.617270614347,3.54545454545455,664.726076040874,36.9292264467152,187.486841960247,14,81.5737439400401,0,0
transformers_4.23.0,src/transformers/pipelines/zero_shot_image_classification.py,131,60,69,4,12,7,13,16,20,51.0195500086539,2.16666666666667,173.333333333333,9.62962962962963,80,19,74.2929613578039,0,0
transformers_4.23.0,src/transformers/pipelines/text2text_generation.py,345,138,161,10,46,36,73,56,109,287.303130927496,7.93478260869565,5022.73077334917,279.040598519398,633.001686504279,55,54.8068899267622,0,0
transformers_4.23.0,src/transformers/pipelines/audio_utils.py,216,114,152,13,46,32,64,59,96,302.189566314457,9.04347826086956,5107.15723520249,283.730957511249,564.733732738737,26,58.4516410527427,0,0
transformers_4.23.0,src/transformers/pipelines/text_classification.py,206,97,119,12,50,35,68,62,103,325.21235949739,8.16,5004.38291495396,278.021273052998,613.282219969848,41,59.7074262994068,0,0
transformers_4.23.0,src/transformers/pipelines/zero_shot_classification.py,237,108,147,11,44,29,52,55,81,278.268739025051,6.5,3043.88588917073,169.104771620596,468.290136795497,42,59.0965881460515,1,1
transformers_4.23.0,src/transformers/pipelines/fill_mask.py,230,125,148,7,36,29,54,43,83,205.768784506326,5.25,2364.49486686144,131.360825936747,450.379974640274,39,56.5412991994448,0,0
transformers_4.23.0,src/transformers/pipelines/token_classification.py,468,241,335,14,87,61,113,101,174,613.839053047646,9.09195402298851,10533.2905657133,585.182809206297,1158.52879799881,83,38.922621302469,0,0
transformers_4.23.0,src/transformers/pipelines/feature_extraction.py,79,29,26,3,7,4,8,10,12,24.4063719565667,1.71428571428571,68.3368065233972,3.79648925129984,39.8631371386484,10,72.1492497236698,0,0
transformers_4.23.0,src/transformers/pipelines/__init__.py,856,228,590,11,81,69,139,92,208,551.581598038665,9.43827160493827,12806.799111165,711.488839509165,1356.90088685986,121,37.3090733795317,0,0
transformers_4.23.0,src/transformers/pipelines/base.py,1186,607,722,14,207,145,277,221,422,1645.85476911117,9.36714975845411,30785.0897219445,1710.28276233025,3286.49488006318,229,11.9031228320371,1,1
transformers_4.23.0,src/transformers/pipelines/document_question_answering.py,442,211,279,11,84,65,127,95,192,575.008411318426,8.31547619047619,10489.243754101,582.73576411672,1261.41227679954,80,44.8142406200356,0,0
transformers_4.23.0,src/transformers/pipelines/text_generation.py,274,140,176,13,64,51,98,77,149,432.105716335834,9.953125,9293.74235839024,516.319019910569,933.75119456354,46,53.5551797754413,0,0
transformers_4.23.0,src/transformers/pipelines/image_classification.py,115,51,59,4,10,7,12,14,19,41.2192809488736,2.4,173.615384445827,9.64529913587926,72.3397435190945,16,76.6924246220258,0,0
transformers_4.23.0,src/transformers/pipelines/conversational.py,306,146,158,11,44,31,57,55,88,278.268739025051,7.125,3624.91254037996,201.384030021109,508.75965479017,50,56.3098024345133,0,0
transformers_4.23.0,src/transformers/pipelines/object_detection.py,135,62,65,4,8,4,8,12,12,32,2,86.0391000173078,4.77995000096154,43.0195500086539,16,76.5375282805419,0,0
transformers_4.23.0,src/transformers/pipelines/table_question_answering.py,419,237,255,12,101,70,141,113,211,715.498909766585,8.37623762376238,12053.8897610385,669.660542279915,1439.0577610696,84,42.6670604547422,0,0
transformers_4.23.0,src/transformers/pipelines/image_to_text.py,95,38,49,1,2,1,2,3,3,2,0.5,2.37744375108173,0.13208020839343,4.75488750216347,12,88.2105117505666,0,0
transformers_4.23.0,src/transformers/pipelines/zero_shot_object_detection.py,278,138,146,12,54,36,69,66,105,353.783475125481,7.66666666666667,4865.73726608356,270.318737004642,634.661382532638,61,54.6484186289541,0,0
transformers_4.23.0,src/transformers/pipelines/question_answering.py,647,295,403,18,134,101,190,152,291,1021.9146015473,12.7611940298507,26915.232910184,1495.29071723245,2109.14690641208,111,35.9722546770182,1,1
transformers_4.23.0,src/transformers/pipelines/image_segmentation.py,180,91,106,5,31,20,40,36,60,165.18972609643,3.2258064516129,1000.63064544045,55.5905914133582,310.195500086539,24,64.0920623212926,0,0
transformers_4.23.0,src/transformers/pipelines/audio_classification.py,158,66,82,6,11,7,12,17,19,53.5635228093372,3.27272727272727,254.165871219567,14.1203261788648,77.6617939837565,18,73.8867986684282,1,1
transformers_4.23.0,src/transformers/pipelines/automatic_speech_recognition.py,417,220,234,17,111,79,156,128,235,823.667029466118,11.9459459459459,19651.0810810811,1091.72672672673,1645,68,46.4078010410627,0,0
transformers_4.23.0,src/transformers/pipelines/pt_utils.py,292,142,137,8,19,20,37,27,57,104.710622755428,7.78947368421053,2111.17005096058,117.287225053366,271.028587623318,47,57.3768067117872,1,1
transformers_4.23.0,src/transformers/pipelines/visual_question_answering.py,115,55,52,4,10,6,12,14,18,41.2192809488736,2.4,164.477732632889,9.13765181293825,68.5323885970369,17,75.2499291410661,0,0
transformers_4.23.0,src/transformers/benchmark/benchmark_utils.py,914,483,564,17,150,109,210,167,319,1153.80967187564,11.9,28029.2798646607,1557.18221470338,2355.40166929922,95,32.0295031354697,0,0
transformers_4.23.0,src/transformers/benchmark/benchmark_args_tf.py,137,80,96,4,7,4,7,11,11,27.6514844544032,2,76.1074956100206,4.2281942005567,38.0537478050103,18,69.4752039833814,0,0
transformers_4.23.0,src/transformers/benchmark/__init__.py,0,0,0,0,0,0,0,0,0,0,0,0,0,0,1,100,0,0
transformers_4.23.0,src/transformers/benchmark/benchmark.py,272,153,195,5,24,14,25,29,39,121.648740491745,2.60416666666667,493.388694817644,27.4104830454247,189.461258809975,45,51.5764306186052,0,0
transformers_4.23.0,src/transformers/benchmark/benchmark_args.py,115,62,76,4,8,5,8,12,13,32,2,93.2090250187501,5.17827916770834,46.604512509375,16,72.6160145419933,0,0
transformers_4.23.0,src/transformers/benchmark/benchmark_tf.py,299,173,223,10,44,23,45,54,68,273.434272168915,5.11363636363636,2001.13133597957,111.173963109976,391.332350147116,49,46.8442538777837,0,0
transformers_4.23.0,src/transformers/benchmark/benchmark_args_utils.py,165,80,125,2,3,2,3,5,5,6.75488750216347,1,11.6096404744368,0.644980026357601,11.6096404744368,8,72.653878976738,0,0
transformers_4.23.0,src/transformers/commands/download.py,46,20,24,0,0,0,0,0,0,0,0,0,0,0,4,100,0,0
transformers_4.23.0,src/transformers/commands/add_new_model_like.py,1570,760,1012,17,389,280,548,406,828,3416.29751650088,11.974293059126,85914.3329909044,4773.01849949469,7174.89813942933,239,5.00439097357108,0,0
transformers_4.23.0,src/transformers/commands/user.py,197,114,147,6,15,11,21,21,32,74.1131339384547,4.2,590.327461621465,32.7959700900814,140.55415752892,26,57.6023827310763,0,0
transformers_4.23.0,src/transformers/commands/__init__.py,27,10,10,0,0,0,0,0,0,0,0,0,0,0,3,100,0,0
transformers_4.23.0,src/transformers/commands/train.py,158,68,108,3,10,7,12,13,19,37.9741684510371,1.8,126.555038360425,7.03083546446807,70.3083546446807,14,69.4410055181739,0,0
transformers_4.23.0,src/transformers/commands/transformers_cli.py,59,32,32,2,3,2,3,5,5,6.75488750216347,1,11.6096404744368,0.644980026357601,11.6096404744368,3,88.4935589625809,0,0
transformers_4.23.0,src/transformers/commands/env.py,92,49,60,1,2,1,2,3,3,2,0.5,2.37744375108173,0.13208020839343,4.75488750216347,9,82.3359275917977,0,0
transformers_4.23.0,src/transformers/commands/add_new_model.py,259,140,194,10,58,45,80,68,125,372.982178666273,6.89655172413793,5247.81279418133,291.545155232296,760.932855156293,20,49.1061722853714,0,0
transformers_4.23.0,src/transformers/commands/run.py,110,48,80,4,6,4,6,10,10,23.5097750043269,2,66.4385618977473,3.69103121654151,33.2192809488736,14,73.6436061411411,0,0
transformers_4.23.0,src/transformers/commands/pt_to_tf.py,378,193,294,14,88,62,121,102,183,621.732951348889,9.625,11752.643186715,652.924621484169,1221.05383758078,64,41.640754123389,0,0
transformers_4.23.0,src/transformers/commands/serving.py,229,98,140,3,4,3,4,7,7,12.7548875021635,1.5,29.4772266816048,1.6376237045336,19.6514844544032,16,72.8724864174978,0,0
transformers_4.23.0,src/transformers/commands/lfs.py,226,111,135,11,30,20,38,41,58,185.260465673266,6.96666666666667,2164.80817999935,120.267121111075,310.738016267849,22,61.5640406715388,0,0
transformers_4.23.0,src/transformers/commands/convert.py,184,89,138,2,14,12,24,16,36,55.3029689088065,1.71428571428571,246.857142857143,13.7142857142857,144,23,60.7937750292934,0,0
transformers_4.23.0,src/transformers/data/test_generation_utils.py,100,40,69,2,3,2,3,5,5,6.75488750216347,1,11.6096404744368,0.644980026357601,11.6096404744368,9,80.955852417045,0,0
transformers_4.23.0,src/transformers/data/__init__.py,48,3,30,0,0,0,0,0,0,0,0,0,0,0,1,100,0,0
transformers_4.23.0,src/transformers/data/data_collator.py,1543,818,908,23,416,325,596,439,921,3723.42484773601,16.4759615384615,133201.707535611,7400.09486308952,8084.60903630207,286,0,0,0
transformers_4.23.0,src/transformers/data/processors/utils.py,349,199,216,12,63,46,90,75,136,419.588185189149,8.57142857142857,7261.0229306352,403.390162813067,847.11934190744,67,47.1771848627045,0,0
transformers_4.23.0,src/transformers/data/processors/__init__.py,22,4,4,0,0,0,0,0,0,0,0,0,0,0,1,100,0,0
transformers_4.23.0,src/transformers/data/processors/glue.py,643,388,422,5,23,33,61,28,94,115.651565463748,6.6304347826087,2996.23620903025,166.457567168347,451.891362673415,118,25.0757336362453,0,0
transformers_4.23.0,src/transformers/data/processors/squad.py,846,376,582,16,176,135,254,192,389,1376.85996488016,11.5454545454545,34065.4456748297,1892.52475971276,2950.55041278053,97,31.2272069075699,0,0
transformers_4.23.0,src/transformers/data/processors/xnli.py,97,61,59,4,15,11,16,19,27,66.6033589341278,2.13333333333333,244.68062477435,13.5933680430195,114.694042862977,18,71.2018574738518,0,0
transformers_4.23.0,src/transformers/data/datasets/__init__.py,27,3,9,0,0,0,0,0,0,0,0,0,0,0,1,100,0,0
transformers_4.23.0,src/transformers/data/datasets/glue.py,163,81,114,7,22,13,25,29,38,117.758980064424,3.97727272727273,734.217582218145,40.7898656787858,184.603277814848,16,64.7861738109864,0,0
transformers_4.23.0,src/transformers/data/datasets/language_modeling.py,532,286,346,15,122,95,173,137,268,904.1533141168,10.6352459016393,20231.1368541628,1123.95204745349,1902.27259823342,90,38.1298273469292,0,0
transformers_4.23.0,src/transformers/data/datasets/squad.py,230,117,175,10,26,16,31,36,47,155.430713620542,5.96153846153846,1448.57321675028,80.4762898194599,242.986475067789,20,56.439188295484,0,0
transformers_4.23.0,src/transformers/data/metrics/__init__.py,102,69,70,3,28,19,38,31,57,139.360825319776,2.03571428571429,574.863707587391,31.936872643744,282.389189692052,16,64.5138069170747,0,0
transformers_4.23.0,src/transformers/data/metrics/squad_metrics.py,776,471,529,18,165,132,243,183,375,1290.50181537652,13.2545454545455,37356.4444234709,2075.35802352616,2818.38743935652,128,23.7898803983716,0,0
transformers_4.23.0,src/transformers/onnx/utils.py,109,43,41,6,12,10,20,18,30,58.5293250129808,5,625.488750216347,34.7493750120193,125.097750043269,12,71.3861086078303,0,0
transformers_4.23.0,src/transformers/onnx/features.py,714,129,589,8,32,19,34,40,53,184,4.25,1198.76430337338,66.5980168540766,282.06218902903,39,51.9772575685541,3,1
transformers_4.23.0,src/transformers/onnx/__init__.py,50,12,28,0,0,0,0,0,0,0,0,0,0,0,2,100,0,0
transformers_4.23.0,src/transformers/onnx/__main__.py,180,65,135,5,15,12,23,20,35,70.2129994085646,3.83333333333333,579.858686064055,32.214371448003,151.267483321058,16,63.1105884501139,0,0
transformers_4.23.0,src/transformers/onnx/config.py,673,321,410,13,76,48,91,89,139,522.948207357547,7.78289473684211,7005.59327755146,389.199626530636,900.126946904329,96,39.886940900768,0,0
transformers_4.23.0,src/transformers/onnx/convert.py,484,194,308,10,64,43,80,74,123,417.219280948874,6.25,4773.51727482726,265.19540415707,763.762763972361,65,48.5202438654875,0,0
transformers_4.23.0,docs/source/_config.py,14,5,12,0,0,0,0,0,0,0,0,0,0,0,1,100,0,0
transformers_4.23.0,docs/source/it/_config.py,15,5,13,0,0,0,0,0,0,0,0,0,0,0,1,100,0,0
transformers_4.23.0,docs/source/en/_config.py,14,5,12,0,0,0,0,0,0,0,0,0,0,0,1,100,0,0
transformers_4.23.0,docs/source/de/_config.py,14,5,12,0,0,0,0,0,0,0,0,0,0,0,1,100,0,0
transformers_4.23.0,docs/source/pt/_config.py,14,5,12,0,0,0,0,0,0,0,0,0,0,0,1,100,0,0
transformers_4.23.0,docs/source/es/_config.py,14,5,12,0,0,0,0,0,0,0,0,0,0,0,1,100,0,0
transformers_4.23.0,tests/test_modeling_flax_common.py,1223,780,838,16,123,90,162,139,252,917.929284156726,10.5365853658537,18902.3512424627,1050.13062458126,1793.97315032632,175,12.2610047193353,0,0
transformers_4.23.0,tests/test_configuration_common.py,414,229,301,7,26,17,32,33,49,141.862917126072,4.30769230769231,1064.75518950151,59.1530660834171,247.175311848564,54,45.857979945144,0,0
transformers_4.23.0,tests/test_feature_extraction_common.py,275,149,174,4,16,13,18,20,31,72,2.25,301.454484618394,16.7474713676885,133.979770941508,40,56.412348049201,0,0
transformers_4.23.0,tests/__init__.py,0,0,0,0,0,0,0,0,0,0,0,0,0,0,1,100,0,0
transformers_4.23.0,tests/test_sequence_feature_extraction_common.py,425,249,302,11,102,77,146,113,223,718.641132686103,7.87254901960784,11973.3590845169,665.186615806495,1520.89990861859,29,39.8079846506617,0,0
transformers_4.23.0,tests/test_modeling_tf_common.py,2309,1386,1738,21,369,261,471,390,732,3238.87768111464,13.4024390243902,84442.9488151405,4691.27493417447,6300.56578966472,370,0,0,0
transformers_4.23.0,tests/test_tokenization_common.py,4093,2227,2990,20,438,363,671,458,1034,3929.79529400306,15.3196347031963,140017.42778618,7778.74598812112,9139.73671689224,462,0,0,0
transformers_4.23.0,tests/test_modeling_common.py,3132,1885,2195,21,351,304,525,372,829,3060.05852020525,15.7051282051282,111176.016046801,6176.44533593339,7078.96265440856,431,0,0,0
transformers_4.23.0,tests/models/__init__.py,0,0,0,0,0,0,0,0,0,0,0,0,0,0,1,100,0,0
transformers_4.23.0,tests/models/fnet/test_tokenization_fnet.py,450,201,340,5,25,16,29,30,45,127.706045218805,2.9,640.349222726912,35.5749568181618,220.810076802383,26,46.9723061015014,0,0
transformers_4.23.0,tests/models/fnet/test_modeling_fnet.py,566,282,401,5,24,25,29,29,54,121.648740491745,3.02083333333333,792.458149830186,44.0254527683436,262.330973736889,45,45.8290155757504,0,0
transformers_4.23.0,tests/models/fnet/__init__.py,0,0,0,0,0,0,0,0,0,0,0,0,0,0,1,100,0,0
transformers_4.23.0,tests/models/gpt_neo/test_modeling_flax_gpt_neo.py,331,200,249,4,28,41,59,32,100,142.605937817613,4.21428571428571,2107.14285714286,117.063492063492,500,31,44.2767079531036,0,0
transformers_4.23.0,tests/models/gpt_neo/__init__.py,0,0,0,0,0,0,0,0,0,0,0,0,0,0,1,100,0,0
transformers_4.23.0,tests/models/gpt_neo/test_modeling_gpt_neo.py,557,296,413,7,49,54,71,56,125,294.772266816048,5.07142857142857,3681.44820951866,204.524900528814,725.919365257201,44,38.7878721784088,0,0
transformers_4.23.0,tests/models/mbart50/__init__.py,0,0,0,0,0,0,0,0,0,0,0,0,0,0,1,100,0,0
transformers_4.23.0,tests/models/mbart50/test_tokenization_mbart50.py,318,169,223,7,29,34,63,36,97,160.532933313103,7.60344827586207,3812.99796183962,211.833220102201,501.482725139904,37,50.2104470229225,0,0
transformers_4.23.0,tests/models/roberta/test_modeling_flax_roberta.py,160,64,124,0,0,0,0,0,0,0,0,0,0,0,12,100,0,0
transformers_4.23.0,tests/models/roberta/__init__.py,0,0,0,0,0,0,0,0,0,0,0,0,0,0,1,100,0,0
transformers_4.23.0,tests/models/roberta/test_modeling_roberta.py,562,262,435,4,31,34,51,35,85,161.580085621993,3.29032258064516,1434.54463731977,79.6969242955428,435.989056440322,43,41.2267765054709,0,0
transformers_4.23.0,tests/models/roberta/test_modeling_tf_roberta.py,687,329,499,5,29,35,48,34,83,152.491089333136,4.13793103448276,1747.28034133977,97.0711300744318,422.259415823778,43,40.8068577933801,0,0
transformers_4.23.0,tests/models/roberta/test_tokenization_roberta.py,303,151,221,3,48,34,68,51,102,272.833087536779,2.125,1229.49819287232,68.3054551595734,578.587384881093,18,51.9377492390436,0,0
transformers_4.23.0,tests/models/esm/__init__.py,0,0,0,0,0,0,0,0,0,0,0,0,0,0,1,100,0,0
transformers_4.23.0,tests/models/esm/test_tokenization_esm.py,91,55,53,1,2,1,2,3,3,2,0.5,2.37744375108173,0.13208020839343,4.75488750216347,11,82.7775043138574,0,0
transformers_4.23.0,tests/models/esm/test_modeling_esm.py,293,164,216,2,23,21,35,25,56,106.041924989311,1.52173913043478,395.73731008515,21.9854061158417,260.055946627385,27,50.9895097526973,0,0
transformers_4.23.0,tests/models/gpt_neox_japanese/__init__.py,0,0,0,0,0,0,0,0,0,0,0,0,0,0,1,100,0,0
transformers_4.23.0,tests/models/gpt_neox_japanese/test_tokenization_gpt_neox_japanese.py,137,69,92,2,9,5,10,11,15,30.5293250129808,1.11111111111111,57.657193643955,3.20317742466416,51.8914742795595,15,71.0184187161619,0,0
transformers_4.23.0,tests/models/gpt_neox_japanese/test_modeling_gpt_neox_japanese.py,255,141,187,3,6,6,8,9,14,20.2646625064904,2,88.7579000403848,4.93099444668804,44.3789500201924,24,56.687488632225,0,0
transformers_4.23.0,tests/models/albert/test_modeling_flax_albert.py,161,70,126,1,6,6,6,7,12,15.5097750043269,0.5,16.8441295323456,0.935784974019201,33.6882590646913,12,65.4973759716119,0,0
transformers_4.23.0,tests/models/albert/__init__.py,0,0,0,0,0,0,0,0,0,0,0,0,0,0,1,100,0,0
transformers_4.23.0,tests/models/albert/test_tokenization_albert.py,135,75,84,4,17,10,18,21,28,77.4868683012558,2.11764705882353,260.43858600947,14.4688103338594,122.984887837805,13,66.6550856208215,0,0
transformers_4.23.0,tests/models/albert/test_modeling_tf_albert.py,337,182,270,3,10,7,11,13,18,37.9741684510371,1.65,109.90305962879,6.1057255349328,66.6079149265397,40,47.8254127868492,0,0
transformers_4.23.0,tests/models/albert/test_modeling_albert.py,309,172,252,2,9,13,14,11,27,30.5293250129808,1.55555555555556,145.296127982767,8.0720071101537,93.404653703207,33,47.1592360181884,0,0
transformers_4.23.0,tests/models/vit/test_modeling_tf_vit.py,244,140,166,6,20,12,22,26,34,101.948336902074,3.3,527.389336375431,29.2994075764128,159.814950416797,26,55.6370813474549,0,0
transformers_4.23.0,tests/models/vit/test_feature_extraction_vit.py,191,71,137,0,0,0,0,0,0,0,0,0,0,0,16,100,0,0
transformers_4.23.0,tests/models/vit/__init__.py,0,0,0,0,0,0,0,0,0,0,0,0,0,0,1,100,0,0
transformers_4.23.0,tests/models/vit/test_modeling_vit.py,302,168,212,6,15,10,15,21,25,74.1131339384547,3,329.423806708407,18.3013225949115,109.807935569469,29,54.08700248237,0,0
transformers_4.23.0,tests/models/vit/test_modeling_flax_vit.py,188,102,134,4,14,7,14,18,21,61.3029689088065,2,175.136850060577,9.7298250033654,87.5684250302886,19,60.5973741380883,0,0
transformers_4.23.0,tests/models/trocr/__init__.py,0,0,0,0,0,0,0,0,0,0,0,0,0,0,1,100,0,0
transformers_4.23.0,tests/models/trocr/test_modeling_trocr.py,192,98,132,4,12,11,19,16,30,51.0195500086539,3.16666666666667,380,21.1111111111111,120,18,62.1859429156597,0,0
transformers_4.23.0,tests/models/qdqbert/test_modeling_qdqbert.py,562,246,465,2,8,14,15,10,29,26,1.875,180.6298401595,10.0349911199722,96.3359147517335,43,42.8585366689365,0,0
transformers_4.23.0,tests/models/qdqbert/__init__.py,0,0,0,0,0,0,0,0,0,0,0,0,0,0,1,100,0,0
transformers_4.23.0,tests/models/phobert/test_tokenization_phobert.py,67,38,37,1,2,1,2,3,3,2,0.5,2.37744375108173,0.13208020839343,4.75488750216347,6,87.9566623776468,0,0
transformers_4.23.0,tests/models/phobert/__init__.py,0,0,0,0,0,0,0,0,0,0,0,0,0,0,1,100,0,0
transformers_4.23.0,tests/models/bort/test_modeling_bort.py,51,21,28,1,6,6,6,7,12,15.5097750043269,0.5,16.8441295323456,0.935784974019201,33.6882590646913,3,89.2976983630154,0,0
transformers_4.23.0,tests/models/bort/__init__.py,0,0,0,0,0,0,0,0,0,0,0,0,0,0,1,100,0,0
transformers_4.23.0,tests/models/bort/test_modeling_tf_bort.py,51,21,26,1,6,6,6,7,12,15.5097750043269,0.5,16.8441295323456,0.935784974019201,33.6882590646913,3,89.254293555947,0,0
transformers_4.23.0,tests/models/plbart/__init__.py,0,0,0,0,0,0,0,0,0,0,0,0,0,0,1,100,0,0
transformers_4.23.0,tests/models/plbart/test_tokenization_plbart.py,360,127,301,4,35,49,92,39,141,187.524905593074,5.25714285714286,3917.84214760463,217.657897089146,745.241712859577,22,45.5805228021941,0,0
transformers_4.23.0,tests/models/plbart/test_modeling_plbart.py,633,358,492,11,51,44,72,62,116,327.347440245557,7.76470588235294,5362.97964144964,297.943313413869,690.686772004878,60,32.4456421557203,0,0
transformers_4.23.0,tests/models/dit/__init__.py,0,0,0,0,0,0,0,0,0,0,0,0,0,0,1,100,0,0
transformers_4.23.0,tests/models/dit/test_modeling_dit.py,61,28,31,1,3,3,3,4,6,4.75488750216347,0.5,6,0.333333333333333,12,4,89.3324454776354,0,0
transformers_4.23.0,tests/models/donut/__init__.py,0,0,0,0,0,0,0,0,0,0,0,0,0,0,1,100,0,0
transformers_4.23.0,tests/models/donut/test_modeling_donut_swin.py,365,202,280,12,53,31,58,65,89,346.599334100503,6.56603773584906,3519.33539443618,195.518633024232,535.990735359532,38,41.5344856173896,0,0
transformers_4.23.0,tests/models/donut/test_feature_extraction_donut.py,203,77,149,0,0,0,0,0,0,0,0,0,0,0,16,100,0,0
transformers_4.23.0,tests/models/tapex/__init__.py,0,0,0,0,0,0,0,0,0,0,0,0,0,0,1,100,0,0
transformers_4.23.0,tests/models/tapex/test_tokenization_tapex.py,906,536,683,13,84,70,133,97,203,585.06037984925,10.2916666666667,13788.592909171,766.032939398391,1339.78230696399,90,24.3602908932297,0,0
transformers_4.23.0,tests/models/xlm_roberta_xl/__init__.py,0,0,0,0,0,0,0,0,0,0,0,0,0,0,1,100,0,0
transformers_4.23.0,tests/models/xlm_roberta_xl/test_modeling_xlm_roberta_xl.py,509,226,404,4,28,31,48,32,79,142.605937817613,3.42857142857143,1354.28571428571,75.2380952380952,395,37,42.8454052096672,0,0
transformers_4.23.0,tests/models/mvp/__init__.py,0,0,0,0,0,0,0,0,0,0,0,0,0,0,1,100,0,0
transformers_4.23.0,tests/models/mvp/test_tokenization_mvp.py,182,107,137,5,15,10,18,20,28,70.2129994085646,3,363.041959970538,20.168997776141,121.013986656846,20,58.8465237300371,0,0
transformers_4.23.0,tests/models/mvp/test_modeling_mvp.py,787,416,631,11,51,46,74,62,120,327.347440245557,7.98039215686275,5702.0185842999,316.778810238883,714.503557246425,67,28.607503898601,0,0
transformers_4.23.0,tests/models/segformer/__init__.py,0,0,0,0,0,0,0,0,0,0,0,0,0,0,1,100,0,0
transformers_4.23.0,tests/models/segformer/test_modeling_segformer.py,424,238,319,7,86,89,114,93,203,572.310253358784,4.63953488372093,6158.74704910834,342.152613839352,1327.44923865493,33,38.1571349093854,0,0
transformers_4.23.0,tests/models/segformer/test_feature_extraction_segformer.py,335,129,255,3,18,13,25,21,38,79.8135375281251,2.08333333333333,347.725129303319,19.3180627390733,166.908062065593,19,55.9143702466775,0,0
transformers_4.23.0,tests/models/segformer/test_modeling_tf_segformer.py,504,291,370,9,99,99,134,108,233,684.835630400862,6.09090909090909,9586.41352693399,532.578529274111,1573.88878800409,42,36.4382249457595,0,0
transformers_4.23.0,tests/models/realm/test_tokenization_realm.py,322,160,239,3,19,11,20,22,31,85.4655102575916,1.57894736842105,218.277442385931,12.1265245769962,138.242380177756,36,47.0244622792415,0,0
transformers_4.23.0,tests/models/realm/__init__.py,0,0,0,0,0,0,0,0,0,0,0,0,0,0,1,100,0,0
transformers_4.23.0,tests/models/realm/test_modeling_realm.py,556,267,454,3,10,9,10,13,19,37.9741684510371,1.5,105.462531967021,5.8590295537234,70.3083546446807,33,43.8512243147345,0,0
transformers_4.23.0,tests/models/realm/test_retrieval_realm.py,187,78,145,2,3,11,12,5,23,6.75488750216347,4,213.617384729637,11.8676324849799,53.4043461824093,12,64.0635379712604,0,0
transformers_4.23.0,tests/models/conditional_detr/test_modeling_conditional_detr.py,542,322,413,8,69,60,81,77,141,445.488187517694,4.69565217391304,4149.15762790009,230.50875710556,883.616902237981,57,32.942400334732,0,0
transformers_4.23.0,tests/models/conditional_detr/test_feature_extraction_conditional_detr.py,342,180,229,5,6,7,13,11,20,27.1194154787637,5.41666666666667,374.771758685707,20.8206532603171,69.188632372746,26,59.4091217631776,0,0
transformers_4.23.0,tests/models/conditional_detr/__init__.py,0,0,0,0,0,0,0,0,0,0,0,0,0,0,1,100,0,0
transformers_4.23.0,tests/models/ibert/__init__.py,0,0,0,0,0,0,0,0,0,0,0,0,0,0,1,100,0,0
transformers_4.23.0,tests/models/ibert/test_modeling_ibert.py,703,433,526,13,133,124,197,146,321,986.458280257492,9.62781954887218,22220.3690345438,1234.46494636354,2307.93368340049,78,27.9114149502381,0,0
transformers_4.23.0,tests/models/reformer/test_modeling_reformer.py,1260,616,1085,10,170,159,236,180,395,1292.81574009228,6.94117647058824,20540.8984011721,1141.16102228734,2959.28197305022,100,13.7364113862242,0,0
transformers_4.23.0,tests/models/reformer/test_tokenization_reformer.py,373,111,294,4,14,21,40,18,61,61.3029689088065,5.71428571428571,1453.51671478846,80.7509285993591,254.365425087981,17,54.2250774625722,0,0
transformers_4.23.0,tests/models/reformer/__init__.py,0,0,0,0,0,0,0,0,0,0,0,0,0,0,1,100,0,0
transformers_4.23.0,tests/models/mobilevit/test_modeling_mobilevit.py,366,201,264,3,28,32,42,31,74,139.360825319776,2.25,824.873685679415,45.8263158710786,366.610526968629,32,45.7670507330694,0,0
transformers_4.23.0,tests/models/mobilevit/__init__.py,0,0,0,0,0,0,0,0,0,0,0,0,0,0,1,100,0,0
transformers_4.23.0,tests/models/mobilevit/test_feature_extraction_mobilevit.py,191,71,137,0,0,0,0,0,0,0,0,0,0,0,16,100,0,0
transformers_4.23.0,tests/models/mobilevit/test_modeling_tf_mobilevit.py,420,240,289,11,67,51,78,78,129,444.481723565681,6.40298507462687,5191.6484208068,288.424912267045,810.81688623323,51,41.9980518953302,0,0
transformers_4.23.0,tests/models/imagegpt/test_modeling_imagegpt.py,552,295,412,10,38,36,69,48,105,232.64052645973,9.07894736842105,5324.08596285852,295.78255349214,586.421062575722,67,35.6925200963515,0,0
transformers_4.23.0,tests/models/imagegpt/__init__.py,0,0,0,0,0,0,0,0,0,0,0,0,0,0,1,100,0,0
transformers_4.23.0,tests/models/imagegpt/test_feature_extraction_imagegpt.py,177,102,121,2,9,6,9,11,15,30.5293250129808,1,51.8914742795595,2.88285968219775,51.8914742795595,20,61.9797313860128,0,0
transformers_4.23.0,tests/models/flaubert/__init__.py,0,0,0,0,0,0,0,0,0,0,0,0,0,0,1,100,0,0
transformers_4.23.0,tests/models/flaubert/test_modeling_tf_flaubert.py,363,157,301,3,10,8,10,13,18,37.9741684510371,1.5,99.9118723898095,5.55065957721164,66.6079149265397,27,49.8889405511798,0,0
transformers_4.23.0,tests/models/flaubert/test_modeling_flaubert.py,448,201,373,5,19,20,26,24,46,92.3202632298649,3.42105263157895,721.528309324014,40.0849060735563,210.908275033173,35,41.2940079927657,0,0
transformers_4.23.0,tests/models/speech_encoder_decoder/test_modeling_speech_encoder_decoder.py,621,271,517,6,31,24,39,37,63,169.08986062632,3.7741935483871,1238.67357284035,68.8151984911308,328.195562034624,44,36.2580060612956,0,0
transformers_4.23.0,tests/models/speech_encoder_decoder/__init__.py,0,0,0,0,0,0,0,0,0,0,0,0,0,0,1,100,0,0
transformers_4.23.0,tests/models/speech_encoder_decoder/test_modeling_flax_speech_encoder_decoder.py,926,475,715,13,46,42,69,59,111,302.189566314457,9.75,6366.49044017185,353.693913342881,652.973378479164,62,28.929476193447,0,0
transformers_4.23.0,tests/models/deberta/test_modeling_deberta.py,290,153,235,1,6,6,6,7,12,15.5097750043269,0.5,16.8441295323456,0.935784974019201,33.6882590646913,28,52.4991326873977,0,0
transformers_4.23.0,tests/models/deberta/__init__.py,0,0,0,0,0,0,0,0,0,0,0,0,0,0,1,100,0,0
transformers_4.23.0,tests/models/deberta/test_tokenization_deberta.py,168,72,123,2,8,4,8,10,12,26,1,39.8631371386484,2.21461872992491,39.8631371386484,14,66.7557594490828,0,0
transformers_4.23.0,tests/models/deberta/test_modeling_tf_deberta.py,282,135,226,1,7,7,7,8,14,19.6514844544032,0.5,21,1.16666666666667,42,24,53.3548769972308,0,0
transformers_4.23.0,tests/models/cvt/__init__.py,0,0,0,0,0,0,0,0,0,0,0,0,0,0,1,100,0,0
transformers_4.23.0,tests/models/cvt/test_modeling_cvt.py,282,166,201,6,22,15,27,28,42,113.617270614347,3.68181818181818,743.391883856362,41.2995491031312,201.908906726419,29,51.0451204299587,0,0
transformers_4.23.0,tests/models/longformer/__init__.py,0,0,0,0,0,0,0,0,0,0,0,0,0,0,1,100,0,0
transformers_4.23.0,tests/models/longformer/test_modeling_longformer.py,709,358,571,8,103,105,138,111,243,712.709554299871,5.35922330097087,8848.30841406542,491.572689670301,1651.04305552308,42,31.181284216763,0,0
transformers_4.23.0,tests/models/longformer/test_tokenization_longformer.py,305,151,221,3,48,34,68,51,102,272.833087536779,2.125,1229.49819287232,68.3054551595734,578.587384881093,18,52.1747759470447,0,0
transformers_4.23.0,tests/models/longformer/test_modeling_tf_longformer.py,700,360,544,8,117,107,144,125,251,827.832672191258,4.92307692307692,8607.56605760091,478.198114311162,1748.41185545018,42,31.2855643745635,0,0
transformers_4.23.0,tests/models/trajectory_transformer/__init__.py,0,0,0,0,0,0,0,0,0,0,0,0,0,0,1,100,0,0
transformers_4.23.0,tests/models/trajectory_transformer/test_modeling_trajectory_transformer.py,275,147,200,5,21,16,23,26,39,103.848306352791,2.73809523809524,501.939812758638,27.8855451532577,183.317149007503,31,50.1360034459988,0,0
transformers_4.23.0,tests/models/mluke/__init__.py,0,0,0,0,0,0,0,0,0,0,0,0,0,0,1,100,0,0
transformers_4.23.0,tests/models/mluke/test_tokenization_mluke.py,676,315,511,3,15,600,604,18,1204,63.3582464362913,60.4,303243.617984887,16846.8676658271,5020.58970173654,29,33.0344661699017,0,0
transformers_4.23.0,tests/models/retribert/test_tokenization_retribert.py,384,194,273,7,27,15,28,34,43,148.033447012817,3.62962962962963,794.021052334405,44.1122806852447,218.760902173765,42,45.5094796483696,0,0
transformers_4.23.0,tests/models/retribert/__init__.py,0,0,0,0,0,0,0,0,0,0,0,0,0,0,1,100,0,0
transformers_4.23.0,tests/models/vit_msn/test_modeling_vit_msn.py,239,140,166,6,13,8,13,19,21,63.6154913401611,3,267.619433346946,14.8677462970525,89.2064777823153,26,56.7574650660091,0,0
transformers_4.23.0,tests/models/vit_msn/__init__.py,0,0,0,0,0,0,0,0,0,0,0,0,0,0,1,100,0,0
transformers_4.23.0,tests/models/levit/test_feature_extraction_levit.py,195,73,141,0,0,0,0,0,0,0,0,0,0,0,16,100,0,0
transformers_4.23.0,tests/models/levit/__init__.py,0,0,0,0,0,0,0,0,0,0,0,0,0,0,1,100,0,0
transformers_4.23.0,tests/models/levit/test_modeling_levit.py,427,238,319,12,67,46,85,79,131,449.447525769325,7.61194029850746,6285.90435501063,349.216908611702,825.795278011201,51,38.715033268151,0,0
transformers_4.23.0,tests/models/barthez/test_tokenization_barthez.py,118,64,75,2,2,2,2,4,4,4,1,8,0.444444444444444,8,9,78.325742048599,0,0
transformers_4.23.0,tests/models/barthez/__init__.py,0,0,0,0,0,0,0,0,0,0,0,0,0,0,1,100,0,0
transformers_4.23.0,tests/models/t5/test_modeling_flax_t5.py,1099,488,845,7,78,58,98,85,156,509.912857525659,4.3974358974359,4396.84218219046,244.269010121692,999.864986037482,82,27.3597386014891,0,0
transformers_4.23.0,tests/models/t5/__init__.py,0,0,0,0,0,0,0,0,0,0,0,0,0,0,1,100,0,0
transformers_4.23.0,tests/models/t5/test_modeling_tf_t5.py,1054,438,796,8,52,43,69,60,112,320.422865343337,5.30769230769231,3511.41927098943,195.078848388302,661.571746708154,61,32.6533749873581,0,0
transformers_4.23.0,tests/models/t5/test_tokenization_t5.py,381,192,282,6,26,29,56,32,85,137.721207675995,6.46153846153846,2746.15384615385,152.564102564103,425,33,45.640502796954,0,0
transformers_4.23.0,tests/models/t5/test_modeling_t5.py,1254,490,1009,7,93,78,124,100,202,627.79325388745,4.66666666666667,6262.94176822764,347.94120934598,1342.05895033449,89,24.2414439645823,0,0
transformers_4.23.0,tests/models/maskformer/test_modeling_maskformer.py,426,239,312,10,81,66,94,91,160,546.747131182528,5.80246913580247,6041.80440670299,335.655800372388,1041.24714243179,43,39.2154843508712,0,0
transformers_4.23.0,tests/models/maskformer/test_feature_extraction_maskformer.py,416,220,311,11,28,21,39,39,60,172.659685622623,7.66071428571429,2429.39737702704,134.966520945947,317.124133131735,45,45.1193904392726,0,0
transformers_4.23.0,tests/models/maskformer/__init__.py,0,0,0,0,0,0,0,0,0,0,0,0,0,0,1,100,0,0
transformers_4.23.0,tests/models/blenderbot/test_modeling_flax_blenderbot.py,417,195,336,7,41,41,66,48,107,239.311116643745,5.63414634146341,3366.91507634939,187.050837574966,597.590987577164,33,40.3263691662469,0,0
transformers_4.23.0,tests/models/blenderbot/test_modeling_blenderbot.py,550,288,417,10,50,42,70,60,112,315.41209043761,7,4631.00222695708,257.277901497616,661.571746708154,50,37.1893389884916,0,0
transformers_4.23.0,tests/models/blenderbot/test_tokenization_blenderbot.py,52,29,28,1,8,4,8,9,12,24,0.5,19.0195500086539,1.05664166714744,38.0391000173078,13,84.482816193915,0,0
transformers_4.23.0,tests/models/blenderbot/__init__.py,0,0,0,0,0,0,0,0,0,0,0,0,0,0,1,100,0,0
transformers_4.23.0,tests/models/blenderbot/test_modeling_tf_blenderbot.py,327,190,246,10,45,35,65,55,100,280.352670283709,7.22222222222222,4175.42645976781,231.968136653767,578.135971352466,50,42.1666345986823,0,0
transformers_4.23.0,tests/models/pegasus_x/test_modeling_pegasus_x.py,860,474,660,14,84,73,119,98,192,590.257632422222,9.91666666666667,12594.4075431954,699.689307955298,1270.02429007012,75,25.8735972033315,0,0
transformers_4.23.0,tests/models/pegasus_x/__init__.py,0,0,0,0,0,0,0,0,0,0,0,0,0,0,1,100,0,0
transformers_4.23.0,tests/models/nezha/__init__.py,0,0,0,0,0,0,0,0,0,0,0,0,0,0,1,100,0,0
transformers_4.23.0,tests/models/nezha/test_modeling_nezha.py,479,231,402,3,14,17,19,17,36,58.0578564109699,2.03571428571429,299.552633937346,16.6418129965192,147.148662285012,42,40.650415049652,0,0
transformers_4.23.0,tests/models/dpr/test_tokenization_dpr.py,88,50,57,2,26,13,26,28,39,124.211432671668,1,187.486841960247,10.4159356644581,187.486841960247,3,71.6404531367886,0,0
transformers_4.23.0,tests/models/dpr/test_modeling_tf_dpr.py,257,122,206,2,7,5,7,9,12,21.6514844544032,1,38.0391000173078,2.11328333429488,38.0391000173078,25,56.8713236503098,0,0
transformers_4.23.0,tests/models/dpr/__init__.py,0,0,0,0,0,0,0,0,0,0,0,0,0,0,1,100,0,0
transformers_4.23.0,tests/models/dpr/test_modeling_dpr.py,311,153,249,2,27,25,27,29,52,130.381962558414,1,252.615011746634,14.0341673192574,252.615011746634,28,47.592310608828,0,0
transformers_4.23.0,tests/models/nystromformer/__init__.py,0,0,0,0,0,0,0,0,0,0,0,0,0,0,1,100,0,0
transformers_4.23.0,tests/models/nystromformer/test_modeling_nystromformer.py,313,166,250,1,7,12,12,8,24,19.6514844544032,0.857142857142857,61.7142857142857,3.42857142857143,72,30,48.3003348188531,0,0
transformers_4.23.0,tests/models/wavlm/test_modeling_wavlm.py,585,331,422,13,107,87,126,120,213,769.442683880757,7.65420560747664,11260.6200348796,625.590001937757,1471.16769686461,71,32.5904808318219,0,0
transformers_4.23.0,tests/models/wavlm/__init__.py,0,0,0,0,0,0,0,0,0,0,0,0,0,0,1,100,0,0
transformers_4.23.0,tests/models/x_clip/test_modeling_x_clip.py,672,408,517,13,42,26,48,55,74,274.583048092542,7.42857142857143,3178.09602537756,176.560890298753,427.820618800825,86,28.6351725309925,0,0
transformers_4.23.0,tests/models/x_clip/__init__.py,0,0,0,0,0,0,0,0,0,0,0,0,0,0,1,100,0,0
transformers_4.23.0,tests/models/sew/test_modeling_sew.py,561,316,405,12,115,92,134,127,226,830.250905867257,6.99130434782609,11042.3648897848,613.464716099155,1579.44273921051,70,31.7556566313754,0,0
transformers_4.23.0,tests/models/sew/__init__.py,0,0,0,0,0,0,0,0,0,0,0,0,0,0,1,100,0,0
transformers_4.23.0,tests/models/clip/test_modeling_flax_clip.py,587,370,428,7,27,16,29,34,45,148.033447012817,3.75925925925926,860.629130644849,47.8127294802694,228.935827856265,70,34.9671123653605,0,0
transformers_4.23.0,tests/models/clip/test_modeling_tf_clip.py,660,380,485,9,65,42,76,74,118,419.98323285983,5.26153846153846,3855.21076958957,214.178376088309,732.715497144216,77,31.5092108429632,0,0
transformers_4.23.0,tests/models/clip/__init__.py,0,0,0,0,0,0,0,0,0,0,0,0,0,0,1,100,0,0
transformers_4.23.0,tests/models/clip/test_feature_extraction_clip.py,294,125,216,3,6,6,8,9,14,20.2646625064904,2,88.7579000403848,4.93099444668804,44.3789500201924,33,59.7060857891423,0,0
transformers_4.23.0,tests/models/clip/test_modeling_clip.py,674,399,490,13,42,23,43,55,66,274.583048092542,6.65476190476191,2539.25577703308,141.069765390727,381.569741092628,91,30.9177682970876,0,0
transformers_4.23.0,tests/models/clip/test_processor_clip.py,189,112,119,2,3,2,3,5,5,6.75488750216347,1,11.6096404744368,0.644980026357601,11.6096404744368,17,67.0926546520455,0,0
transformers_4.23.0,tests/models/clip/test_tokenization_clip.py,186,93,124,1,20,13,26,21,39,86.4385618977473,0.65,111.345246667442,6.18584703708009,171.300379488372,15,66.8622498597729,0,0
transformers_4.23.0,tests/models/squeezebert/__init__.py,0,0,0,0,0,0,0,0,0,0,0,0,0,0,1,100,0,0
transformers_4.23.0,tests/models/squeezebert/test_modeling_squeezebert.py,286,150,234,1,3,6,6,4,12,4.75488750216347,1,24,1.33333333333333,24,26,53.5627128134099,0,0
transformers_4.23.0,tests/models/squeezebert/test_tokenization_squeezebert.py,46,19,21,2,15,8,16,17,24,60.6033589341278,1.06666666666667,104.639048736009,5.81328048533382,98.0991081900082,5,86.5129404771989,0,0
transformers_4.23.0,tests/models/herbert/__init__.py,0,0,0,0,0,0,0,0,0,0,0,0,0,0,1,100,0,0
transformers_4.23.0,tests/models/herbert/test_tokenization_herbert.py,128,63,88,3,18,10,19,21,29,79.8135375281251,1.58333333333333,201.680574995925,11.2044763886625,127.377205260584,9,66.8715537044767,0,0
transformers_4.23.0,tests/models/big_bird/test_modeling_flax_big_bird.py,223,102,168,0,0,0,0,0,0,0,0,0,0,0,22,100,0,0
transformers_4.23.0,tests/models/big_bird/__init__.py,0,0,0,0,0,0,0,0,0,0,0,0,0,0,1,100,0,0
transformers_4.23.0,tests/models/big_bird/test_modeling_big_bird.py,936,397,769,8,341,344,359,349,703,2893.04712379724,4.21114369501466,25007.0325323298,1389.27958512943,5938.29950802539,64,22.6105298044338,0,0
transformers_4.23.0,tests/models/big_bird/test_tokenization_big_bird.py,237,99,160,5,19,24,46,24,70,92.3202632298649,6.05263157894737,1942.57621741081,107.920900967267,320.947375050481,15,60.7715396091439,0,0
transformers_4.23.0,tests/models/openai/test_modeling_tf_openai.py,285,146,226,3,7,5,10,10,15,24.4063719565667,2.14285714285714,106.776260192808,5.932014455156,49.8289214233104,32,54.5479954877805,0,0
transformers_4.23.0,tests/models/openai/test_modeling_openai.py,267,130,211,2,4,2,4,6,6,10,1,15.5097750043269,0.861654166907052,15.5097750043269,25,60.9978704466741,0,0
transformers_4.23.0,tests/models/openai/__init__.py,0,0,0,0,0,0,0,0,0,0,0,0,0,0,1,100,0,0
transformers_4.23.0,tests/models/openai/test_tokenization_openai.py,144,58,93,1,2,1,2,3,3,2,0.5,2.37744375108173,0.13208020839343,4.75488750216347,7,80.92383581295,0,0
transformers_4.23.0,tests/models/mbart/test_modeling_mbart.py,668,361,523,11,51,44,72,62,116,327.347440245557,7.76470588235294,5362.97964144964,297.943313413869,690.686772004878,62,32.0187544427629,0,0
transformers_4.23.0,tests/models/mbart/test_modeling_tf_mbart.py,345,205,266,9,41,30,59,50,89,248.188957202322,6.47560975609756,3252.719508202,180.706639344555,502.303200889951,52,41.3097771483669,0,0
transformers_4.23.0,tests/models/mbart/__init__.py,0,0,0,0,0,0,0,0,0,0,0,0,0,0,1,100,0,0
transformers_4.23.0,tests/models/mbart/test_tokenization_mbart.py,327,149,240,7,29,35,63,36,98,160.532933313103,7.60344827586207,3852.30721917817,214.017067732121,506.652650141347,32,50.1487379967439,0,0
transformers_4.23.0,tests/models/mbart/test_modeling_flax_mbart.py,464,221,378,6,39,40,64,45,104,221.640461539955,4.92307692307692,2811.82878532079,156.2127102956,571.152722018286,38,37.8602482914131,0,0
transformers_4.23.0,tests/models/xglm/test_modeling_flax_xglm.py,347,206,260,4,26,38,53,30,91,130.211432671668,4.07692307692308,1820.45641097076,101.136467276153,446.527044200375,32,44.7724535126665,0,0
transformers_4.23.0,tests/models/xglm/__init__.py,0,0,0,0,0,0,0,0,0,0,0,0,0,0,1,100,0,0
transformers_4.23.0,tests/models/xglm/test_tokenization_xglm.py,205,84,151,2,13,21,41,15,62,50.1057163358342,3.15384615384615,763.947376464373,42.4415209146874,242.227216927728,15,59.3305852332707,0,0
transformers_4.23.0,tests/models/xglm/test_modeling_tf_xglm.py,284,146,214,4,10,8,14,14,22,41.2192809488736,2.8,234.533063198748,13.0296146221527,83.7618082852673,28,53.2300703758581,0,0
transformers_4.23.0,tests/models/xglm/test_modeling_xglm.py,489,279,357,9,38,35,58,47,93,227.950570523837,6.86842105263158,3548.06671570451,197.114817539139,516.57676320602,42,40.0954600318332,0,0
transformers_4.23.0,tests/models/pegasus/test_modeling_tf_pegasus.py,374,216,281,10,45,35,65,55,100,280.352670283709,7.22222222222222,4175.42645976781,231.968136653767,578.135971352466,53,41.1801499650285,0,0
transformers_4.23.0,tests/models/pegasus/__init__.py,0,0,0,0,0,0,0,0,0,0,0,0,0,0,1,100,0,0
transformers_4.23.0,tests/models/pegasus/test_tokenization_pegasus.py,215,120,137,4,32,21,40,36,61,168,2.5,788.413562719953,43.8007534844418,315.365425087981,36,57.4070274249909,0,0
transformers_4.23.0,tests/models/pegasus/test_modeling_pegasus.py,562,287,433,10,54,44,74,64,118,343.983206065701,6.85185185185185,4851.11111111111,269.506172839506,708,53,36.3328607547327,0,0
transformers_4.23.0,tests/models/pegasus/test_modeling_flax_pegasus.py,338,160,264,6,32,34,52,38,86,175.509775004327,4.875,2200.19361001122,122.232978333957,451.321766156148,26,44.5114195588863,0,0
transformers_4.23.0,tests/models/layoutlm/test_tokenization_layoutlm.py,74,32,45,1,2,1,2,3,3,2,0.5,2.37744375108173,0.13208020839343,4.75488750216347,7,88.2410911079749,0,0
transformers_4.23.0,tests/models/layoutlm/__init__.py,0,0,0,0,0,0,0,0,0,0,0,0,0,0,1,100,0,0
transformers_4.23.0,tests/models/layoutlm/test_modeling_layoutlm.py,375,182,279,2,13,27,29,15,56,50.1057163358342,2.23076923076923,488.060794405249,27.1144885780694,218.785873354077,32,50.8692421392384,0,0
transformers_4.23.0,tests/models/layoutlm/test_modeling_tf_layoutlm.py,358,176,261,2,13,27,29,15,56,50.1057163358342,2.23076923076923,488.060794405249,27.1144885780694,218.785873354077,32,51.3226793843691,0,0
transformers_4.23.0,tests/models/convbert/__init__.py,0,0,0,0,0,0,0,0,0,0,0,0,0,0,1,100,0,0
transformers_4.23.0,tests/models/convbert/test_modeling_tf_convbert.py,410,228,335,4,21,17,23,25,40,100.238665878354,2.19047619047619,406.890256627881,22.6050142571045,185.754247590989,33,41.0313453915977,0,0
transformers_4.23.0,tests/models/convbert/test_modeling_convbert.py,457,253,375,8,31,37,54,39,91,177.580085621993,6.96774193548387,3351.28600045021,186.182555580567,480.971601916465,46,37.2461259414346,0,0
transformers_4.23.0,tests/models/gpt2/test_modeling_gpt2.py,765,400,594,10,59,62,98,69,160,380.295220861222,8.30508474576271,8117.09012561709,450.949451423172,977.363913084507,61,29.884278194604,0,0
transformers_4.23.0,tests/models/gpt2/test_tokenization_gpt2.py,331,168,223,6,31,25,44,37,69,169.08986062632,4.25806451612903,1530.57100819834,85.0317226776854,359.452282228398,25,54.340852631287,0,0
transformers_4.23.0,tests/models/gpt2/test_modeling_tf_gpt2.py,665,358,496,8,28,31,48,36,79,158.605937817613,6.85714285714286,2800.62222935275,155.590123852931,408.424075113943,50,37.3110960531279,0,0
transformers_4.23.0,tests/models/gpt2/__init__.py,0,0,0,0,0,0,0,0,0,0,0,0,0,0,1,100,0,0
transformers_4.23.0,tests/models/gpt2/test_modeling_flax_gpt2.py,337,203,252,4,28,41,59,32,100,142.605937817613,4.21428571428571,2107.14285714286,117.063492063492,500,32,43.9111731510461,0,0
transformers_4.23.0,tests/models/vision_text_dual_encoder/test_modeling_flax_vision_text_dual_encoder.py,395,216,278,5,15,11,18,20,29,70.2129994085646,3,376.007744255201,20.8893191252889,125.335914751734,33,46.6691979457257,0,0
transformers_4.23.0,tests/models/vision_text_dual_encoder/__init__.py,0,0,0,0,0,0,0,0,0,0,0,0,0,0,1,100,0,0
transformers_4.23.0,tests/models/vision_text_dual_encoder/test_modeling_vision_text_dual_encoder.py,527,285,391,5,22,19,30,27,49,109.717136084457,3.40909090909091,794.282344111398,44.1267968950777,232.98948760601,40,38.8537603032722,0,0
transformers_4.23.0,tests/models/vision_text_dual_encoder/test_processor_vision_text_dual_encoder.py,170,94,102,2,3,2,3,5,5,6.75488750216347,1,11.6096404744368,0.644980026357601,11.6096404744368,17,70.0161471298386,0,0
transformers_4.23.0,tests/models/rag/__init__.py,0,0,0,0,0,0,0,0,0,0,0,0,0,0,1,100,0,0
transformers_4.23.0,tests/models/rag/test_retrieval_rag.py,380,213,329,5,32,23,36,37,59,171.609640474437,2.8125,864.443667859054,48.0246482143919,307.357748572108,25,44.512875631491,0,0
transformers_4.23.0,tests/models/rag/test_modeling_rag.py,1190,479,945,6,47,27,56,53,83,276.575451033176,3.57446808510638,1699.36431528573,94.4091286269849,475.417397728746,66,28.1551184910148,0,0
transformers_4.23.0,tests/models/rag/test_modeling_tf_rag.py,1077,421,861,4,32,17,37,36,54,168,2.3125,645.594384555109,35.866354697506,279.175950077885,58,29.529186609928,0,0
transformers_4.23.0,tests/models/rag/test_tokenization_rag.py,169,70,138,2,6,3,7,8,10,17.5097750043269,1.16666666666667,35,1.94444444444444,30,12,66.2513945765571,0,0
transformers_4.23.0,tests/models/megatron_bert/__init__.py,0,0,0,0,0,0,0,0,0,0,0,0,0,0,1,100,0,0
transformers_4.23.0,tests/models/megatron_bert/test_modeling_megatron_bert.py,380,196,314,4,16,17,21,20,38,72,2.625,431.112327465014,23.9506848591675,164.23326760572,36,42.825266692128,0,0
transformers_4.23.0,tests/models/data2vec/test_modeling_data2vec_audio.py,743,431,538,14,105,73,130,119,203,758.298748263749,8.66666666666667,12130.2827182464,673.904595458136,1399.64800595151,93,25.6982305860924,0,0
transformers_4.23.0,tests/models/data2vec/__init__.py,0,0,0,0,0,0,0,0,0,0,0,0,0,0,1,100,0,0
transformers_4.23.0,tests/models/data2vec/test_modeling_tf_data2vec_vision.py,495,270,366,12,54,35,65,66,100,353.783475125481,7.22222222222222,4365.39575286999,242.521986270555,604.439411935845,60,38.6630670430457,0,0
transformers_4.23.0,tests/models/data2vec/test_modeling_data2vec_text.py,506,233,403,4,31,34,51,35,85,161.580085621993,3.29032258064516,1434.54463731977,79.6969242955428,435.989056440322,39,41.1861211030938,0,0
transformers_4.23.0,tests/models/data2vec/test_modeling_data2vec_vision.py,351,199,260,11,35,23,42,46,65,217.578653398084,6.6,2369.60807914846,131.644893286025,359.031527143706,46,44.697433249402,0,0
transformers_4.23.0,tests/models/luke/test_tokenization_luke.py,668,333,506,3,15,508,513,18,1021,63.3582464362913,51.3,218409.412778044,12133.8562654469,4257.4934264726,29,33.8349462265578,0,0
transformers_4.23.0,tests/models/luke/__init__.py,0,0,0,0,0,0,0,0,0,0,0,0,0,0,1,100,0,0
transformers_4.23.0,tests/models/luke/test_modeling_luke.py,908,364,776,7,32,47,61,39,108,179.651484454403,6.671875,3808.46263632893,211.581257573829,570.823439637123,60,28.1627391989024,0,0
transformers_4.23.0,tests/models/bloom/test_tokenization_bloom.py,136,67,78,0,0,0,0,0,0,0,0,0,0,0,9,100,0,0
transformers_4.23.0,tests/models/bloom/__init__.py,0,0,0,0,0,0,0,0,0,0,0,0,0,0,1,100,0,0
transformers_4.23.0,tests/models/bloom/test_modeling_bloom.py,794,361,593,9,79,110,126,88,236,526.528004118972,7.17721518987342,10941.1324525708,607.84069180949,1524.4258619984,52,35.094866908788,0,0
transformers_4.23.0,tests/models/vision_encoder_decoder/test_modeling_flax_vision_encoder_decoder.py,521,263,384,9,49,44,65,58,109,303.650107374626,5.96938775510204,3811.57304239091,211.754057910606,638.519928468905,43,38.4745856144754,0,0
transformers_4.23.0,tests/models/vision_encoder_decoder/test_modeling_vision_encoder_decoder.py,1002,491,786,8,88,96,122,96,218,592.429982440082,5.54545454545455,7960.62103041727,442.25672391207,1435.52182515721,52,28.1539085059993,0,0
transformers_4.23.0,tests/models/vision_encoder_decoder/__init__.py,0,0,0,0,0,0,0,0,0,0,0,0,0,0,1,100,0,0
transformers_4.23.0,tests/models/vision_encoder_decoder/test_modeling_tf_vision_encoder_decoder.py,991,472,701,11,79,63,100,90,163,536.052426911001,6.9620253164557,7367.02063399943,409.27892411108,1058.17205470174,78,30.4557766305481,0,0
transformers_4.23.0,tests/models/dpt/test_feature_extraction_dpt.py,188,69,135,0,0,0,0,0,0,0,0,0,0,0,15,100,0,0
transformers_4.23.0,tests/models/dpt/__init__.py,0,0,0,0,0,0,0,0,0,0,0,0,0,0,1,100,0,0
transformers_4.23.0,tests/models/dpt/test_modeling_dpt.py,321,195,229,8,21,11,21,29,32,116.238665878354,4,621.821567376329,34.5456426320183,155.455391844082,37,48.5193274194595,0,0
transformers_4.23.0,tests/models/deberta_v2/test_modeling_deberta_v2.py,308,161,252,1,6,11,11,7,22,15.5097750043269,0.916666666666667,56.6149909281617,3.14527727378676,61.7618082852673,29,49.5812658039106,0,0
transformers_4.23.0,tests/models/deberta_v2/__init__.py,0,0,0,0,0,0,0,0,0,0,0,0,0,0,1,100,0,0
transformers_4.23.0,tests/models/deberta_v2/test_modeling_tf_deberta_v2.py,278,135,222,1,5,5,5,6,10,11.6096404744368,0.5,12.9248125036058,0.71804513908921,25.8496250072116,24,54.9483672599128,0,0
transformers_4.23.0,tests/models/deberta_v2/test_tokenization_deberta_v2.py,250,150,155,2,12,7,13,14,20,45.0195500086539,1.08333333333333,82.4926899779148,4.58292722099526,76.1470984411521,16,60.8418818935568,0,0
transformers_4.23.0,tests/models/yoso/__init__.py,0,0,0,0,0,0,0,0,0,0,0,0,0,0,1,100,0,0
transformers_4.23.0,tests/models/yoso/test_modeling_yoso.py,405,202,329,1,20,25,25,21,50,86.4385618977473,0.625,137.259919461836,7.62555108121313,219.615871138938,35,40.7282361896379,0,0
transformers_4.23.0,tests/models/poolformer/test_modeling_poolformer.py,253,147,178,4,11,9,13,15,22,46.0537478050103,2.36363636363636,203.158310971643,11.2865728317579,85.9515931033874,27,54.2618571016134,0,0
transformers_4.23.0,tests/models/poolformer/test_feature_extraction_poolformer.py,193,72,139,0,0,0,0,0,0,0,0,0,0,0,16,100,0,0
transformers_4.23.0,tests/models/poolformer/__init__.py,0,0,0,0,0,0,0,0,0,0,0,0,0,0,1,100,0,0
transformers_4.23.0,tests/models/opt/__init__.py,0,0,0,0,0,0,0,0,0,0,0,0,0,0,1,100,0,0
transformers_4.23.0,tests/models/opt/test_modeling_flax_opt.py,406,179,285,7,68,74,94,75,168,433.598957659426,4.83823529411765,5062.93039207483,281.273910670824,1046.44154000331,26,48.3585862960742,0,0
transformers_4.23.0,tests/models/opt/test_modeling_opt.py,492,272,376,8,62,60,74,70,134,393.160171243986,4.7741935483871,3921.15938038879,217.842187799377,821.323924270626,43,36.6140704374065,0,0
transformers_4.23.0,tests/models/opt/test_modeling_tf_opt.py,415,230,307,9,71,66,88,80,154,465.161370497813,5.57746478873239,5430.09102730438,301.671723739132,973.576926612654,38,39.3037239444338,0,0
transformers_4.23.0,tests/models/wav2vec2_conformer/__init__.py,0,0,0,0,0,0,0,0,0,0,0,0,0,0,1,100,0,0
transformers_4.23.0,tests/models/wav2vec2_conformer/test_modeling_wav2vec2_conformer.py,939,526,679,15,154,112,196,169,308,1177.68848620114,9.54545454545455,21758.5855426696,1208.81030792609,2279.47086637491,107,21.1134773784712,0,0
transformers_4.23.0,tests/models/bigbird_pegasus/test_modeling_bigbird_pegasus.py,789,407,596,11,107,92,138,118,230,759.390715349933,7.09345794392523,11228.9999731504,623.833331841691,1583.00790135322,62,30.2006896372217,0,0
transformers_4.23.0,tests/models/bigbird_pegasus/__init__.py,0,0,0,0,0,0,0,0,0,0,0,0,0,0,1,100,0,0
transformers_4.23.0,tests/models/deit/test_modeling_tf_deit.py,282,149,199,7,13,8,14,20,22,67.7572007902374,3.76923076923077,358.387575868352,19.9104208815751,95.082418087522,31,54.4829016403758,0,0
transformers_4.23.0,tests/models/deit/__init__.py,0,0,0,0,0,0,0,0,0,0,0,0,0,0,1,100,0,0
transformers_4.23.0,tests/models/deit/test_modeling_deit.py,396,217,291,11,38,22,39,49,61,237.474993315867,5.64473684210526,1933.3071304033,107.405951689072,342.497300491028,50,43.1069532737484,0,0
transformers_4.23.0,tests/models/deit/test_feature_extraction_deit.py,199,75,145,0,0,0,0,0,0,0,0,0,0,0,16,100,0,0
transformers_4.23.0,tests/models/whisper/test_processor_whisper.py,118,67,69,0,0,0,0,0,0,0,0,0,0,0,13,100,0,0
transformers_4.23.0,tests/models/whisper/test_tokenization_whisper.py,190,97,126,3,6,4,7,9,11,20.2646625064904,1.75,61.0210562777645,3.39005868209803,34.8691750158654,17,67.2083331974644,0,0
transformers_4.23.0,tests/models/whisper/__init__.py,0,0,0,0,0,0,0,0,0,0,0,0,0,0,1,100,0,0
transformers_4.23.0,tests/models/whisper/test_feature_extraction_whisper.py,225,133,157,7,42,34,45,49,79,246.128816211111,3.75,1663.35779131913,92.4087661843961,443.562077685102,32,52.0131569573077,0,0
transformers_4.23.0,tests/models/whisper/test_modeling_whisper.py,1042,554,777,14,141,127,187,155,314,1059.97970959704,9.28368794326241,21210.4702822855,1178.35946012697,2284.70306325611,87,23.1621151368926,0,0
transformers_4.23.0,tests/models/whisper/test_modeling_tf_whisper.py,983,490,714,14,121,104,140,135,244,890.485420619032,8.09917355371901,13985.191285676,776.955071426444,1726.7430056804,69,28.5370127792992,0,0
transformers_4.23.0,tests/models/splinter/__init__.py,0,0,0,0,0,0,0,0,0,0,0,0,0,0,1,100,0,0
transformers_4.23.0,tests/models/splinter/test_modeling_splinter.py,493,234,390,2,5,5,8,7,13,13.6096404744368,1.6,58.3929823787982,3.2440545765999,36.4956139867489,42,49.5475005815673,0,0
transformers_4.23.0,tests/models/nllb/__init__.py,0,0,0,0,0,0,0,0,0,0,0,0,0,0,1,100,0,0
transformers_4.23.0,tests/models/nllb/test_tokenization_nllb.py,428,180,331,6,24,31,58,30,89,125.548875021635,7.25,3166.1711568164,175.898397600911,436.713263009158,34,45.9880542945891,0,0
transformers_4.23.0,tests/models/visual_bert/test_modeling_visual_bert.py,690,373,548,8,91,88,131,99,219,616.209312258081,5.75824175824176,8359.98294828413,464.443497126896,1451.82909979743,75,23.4671048797254,0,0
transformers_4.23.0,tests/models/visual_bert/__init__.py,0,0,0,0,0,0,0,0,0,0,0,0,0,0,1,100,0,0
transformers_4.23.0,tests/models/distilbert/test_modeling_distilbert.py,293,163,237,2,6,8,9,8,17,17.5097750043269,1.5,76.5,4.25,51,29,50.4477342248719,0,0
transformers_4.23.0,tests/models/distilbert/__init__.py,0,0,0,0,0,0,0,0,0,0,0,0,0,0,1,100,0,0
transformers_4.23.0,tests/models/distilbert/test_tokenization_distilbert.py,43,17,19,2,15,8,16,17,24,60.6033589341278,1.06666666666667,104.639048736009,5.81328048533382,98.0991081900082,4,87.2856935820907,0,0
transformers_4.23.0,tests/models/distilbert/test_modeling_tf_distilbert.py,247,141,192,1,3,3,3,4,6,4.75488750216347,0.5,6,0.333333333333333,12,25,57.717992807654,0,0
transformers_4.23.0,tests/models/distilbert/test_modeling_flax_distilbert.py,152,67,118,1,3,3,3,4,6,4.75488750216347,0.5,6,0.333333333333333,12,11,69.6917336443761,0,0
transformers_4.23.0,tests/models/xlnet/test_modeling_tf_xlnet.py,504,211,383,8,43,28,52,51,80,257.32938445219,4.83720930232558,2195.09669047455,121.949816137475,453.79402735772,44,45.7390495904191,0,0
transformers_4.23.0,tests/models/xlnet/test_modeling_xlnet.py,716,283,574,10,70,53,100,80,153,462.269092135021,7.14285714285714,6908.9642751269,383.831348618161,967.254998517766,62,35.1693698380877,0,0
transformers_4.23.0,tests/models/xlnet/test_tokenization_xlnet.py,212,65,166,3,41,43,85,44,128,224.414519691505,3.10975609756098,2173.12009795514,120.728894330841,698.807247185574,12,57.3613815434146,0,0
transformers_4.23.0,tests/models/xlnet/__init__.py,0,0,0,0,0,0,0,0,0,0,0,0,0,0,1,100,0,0
transformers_4.23.0,tests/models/time_series_transformer/test_modeling_time_series_transformer.py,438,220,345,5,33,31,46,38,77,178.074646413266,3.48484848484848,1408.19388277403,78.232993487446,404.090418535156,31,41.6785821131187,0,0
transformers_4.23.0,tests/models/time_series_transformer/__init__.py,0,0,0,0,0,0,0,0,0,0,0,0,0,0,1,100,0,0
transformers_4.23.0,tests/models/deformable_detr/test_modeling_deformable_detr.py,625,373,476,12,79,62,96,91,158,541.018229114645,7.29113924050633,7496.9794255089,416.498856972717,1028.23155315139,60,30.1174866592314,0,0
transformers_4.23.0,tests/models/deformable_detr/test_feature_extraction_deformable_detr.py,341,180,229,5,6,7,13,11,20,27.1194154787637,5.41666666666667,374.771758685707,20.8206532603171,69.188632372746,26,59.2685028494106,0,0
transformers_4.23.0,tests/models/deformable_detr/__init__.py,0,0,0,0,0,0,0,0,0,0,0,0,0,0,1,100,0,0
transformers_4.23.0,tests/models/groupvit/test_modeling_groupvit.py,696,431,525,13,34,21,39,47,60,221.079452938346,7.45588235294118,2484.86165982403,138.047869990224,333.275331100658,87,28.634086418841,0,0
transformers_4.23.0,tests/models/groupvit/__init__.py,0,0,0,0,0,0,0,0,0,0,0,0,0,0,1,100,0,0
transformers_4.23.0,tests/models/groupvit/test_modeling_tf_groupvit.py,715,408,524,12,49,35,61,61,96,318.140332370299,7.46938775510204,4252.7017774002,236.261209855566,569.350784406037,84,31.1909555812557,0,0
transformers_4.23.0,tests/models/ernie/test_modeling_ernie.py,577,253,488,3,9,13,16,12,29,33.2842125151443,2.66666666666667,277.237100055769,15.4020611142094,103.963912520914,49,40.0815632645032,0,0
transformers_4.23.0,tests/models/ernie/__init__.py,0,0,0,0,0,0,0,0,0,0,0,0,0,0,1,100,0,0
transformers_4.23.0,tests/models/yolos/test_modeling_yolos.py,371,217,269,7,32,24,36,39,60,179.651484454403,3.9375,1248.67627420621,69.370904122567,317.124133131735,35,45.9741046090269,0,0
transformers_4.23.0,tests/models/yolos/__init__.py,0,0,0,0,0,0,0,0,0,0,0,0,0,0,1,100,0,0
transformers_4.23.0,tests/models/yolos/test_feature_extraction_yolos.py,338,179,226,5,6,7,13,11,20,27.1194154787637,5.41666666666667,374.771758685707,20.8206532603171,69.188632372746,26,59.4242769887107,0,0
transformers_4.23.0,tests/models/xlm_prophetnet/test_tokenization_xlm_prophetnet.py,156,53,114,2,14,23,43,16,66,55.3029689088065,3.07142857142857,810.857142857143,45.0476190476191,264,11,65.3965222519422,0,0
transformers_4.23.0,tests/models/xlm_prophetnet/__init__.py,0,0,0,0,0,0,0,0,0,0,0,0,0,0,1,100,0,0
transformers_4.23.0,tests/models/xlm_prophetnet/test_modeling_xlm_prophetnet.py,153,70,115,1,21,21,21,22,42,92.238665878354,0.5,93.6480639913832,5.20267022174351,187.296127982766,7,64.2713034671368,0,0
transformers_4.23.0,tests/models/wav2vec2_with_lm/test_processor_wav2vec2_with_lm.py,454,265,315,6,24,20,30,30,50,125.548875021635,3.75,920.041986676597,51.1134437042554,245.344529780426,38,43.4678478049126,0,0
transformers_4.23.0,tests/models/wav2vec2_with_lm/__init__.py,0,0,0,0,0,0,0,0,0,0,0,0,0,0,1,100,0,0
transformers_4.23.0,tests/models/funnel/test_modeling_tf_funnel.py,412,193,338,2,5,3,5,7,8,13.6096404744368,1,22.4588393764608,1.24771329869227,22.4588393764608,35,50.4122725154506,0,0
transformers_4.23.0,tests/models/funnel/__init__.py,0,0,0,0,0,0,0,0,0,0,0,0,0,0,1,100,0,0
transformers_4.23.0,tests/models/funnel/test_tokenization_funnel.py,83,39,53,3,14,8,16,17,24,58.0578564109699,1.71428571428571,168.1698997543,9.34277220857221,98.0991081900082,9,75.7144056765841,0,0
transformers_4.23.0,tests/models/funnel/test_modeling_funnel.py,512,252,425,9,51,36,65,60,101,317.823017453527,5.73529411764706,3421.65324354441,190.091846863578,596.59595015646,58,34.2022656733342,0,0
transformers_4.23.0,tests/models/flava/test_feature_extraction_flava.py,347,144,267,3,8,7,11,11,18,28.7548875021635,2.0625,128.43139884191,7.13507771343943,62.2697691354714,27,55.6940114582177,0,0
transformers_4.23.0,tests/models/flava/__init__.py,0,0,0,0,0,0,0,0,0,0,0,0,0,0,1,100,0,0
transformers_4.23.0,tests/models/flava/test_processor_flava.py,234,115,157,2,3,2,3,5,5,6.75488750216347,1,11.6096404744368,0.644980026357601,11.6096404744368,19,65.134231745844,0,0
transformers_4.23.0,tests/models/flava/test_modeling_flava.py,1228,685,959,16,85,58,107,101,165,608.798229571705,10.0705882352941,11063.5975273396,614.644307074421,1098.60489465405,152,11.8335589982974,0,0
transformers_4.23.0,tests/models/bart/test_modeling_tf_bart.py,924,225,835,7,48,37,59,55,96,287.729684489019,4.30208333333333,2387.70156168568,132.650086760316,555.010532498367,49,32.9450373301511,0,0
transformers_4.23.0,tests/models/bart/test_modeling_bart.py,1422,503,1229,12,70,61,94,82,155,472.069361194802,8.05714285714286,7939.67423205304,441.093012891836,985.420560715803,86,20.2949398747876,0,0
transformers_4.23.0,tests/models/bart/test_tokenization_bart.py,183,108,138,5,15,10,18,20,28,70.2129994085646,3,363.041959970538,20.168997776141,121.013986656846,20,58.6996144109001,0,0
transformers_4.23.0,tests/models/bart/__init__.py,0,0,0,0,0,0,0,0,0,0,0,0,0,0,1,100,0,0
transformers_4.23.0,tests/models/bart/test_modeling_flax_bart.py,764,257,661,7,45,43,70,52,113,266.784873789239,5.44444444444444,3507.03719103858,194.835399502143,644.149688149944,43,32.7695079786315,0,0
transformers_4.23.0,tests/models/gptj/test_modeling_flax_gptj.py,328,199,246,4,28,41,59,32,100,142.605937817613,4.21428571428571,2107.14285714286,117.063492063492,500,31,44.4155522518272,0,0
transformers_4.23.0,tests/models/gptj/__init__.py,0,0,0,0,0,0,0,0,0,0,0,0,0,0,1,100,0,0
transformers_4.23.0,tests/models/gptj/test_modeling_tf_gptj.py,446,251,322,7,30,33,51,37,84,166.858202322659,5.95,2603.68479214135,144.649155118964,437.594082712832,39,44.1849786625407,0,0
transformers_4.23.0,tests/models/gptj/test_modeling_gptj.py,574,307,434,7,37,42,67,44,109,212.401258982674,6.33783783783784,3771.50815913996,209.528231063331,595.078046431465,41,38.7253396105894,0,0
transformers_4.23.0,tests/models/longt5/__init__.py,0,0,0,0,0,0,0,0,0,0,0,0,0,0,1,100,0,0
transformers_4.23.0,tests/models/longt5/test_modeling_longt5.py,1319,643,1074,11,86,108,174,97,282,590.712516709391,11.1279069767442,20710.9869578187,1150.61038654548,1861.17542149677,113,16.051004012173,0,0
transformers_4.23.0,tests/models/longt5/test_modeling_flax_longt5.py,757,387,591,8,53,46,78,61,124,327.57978409185,5.88679245283019,4329.21445501194,240.51191416733,735.411429857798,64,31.447083780546,0,0
transformers_4.23.0,tests/models/prophetnet/test_tokenization_prophetnet.py,206,106,144,2,13,7,14,15,21,50.1057163358342,1.07692307692308,88.3558334699157,4.90865741499532,82.0447025077789,23,56.9284967272063,0,0
transformers_4.23.0,tests/models/prophetnet/__init__.py,0,0,0,0,0,0,0,0,0,0,0,0,0,0,1,100,0,0
transformers_4.23.0,tests/models/prophetnet/test_modeling_prophetnet.py,1304,596,1070,10,65,69,98,75,167,424.673188795723,7.53846153846154,7841.60359143504,435.644643968614,1040.21272131281,92,20.8370326999592,0,0
transformers_4.23.0,tests/models/regnet/__init__.py,0,0,0,0,0,0,0,0,0,0,0,0,0,0,1,100,0,0
transformers_4.23.0,tests/models/regnet/test_modeling_regnet.py,274,161,192,4,14,12,19,18,31,61.3029689088065,2.71428571428571,350.869403692789,19.4927446495994,129.267675044712,33,52.5187362580397,0,0
transformers_4.23.0,tests/models/regnet/test_modeling_tf_regnet.py,289,170,202,5,13,12,19,18,31,59.715356810271,3.65384615384615,472.324197278754,26.240233182153,129.267675044712,31,52.1799218040527,0,0
transformers_4.23.0,tests/models/wav2vec2_phoneme/__init__.py,0,0,0,0,0,0,0,0,0,0,0,0,0,0,1,100,0,0
transformers_4.23.0,tests/models/wav2vec2_phoneme/test_tokenization_wav2vec2_phoneme.py,411,237,281,10,40,31,58,50,89,246.096404744368,7.25,3641.69820645214,202.316567025119,502.303200889951,44,45.284523812526,0,0
transformers_4.23.0,tests/models/rembert/test_modeling_tf_rembert.py,713,318,537,5,30,35,43,35,78,158.816358342692,3.58333333333333,1433.63460323612,79.646366846451,400.084075321707,42,39.2606666598792,0,0
transformers_4.23.0,tests/models/rembert/__init__.py,0,0,0,0,0,0,0,0,0,0,0,0,0,0,1,100,0,0
transformers_4.23.0,tests/models/rembert/test_modeling_rembert.py,498,207,406,2,17,23,24,19,47,71.4868683012558,1.41176470588235,281.862484421433,15.6590269123018,199.652593131849,36,44.3726272682238,0,0
transformers_4.23.0,tests/models/roformer/test_modeling_roformer.py,558,233,463,4,70,73,82,74,155,437.049811186148,2.34285714285714,2254.91863648983,125.273257582768,962.465271672487,38,35.3865651335957,0,0
transformers_4.23.0,tests/models/roformer/test_modeling_flax_roformer.py,163,71,124,1,6,6,6,7,12,15.5097750043269,0.5,16.8441295323456,0.935784974019201,33.6882590646913,12,65.4856896708118,0,0
transformers_4.23.0,tests/models/roformer/__init__.py,0,0,0,0,0,0,0,0,0,0,0,0,0,0,1,100,0,0
transformers_4.23.0,tests/models/roformer/test_tokenization_roformer.py,77,43,43,1,4,2,4,5,6,8,0.5,6.96578428466209,0.38698801581456,13.9315685693242,10,83.2086861918228,0,0
transformers_4.23.0,tests/models/roformer/test_modeling_tf_roformer.py,401,190,320,3,65,62,70,68,132,396.208795349013,1.61538461538462,1298.03438430353,72.1130213501963,803.545095045045,30,39.3551283138475,0,0
transformers_4.23.0,tests/models/canine/__init__.py,0,0,0,0,0,0,0,0,0,0,0,0,0,0,1,100,0,0
transformers_4.23.0,tests/models/canine/test_modeling_canine.py,536,314,414,10,37,41,58,47,99,225.969055477145,7.83783783783784,4310.06070085581,239.447816714212,549.904296316086,40,38.5216910438027,0,0
transformers_4.23.0,tests/models/canine/test_tokenization_canine.py,343,212,230,2,8,7,14,10,21,26,1.75,122.080857487111,6.78226986039503,69.7604899926346,35,54.8384813723974,0,0
transformers_4.23.0,tests/models/hubert/test_modeling_hubert.py,935,561,687,14,132,109,175,146,284,983.162992664122,9.28030303030303,18949.5451820785,1052.75251011547,2041.91017472192,129,16.9062949842939,0,0
transformers_4.23.0,tests/models/hubert/__init__.py,0,0,0,0,0,0,0,0,0,0,0,0,0,0,1,100,0,0
transformers_4.23.0,tests/models/hubert/test_modeling_tf_hubert.py,554,325,391,9,61,43,74,70,117,390.304302604317,5.45901639344262,3914.80320693759,217.489067052088,717.126112982561,63,34.7280470169518,0,0
transformers_4.23.0,tests/models/lxmert/test_modeling_tf_lxmert.py,695,317,592,7,37,38,55,44,93,212.401258982674,5.2027027027027,2641.55336628795,146.752964793775,507.727140533269,65,29.1259795249822,0,0
transformers_4.23.0,tests/models/lxmert/__init__.py,0,0,0,0,0,0,0,0,0,0,0,0,0,0,1,100,0,0
transformers_4.23.0,tests/models/lxmert/test_modeling_lxmert.py,787,336,674,8,35,39,56,43,95,203.524905593074,6.4,3299.16897085888,183.287165047715,515.495151696699,57,29.1536847817853,0,0
transformers_4.23.0,tests/models/lxmert/test_tokenization_lxmert.py,89,43,57,2,3,2,3,5,5,6.75488750216347,1,11.6096404744368,0.644980026357601,11.6096404744368,7,80.9907862206158,0,0
transformers_4.23.0,tests/models/blenderbot_small/test_modeling_tf_blenderbot_small.py,337,190,255,9,45,35,65,54,100,275.662714347816,6.5,3740.67687640626,207.81538202257,575.488750216347,50,42.2056798810529,0,0
transformers_4.23.0,tests/models/blenderbot_small/test_modeling_blenderbot_small.py,547,281,416,10,50,42,70,60,112,315.41209043761,7,4631.00222695708,257.277901497616,661.571746708154,53,36.8434950832949,0,0
transformers_4.23.0,tests/models/blenderbot_small/__init__.py,0,0,0,0,0,0,0,0,0,0,0,0,0,0,1,100,0,0
transformers_4.23.0,tests/models/blenderbot_small/test_tokenization_blenderbot_small.py,87,53,54,4,14,8,15,18,23,61.3029689088065,2.14285714285714,205.517732213943,11.4176517896635,95.9082750331732,11,73.4486972401928,0,0
transformers_4.23.0,tests/models/blenderbot_small/test_modeling_flax_blenderbot_small.py,398,181,322,6,39,40,64,45,104,221.640461539955,4.92307692307692,2811.82878532079,156.2127102956,571.152722018286,31,41.7161038985193,0,0
transformers_4.23.0,tests/models/gpt_neox/__init__.py,0,0,0,0,0,0,0,0,0,0,0,0,0,0,1,100,0,0
transformers_4.23.0,tests/models/gpt_neox/test_modeling_gpt_neox.py,230,128,166,2,4,5,6,6,11,10,1.5,42.6518812618991,2.36954895899439,28.4345875079327,23,60.0232741796294,0,0
transformers_4.23.0,tests/models/electra/test_modeling_tf_electra.py,602,303,447,5,19,24,32,24,56,92.3202632298649,4.21052631578947,1081.08589490688,60.0603274948269,256.757900040385,41,41.1815518957419,0,0
transformers_4.23.0,tests/models/electra/test_modeling_flax_electra.py,137,61,118,1,2,1,2,3,3,2,0.5,2.37744375108173,0.13208020839343,4.75488750216347,12,54.6994991863665,0,0
transformers_4.23.0,tests/models/electra/__init__.py,0,0,0,0,0,0,0,0,0,0,0,0,0,0,1,100,0,0
transformers_4.23.0,tests/models/electra/test_modeling_electra.py,455,198,390,2,6,10,11,8,21,17.5097750043269,1.83333333333333,115.5,6.41666666666667,63,39,43.613779153169,0,0
transformers_4.23.0,tests/models/auto/test_modeling_tf_auto.py,307,177,239,1,3,2,4,4,6,4.75488750216347,0.666666666666667,8,0.444444444444444,12,32,56.2971328859911,0,0
transformers_4.23.0,tests/models/auto/test_processor_auto.py,317,190,221,3,9,7,14,12,21,33.2842125151443,2.33333333333333,175.663162535337,9.75906458529648,75.2842125151443,28,54.3740392766756,0,0
transformers_4.23.0,tests/models/auto/__init__.py,0,0,0,0,0,0,0,0,0,0,0,0,0,0,1,100,0,0
transformers_4.23.0,tests/models/auto/test_tokenization_auto.py,353,216,255,4,13,8,16,17,24,56.1057163358342,2.46153846153846,241.474727852328,13.4152626584627,98.0991081900082,42,50.2374836727679,0,0
transformers_4.23.0,tests/models/auto/test_feature_extraction_auto.py,123,63,79,3,7,4,8,10,12,24.4063719565667,1.71428571428571,68.3368065233972,3.79648925129984,39.8631371386484,12,73.5535426393829,0,0
transformers_4.23.0,tests/models/auto/test_configuration_auto.py,112,66,73,2,4,2,4,6,6,10,1,15.5097750043269,0.861654166907052,15.5097750043269,13,75.6894632156235,0,0
transformers_4.23.0,tests/models/auto/test_modeling_auto.py,374,226,295,2,8,5,10,10,15,26,1.25,62.2861517791381,3.46034176550767,49.8289214233104,42,47.4052489520698,0,0
transformers_4.23.0,tests/models/auto/test_modeling_tf_pytorch.py,235,132,182,0,0,0,0,0,0,0,0,0,0,0,21,100,0,0
transformers_4.23.0,tests/models/auto/test_modeling_flax_auto.py,101,62,69,0,0,0,0,0,0,0,0,0,0,0,14,100,0,0
transformers_4.23.0,tests/models/van/__init__.py,0,0,0,0,0,0,0,0,0,0,0,0,0,0,1,100,0,0
transformers_4.23.0,tests/models/van/test_modeling_van.py,276,166,190,6,23,16,28,29,44,119.551699993638,3.65217391304348,780.6564242605,43.3698013478056,213.751163785613,33,51.404749369434,0,0
transformers_4.23.0,tests/models/fsmt/test_modeling_fsmt.py,540,300,429,9,43,31,50,52,81,261.858709465171,5.23255813953488,2416.05846193306,134.225470107392,461.735617169429,57,36.5519351754261,0,0
transformers_4.23.0,tests/models/fsmt/__init__.py,0,0,0,0,0,0,0,0,0,0,0,0,0,0,1,100,0,0
transformers_4.23.0,tests/models/fsmt/test_tokenization_fsmt.py,168,84,113,2,13,7,14,15,21,50.1057163358342,1.07692307692308,88.3558334699157,4.90865741499532,82.0447025077789,14,66.6062741809119,0,0
transformers_4.23.0,tests/models/bert/test_modeling_bert.py,625,291,527,3,13,17,20,16,37,52.8606038379977,2.30769230769231,341.538461538461,18.974358974359,148,52,36.815034199914,0,0
transformers_4.23.0,tests/models/bert/test_modeling_tf_bert.py,771,374,593,7,32,33,46,39,79,179.651484454403,5.03125,2100.7822131784,116.710122954356,417.546775290118,62,32.9845199737971,0,0
transformers_4.23.0,tests/models/bert/__init__.py,0,0,0,0,0,0,0,0,0,0,0,0,0,0,1,100,0,0
transformers_4.23.0,tests/models/bert/test_tokenization_bert_tf.py,100,69,78,4,12,7,13,16,20,51.0195500086539,2.16666666666667,173.333333333333,9.62962962962963,80,24,56.5561816428704,0,0
transformers_4.23.0,tests/models/bert/test_tokenization_bert.py,338,166,248,4,21,12,22,25,34,100.238665878354,2.0952380952381,330.81946951919,18.3788594177328,157.891110452341,37,46.6891019890887,0,0
transformers_4.23.0,tests/models/bert/test_modeling_flax_bert.py,164,63,126,0,0,0,0,0,0,0,0,0,0,0,11,100,0,0
transformers_4.23.0,tests/models/xlm/test_modeling_tf_xlm.py,367,152,306,2,4,2,4,6,6,10,1,15.5097750043269,0.861654166907052,15.5097750043269,27,54.8724116746332,0,0
transformers_4.23.0,tests/models/xlm/__init__.py,0,0,0,0,0,0,0,0,0,0,0,0,0,0,1,100,0,0
transformers_4.23.0,tests/models/xlm/test_modeling_xlm.py,488,202,410,5,34,27,48,39,75,184.583377076948,3.52941176470588,1399.07705793412,77.7265032185625,396.405166414669,41,40.0566176542804,0,0
transformers_4.23.0,tests/models/xlm/test_tokenization_xlm.py,98,43,64,2,17,9,18,19,27,71.4868683012558,1.05882352941176,121.440751266681,6.74670840370452,114.694042862977,7,73.6590373246785,0,0
transformers_4.23.0,tests/models/vilt/__init__.py,0,0,0,0,0,0,0,0,0,0,0,0,0,0,1,100,0,0
transformers_4.23.0,tests/models/vilt/test_feature_extraction_vilt.py,251,119,176,7,18,17,33,25,50,94.7101344803648,6.41666666666667,1489.90386088606,82.7724367158921,232.192809488736,24,57.784296225539,0,0
transformers_4.23.0,tests/models/vilt/test_modeling_vilt.py,646,357,493,10,50,42,66,60,108,315.41209043761,6.6,4210.43161654975,233.912867586097,637.94418432572,65,33.0666853870152,0,0
transformers_4.23.0,tests/models/bartpho/__init__.py,0,0,0,0,0,0,0,0,0,0,0,0,0,0,1,100,0,0
transformers_4.23.0,tests/models/bartpho/test_tokenization_bartpho.py,67,38,37,1,2,1,2,3,3,2,0.5,2.37744375108173,0.13208020839343,4.75488750216347,6,87.5310320619114,0,0
transformers_4.23.0,tests/models/layoutxlm/test_processor_layoutxlm.py,461,239,292,2,4,8,9,6,17,10,2.25,98.8748156525842,5.49304531403246,43.9443625122597,25,59.0090319290123,0,0
transformers_4.23.0,tests/models/layoutxlm/__init__.py,0,0,0,0,0,0,0,0,0,0,0,0,0,0,1,100,0,0
transformers_4.23.0,tests/models/layoutxlm/test_tokenization_layoutxlm.py,1948,1044,1399,15,206,224,368,221,592,1642.02246753387,13.3980582524272,61770.9211157323,3431.7178397629,4610.43831515973,217,0,0,0
transformers_4.23.0,tests/models/markuplm/test_tokenization_markuplm.py,2306,1256,1729,18,320,332,567,338,899,2738.07564038992,15.946875,120437.029060156,6690.94605889754,7552.39061321768,232,0,0,0
transformers_4.23.0,tests/models/markuplm/__init__.py,0,0,0,0,0,0,0,0,0,0,0,0,0,0,1,100,0,0
transformers_4.23.0,tests/models/markuplm/test_processor_markuplm.py,451,228,292,2,5,22,24,7,46,13.6096404744368,4.8,619.863966790319,34.4368870439066,129.13832641465,25,55.6823142236471,0,0
transformers_4.23.0,tests/models/markuplm/test_feature_extraction_markuplm.py,114,39,65,1,4,2,4,5,6,8,0.5,6.96578428466209,0.38698801581456,13.9315685693242,8,82.8878701257286,0,0
transformers_4.23.0,tests/models/markuplm/test_modeling_markuplm.py,364,138,297,1,5,5,5,6,10,11.6096404744368,0.5,12.9248125036058,0.71804513908921,25.8496250072116,22,54.7486753397098,0,0
transformers_4.23.0,tests/models/layoutlmv2/__init__.py,0,0,0,0,0,0,0,0,0,0,0,0,0,0,1,100,0,0
transformers_4.23.0,tests/models/layoutlmv2/test_feature_extraction_layoutlmv2.py,221,84,150,0,0,0,0,0,0,0,0,0,0,0,17,100,0,0
transformers_4.23.0,tests/models/layoutlmv2/test_tokenization_layoutlmv2.py,2483,1321,1870,18,324,327,563,342,890,2777.17005096058,15.6388888888889,117164.815545385,6509.15641918808,7491.88873824845,258,0,0,0
transformers_4.23.0,tests/models/layoutlmv2/test_processor_layoutlmv2.py,466,241,298,2,5,9,11,7,20,13.6096404744368,2.2,123.523616570535,6.86242314280748,56.1470984411521,26,57.8017267444355,0,0
transformers_4.23.0,tests/models/layoutlmv2/test_modeling_layoutlmv2.py,544,272,423,9,46,29,49,55,78,282.613174991603,4.79347826086957,2161.60012419371,120.088895788539,450.946057654924,47,39.7499772554245,0,0
transformers_4.23.0,tests/models/camembert/__init__.py,0,0,0,0,0,0,0,0,0,0,0,0,0,0,1,100,0,0
transformers_4.23.0,tests/models/camembert/test_tokenization_camembert.py,130,69,78,2,2,2,2,4,4,4,1,8,0.444444444444444,8,10,78.283594041642,0,0
transformers_4.23.0,tests/models/camembert/test_modeling_tf_camembert.py,54,21,26,1,5,5,5,6,10,11.6096404744368,0.5,12.9248125036058,0.71804513908921,25.8496250072116,3,89.5175111163942,0,0
transformers_4.23.0,tests/models/camembert/test_modeling_camembert.py,55,21,28,1,5,5,5,6,10,11.6096404744368,0.5,12.9248125036058,0.71804513908921,25.8496250072116,3,89.8330492203084,0,0
transformers_4.23.0,tests/models/perceiver/test_modeling_perceiver.py,1002,611,757,15,128,107,174,143,281,954.603358934128,10.1953125,20512.1923324478,1139.56624069154,2011.92384563473,95,19.8856887639193,0,0
transformers_4.23.0,tests/models/perceiver/__init__.py,0,0,0,0,0,0,0,0,0,0,0,0,0,0,1,100,0,0
transformers_4.23.0,tests/models/perceiver/test_tokenization_perceiver.py,298,176,201,8,31,20,41,39,61,177.580085621993,5.29032258064516,1705.65044508058,94.7583580600321,322.409535350597,40,52.1831533064501,0,0
transformers_4.23.0,tests/models/videomae/test_feature_extraction_videomae.py,202,75,148,0,0,0,0,0,0,0,0,0,0,0,16,100,0,0
transformers_4.23.0,tests/models/videomae/__init__.py,0,0,0,0,0,0,0,0,0,0,0,0,0,0,1,100,0,0
transformers_4.23.0,tests/models/videomae/test_modeling_videomae.py,423,239,303,11,46,28,48,57,76,292.137597783633,5.73913043478261,2544.15446183046,141.341914546137,443.29964107652,37,44.3980209955044,0,0
transformers_4.23.0,tests/models/layoutlmv3/test_feature_extraction_layoutlmv3.py,213,84,142,0,0,0,0,0,0,0,0,0,0,0,17,100,0,0
transformers_4.23.0,tests/models/layoutlmv3/__init__.py,0,0,0,0,0,0,0,0,0,0,0,0,0,0,1,100,0,0
transformers_4.23.0,tests/models/layoutlmv3/test_modeling_tf_layoutlmv3.py,497,228,396,14,70,45,80,84,125,482.352780094954,8,6392.31742277876,355.128745709931,799.039677847345,55,36.8605468872629,0,0
transformers_4.23.0,tests/models/layoutlmv3/test_tokenization_layoutlmv3.py,2445,1304,1831,18,337,335,578,355,913,2904.71446128425,15.4362017804154,119393.455569107,6632.96975383929,7734.63947073994,253,0,0,0
transformers_4.23.0,tests/models/layoutlmv3/test_processor_layoutlmv3.py,446,234,284,2,5,9,11,7,20,13.6096404744368,2.2,123.523616570535,6.86242314280748,56.1470984411521,24,58.6145776152908,0,0
transformers_4.23.0,tests/models/layoutlmv3/test_modeling_layoutlmv3.py,399,186,323,8,29,22,35,37,57,164.8814488587,4.82758620689655,1433.49785716272,79.6387698423736,296.93884184085,41,42.7172984100039,0,0
transformers_4.23.0,tests/models/wav2vec2/test_modeling_tf_wav2vec2.py,591,350,416,9,63,44,76,72,120,405.097960193476,5.42857142857143,4019.26542951099,223.292523861722,740.391000173078,68,32.972879510965,0,0
transformers_4.23.0,tests/models/wav2vec2/test_processor_wav2vec2.py,139,78,89,1,3,2,4,4,6,4.75488750216347,0.666666666666667,8,0.444444444444444,12,12,70.3655392396165,0,0
transformers_4.23.0,tests/models/wav2vec2/__init__.py,0,0,0,0,0,0,0,0,0,0,0,0,0,0,1,100,0,0
transformers_4.23.0,tests/models/wav2vec2/test_feature_extraction_wav2vec2.py,225,143,152,7,26,16,31,33,47,141.862917126072,4.17307692307692,989.380300448786,54.9655722471548,237.086523609847,32,54.151796176988,0,0
transformers_4.23.0,tests/models/wav2vec2/test_modeling_flax_wav2vec2.py,549,265,384,12,80,58,105,92,163,548.773797599643,7.875,8373.80721584368,465.211511991316,1063.34059883729,48,39.8411185200168,0,0
transformers_4.23.0,tests/models/wav2vec2/test_modeling_wav2vec2.py,1665,916,1215,18,247,199,320,265,519,2038.30535622738,11.6599190283401,48713.6422017601,2706.31345565334,4177.87139716484,179,3.49145782242769,0,0
transformers_4.23.0,tests/models/wav2vec2/test_tokenization_wav2vec2.py,766,439,514,11,68,56,103,79,159,452.001221010033,8.33088235294118,8350.05287089603,463.891826160891,1002.30113896016,61,36.2133229840315,0,0
transformers_4.23.0,tests/models/tapas/__init__.py,0,0,0,0,0,0,0,0,0,0,0,0,0,0,1,100,0,0
transformers_4.23.0,tests/models/tapas/test_modeling_tf_tapas.py,1048,446,847,11,81,127,159,92,286,551.581598038665,10.7962962962963,20143.0680264636,1119.05933480353,1865.73871943231,65,28.6713928926388,0,0
transformers_4.23.0,tests/models/tapas/test_modeling_tapas.py,1100,464,889,8,76,125,153,84,278,498.842491021713,8.05263157894737,14310.043645288,795.002424738222,1777.0642435325,68,28.0938097059354,0,0
transformers_4.23.0,tests/models/tapas/test_tokenization_tapas.py,1243,690,942,16,147,115,221,163,336,1122.35183469095,12.0272108843537,29697.2602895555,1649.8477938642,2469.17265982164,164,8.49303672134272,0,0
transformers_4.23.0,tests/models/mpnet/test_tokenization_mpnet.py,82,36,52,2,19,10,20,21,30,82.7106227554281,1.05263157894737,138.704760719329,7.70582003996274,131.769522683363,8,75.8529576303579,0,0
transformers_4.23.0,tests/models/mpnet/test_modeling_tf_mpnet.py,262,141,212,1,6,6,6,7,12,15.5097750043269,0.5,16.8441295323456,0.935784974019201,33.6882590646913,25,53.9031805650444,0,0
transformers_4.23.0,tests/models/mpnet/__init__.py,0,0,0,0,0,0,0,0,0,0,0,0,0,0,1,100,0,0
transformers_4.23.0,tests/models/mpnet/test_modeling_mpnet.py,251,131,203,1,7,10,10,8,20,19.6514844544032,0.714285714285714,42.8571428571429,2.38095238095238,60,23,53.8819913133028,0,0
transformers_4.23.0,tests/models/led/__init__.py,0,0,0,0,0,0,0,0,0,0,0,0,0,0,1,100,0,0
transformers_4.23.0,tests/models/led/test_modeling_led.py,556,300,414,11,64,51,83,75,134,422.05374780501,7.1328125,5953.48543931755,330.749191073197,834.661704526448,47,39.0816366935843,0,0
transformers_4.23.0,tests/models/led/test_modeling_tf_led.py,431,255,321,11,70,58,97,81,155,467.103558991158,7.62142857142857,7489.40066233624,416.077814574236,982.676750447117,53,38.7518750942023,0,0
transformers_4.23.0,tests/models/megatron_gpt2/__init__.py,0,0,0,0,0,0,0,0,0,0,0,0,0,0,1,100,0,0
transformers_4.23.0,tests/models/megatron_gpt2/test_modeling_megatron_gpt2.py,85,31,59,4,23,20,24,27,44,112.041924989311,2.08695652173913,436.622713242141,24.2568174023412,209.215050095193,5,75.833150506637,0,0
transformers_4.23.0,tests/models/bert_generation/test_tokenization_bert_generation.py,245,75,193,3,16,22,43,19,65,68.7548875021635,4.03125,1113.08975625701,61.8383197920564,276.115288373833,12,57.6833495532247,0,0
transformers_4.23.0,tests/models/bert_generation/__init__.py,0,0,0,0,0,0,0,0,0,0,0,0,0,0,1,100,0,0
transformers_4.23.0,tests/models/bert_generation/test_modeling_bert_generation.py,333,149,265,2,8,9,10,10,19,26,1.25,78.8957922535749,4.38309956964305,63.1166338028599,26,52.2525807579479,0,0
transformers_4.23.0,tests/models/bertweet/__init__.py,0,0,0,0,0,0,0,0,0,0,0,0,0,0,1,100,0,0
transformers_4.23.0,tests/models/bertweet/test_tokenization_bertweet.py,65,37,36,1,2,1,2,3,3,2,0.5,2.37744375108173,0.13208020839343,4.75488750216347,6,88.3550357627131,0,0
transformers_4.23.0,tests/models/swinv2/__init__.py,0,0,0,0,0,0,0,0,0,0,0,0,0,0,1,100,0,0
transformers_4.23.0,tests/models/swinv2/test_modeling_swinv2.py,430,248,331,12,57,34,63,69,97,375.494280816044,6.63157894736842,3929.38873214436,218.29937400802,592.526872307483,46,37.6468684209258,0,0
transformers_4.23.0,tests/models/swin/test_modeling_swin.py,453,257,348,12,56,34,61,68,95,368.23142564388,6.53571428571429,3779.6621962549,209.981233125272,578.308969918782,46,37.5913404047603,0,0
transformers_4.23.0,tests/models/swin/__init__.py,0,0,0,0,0,0,0,0,0,0,0,0,0,0,1,100,0,0
transformers_4.23.0,tests/models/swin/test_modeling_tf_swin.py,405,229,299,9,49,30,53,58,83,303.650107374626,4.86734693877551,2366.56454671526,131.475808150848,486.212422595589,38,41.0879957150509,0,0
transformers_4.23.0,tests/models/codegen/test_modeling_codegen.py,554,307,416,7,37,43,69,44,112,212.401258982674,6.52702702702703,3990.99206542977,221.721781412765,611.456341287377,41,37.6616175790605,0,0
transformers_4.23.0,tests/models/codegen/test_tokenization_codegen.py,265,135,173,5,26,22,39,31,61,133.821073146105,3.75,1133.272406001,62.9595781111665,302.205974933599,17,58.8053980668868,0,0
transformers_4.23.0,tests/models/codegen/__init__.py,0,0,0,0,0,0,0,0,0,0,0,0,0,0,1,100,0,0
transformers_4.23.0,tests/models/encoder_decoder/__init__.py,0,0,0,0,0,0,0,0,0,0,0,0,0,0,1,100,0,0
transformers_4.23.0,tests/models/encoder_decoder/test_modeling_encoder_decoder.py,1088,451,908,8,44,40,64,52,104,264.214991220041,5.81818181818182,3449.28425126792,191.626902848218,592.845730686674,74,25.0518911939085,0,0
transformers_4.23.0,tests/models/encoder_decoder/test_modeling_tf_encoder_decoder.py,1263,557,928,12,74,57,100,86,157,502.519099065196,8.10810810810811,8180.46134990456,454.470074994698,1008.92356648823,95,25.9829811330194,0,0
transformers_4.23.0,tests/models/encoder_decoder/test_modeling_flax_encoder_decoder.py,601,289,459,10,36,35,57,46,92,219.336581000797,7.91666666666667,4022.99429132819,223.499682851566,508.167699957245,50,36.06785561852,0,0
transformers_4.23.0,tests/models/byt5/__init__.py,0,0,0,0,0,0,0,0,0,0,0,0,0,0,1,100,0,0
transformers_4.23.0,tests/models/byt5/test_tokenization_byt5.py,369,218,253,8,35,25,51,43,76,203.524905593074,5.82857142857143,2403.68025019718,133.537791677621,412.39612135736,48,47.3392264923612,0,0
transformers_4.23.0,tests/models/bert_japanese/__init__.py,0,0,0,0,0,0,0,0,0,0,0,0,0,0,1,100,0,0
transformers_4.23.0,tests/models/bert_japanese/test_tokenization_bert_japanese.py,449,231,327,2,28,18,36,30,54,136.605937817613,1.28571428571429,340.678404209391,18.9265780116329,264.97209216286,52,42.8168233908205,0,0
transformers_4.23.0,tests/models/sew_d/__init__.py,0,0,0,0,0,0,0,0,0,0,0,0,0,0,1,100,0,0
transformers_4.23.0,tests/models/sew_d/test_modeling_sew_d.py,575,318,421,12,108,85,127,120,212,772.547400242309,7.05555555555556,10331.1734664535,573.954081469641,1464.26080626901,68,31.8996285690303,0,0
transformers_4.23.0,tests/models/speech_to_text_2/__init__.py,0,0,0,0,0,0,0,0,0,0,0,0,0,0,1,100,0,0
transformers_4.23.0,tests/models/speech_to_text_2/test_modeling_speech_to_text_2.py,212,99,151,4,12,11,19,16,30,51.0195500086539,3.16666666666667,380,21.1111111111111,120,18,60.9872476212928,0,0
transformers_4.23.0,tests/models/speech_to_text_2/test_tokenization_speech_to_text_2.py,97,56,55,6,12,7,12,18,19,58.5293250129808,3,237.685725082212,13.2047625045673,79.2285750274039,11,74.1844631737087,0,0
transformers_4.23.0,tests/models/glpn/__init__.py,0,0,0,0,0,0,0,0,0,0,0,0,0,0,1,100,0,0
transformers_4.23.0,tests/models/glpn/test_feature_extraction_glpn.py,127,65,79,3,24,18,30,27,48,114.793987519471,1.875,427.939875194712,23.7744375108173,228.234600103846,16,68.0813911009607,0,0
transformers_4.23.0,tests/models/glpn/test_modeling_glpn.py,355,213,260,8,32,32,54,40,86,184,6.75,3089.37925908211,171.632181060117,457.685816160313,32,44.3808215254777,0,0
transformers_4.23.0,tests/models/cpm/test_tokenization_cpm.py,39,17,17,1,2,1,2,3,3,2,0.5,2.37744375108173,0.13208020839343,4.75488750216347,2,96.5421274873175,0,0
transformers_4.23.0,tests/models/cpm/__init__.py,0,0,0,0,0,0,0,0,0,0,0,0,0,0,1,100,0,0
transformers_4.23.0,tests/models/owlvit/__init__.py,0,0,0,0,0,0,0,0,0,0,0,0,0,0,1,100,0,0
transformers_4.23.0,tests/models/owlvit/test_processor_owlvit.py,241,146,156,3,5,3,5,8,8,16.3645279766003,1.5,36,2,24,21,60.4471602907968,0,0
transformers_4.23.0,tests/models/owlvit/test_feature_extraction_owlvit.py,201,75,147,0,0,0,0,0,0,0,0,0,0,0,15,100,0,0
transformers_4.23.0,tests/models/owlvit/test_modeling_owlvit.py,793,484,617,13,46,36,70,59,106,302.189566314457,9.89130434782609,6167.82335371134,342.656852983963,623.560163232355,102,21.4352825246833,0,0
transformers_4.23.0,tests/models/m2m_100/test_modeling_m2m_100.py,384,203,290,7,38,35,49,45,84,219.072729965259,4.51315789473684,2081.99041330856,115.666134072698,461.315660091693,32,45.0350299213,0,0
transformers_4.23.0,tests/models/m2m_100/test_tokenization_m2m_100.py,246,145,175,4,16,12,20,20,32,72,2.5,345.754247590989,19.2085693106105,138.301699036396,29,54.5908696900643,0,0
transformers_4.23.0,tests/models/m2m_100/__init__.py,0,0,0,0,0,0,0,0,0,0,0,0,0,0,1,100,0,0
transformers_4.23.0,tests/models/unispeech/test_modeling_unispeech.py,583,318,422,13,79,53,95,92,148,546.104395441825,7.81645569620253,7546.68768562089,419.260426978938,965.487169496438,75,32.7344057056237,0,0
transformers_4.23.0,tests/models/unispeech/__init__.py,0,0,0,0,0,0,0,0,0,0,0,0,0,0,1,100,0,0
transformers_4.23.0,tests/models/ctrl/__init__.py,0,0,0,0,0,0,0,0,0,0,0,0,0,0,1,100,0,0
transformers_4.23.0,tests/models/ctrl/test_tokenization_ctrl.py,66,38,37,1,4,2,4,5,6,8,0.5,6.96578428466209,0.38698801581456,13.9315685693242,5,84.8222070495732,0,0
transformers_4.23.0,tests/models/ctrl/test_modeling_ctrl.py,248,130,193,1,2,1,2,3,3,2,0.5,2.37744375108173,0.13208020839343,4.75488750216347,24,65.0939424077032,0,0
transformers_4.23.0,tests/models/ctrl/test_modeling_tf_ctrl.py,261,142,206,3,8,6,12,11,18,28.7548875021635,2.25,140.106980554811,7.78372114193392,62.2697691354714,35,54.4444352846867,0,0
transformers_4.23.0,tests/models/speech_to_text/test_tokenization_speech_to_text.py,163,97,110,4,19,25,47,23,72,88.7106227554281,4.94736842105263,1611.34038518915,89.5189102882862,325.696460836105,16,59.5158200890715,0,0
transformers_4.23.0,tests/models/speech_to_text/test_processor_speech_to_text.py,146,82,92,2,6,5,9,8,14,17.5097750043269,1.5,63,3.5,42,14,65.5440129580321,0,0
transformers_4.23.0,tests/models/speech_to_text/test_modeling_speech_to_text.py,780,428,583,13,76,69,122,89,191,522.948207357547,10.4342105263158,12905.7106928219,716.983927378994,1236.86508531458,76,29.1349528901185,0,0
transformers_4.23.0,tests/models/speech_to_text/__init__.py,0,0,0,0,0,0,0,0,0,0,0,0,0,0,1,100,0,0
transformers_4.23.0,tests/models/speech_to_text/test_modeling_tf_speech_to_text.py,610,300,436,8,41,37,58,49,95,243.659632189341,5.65853658536585,3018.24890156827,167.680494531571,533.397435190945,52,41.219942568046,0,0
transformers_4.23.0,tests/models/speech_to_text/test_feature_extraction_speech_to_text.py,250,154,184,7,30,19,36,37,55,166.858202322659,4.2,1203.38372746029,66.8546515255715,286.519935109592,35,49.5717913746422,0,0
transformers_4.23.0,tests/models/mobilebert/test_modeling_tf_mobilebert.py,353,195,286,3,16,13,17,19,30,68.7548875021635,1.59375,203.104034236521,11.2835574575845,127.437825403308,30,45.0323802227574,0,0
transformers_4.23.0,tests/models/mobilebert/test_tokenization_mobilebert.py,345,169,252,4,21,12,22,25,34,100.238665878354,2.0952380952381,330.81946951919,18.3788594177328,157.891110452341,38,47.0124208617639,0,0
transformers_4.23.0,tests/models/mobilebert/__init__.py,0,0,0,0,0,0,0,0,0,0,0,0,0,0,1,100,0,0
transformers_4.23.0,tests/models/mobilebert/test_modeling_mobilebert.py,369,179,301,8,17,17,25,25,42,93.4868683012558,5.88235294117647,1147.30564688552,63.7392026047511,195.041959970538,33,44.9259900621679,0,0
transformers_4.23.0,tests/models/decision_transformer/test_modeling_decision_transformer.py,251,116,189,4,11,11,15,15,26,46.0537478050103,2.72727272727273,277.034060415877,15.3907811342154,101.579155485821,17,58.9517618191198,0,0
transformers_4.23.0,tests/models/decision_transformer/__init__.py,0,0,0,0,0,0,0,0,0,0,0,0,0,0,1,100,0,0
transformers_4.23.0,tests/models/convnext/__init__.py,0,0,0,0,0,0,0,0,0,0,0,0,0,0,1,100,0,0
transformers_4.23.0,tests/models/convnext/test_modeling_convnext.py,264,151,183,3,10,9,14,13,23,37.9741684510371,2.1,178.731238386215,9.9295132436786,85.1101135172451,28,55.4558408724189,0,0
transformers_4.23.0,tests/models/convnext/test_modeling_tf_convnext.py,298,167,209,5,13,11,18,18,29,59.715356810271,3.46153846153846,418.596317452478,23.2553509695821,120.927825041827,29,52.548596602273,0,0
transformers_4.23.0,tests/models/convnext/test_feature_extraction_convnext.py,195,73,141,0,0,0,0,0,0,0,0,0,0,0,16,100,0,0
transformers_4.23.0,tests/models/unispeech_sat/test_modeling_unispeech_sat.py,923,494,683,13,148,125,190,161,315,1115.10481444892,8.3445945945946,19269.6617466793,1070.53676370441,2309.2388166061,122,18.8370977217348,0,0
transformers_4.23.0,tests/models/unispeech_sat/__init__.py,0,0,0,0,0,0,0,0,0,0,0,0,0,0,1,100,0,0
transformers_4.23.0,tests/models/mctct/test_feature_extraction_mctct.py,274,168,205,8,36,23,44,44,67,210.117300051923,4.88888888888889,1788.26715686031,99.3481753811281,365.781918448699,37,47.2363251530232,0,0
transformers_4.23.0,tests/models/mctct/test_processor_mctct.py,146,83,94,2,5,3,6,7,9,13.6096404744368,1.2,30.3194331582221,1.68441295323456,25.2661942985184,14,66.8005199823832,0,0
transformers_4.23.0,tests/models/mctct/__init__.py,0,0,0,0,0,0,0,0,0,0,0,0,0,0,1,100,0,0
transformers_4.23.0,tests/models/mctct/test_modeling_mctct.py,647,374,471,11,93,75,135,104,210,646.195517238057,7.98387096774194,11234.043688722,624.113538262336,1407.09234080963,97,26.5853945914649,0,0
transformers_4.23.0,tests/models/resnet/test_modeling_tf_resnet.py,252,146,172,3,11,10,15,14,25,42.8086353071737,2.04545454545455,194.694285787037,10.8163492103909,95.1838730514401,29,55.8023723352412,0,0
transformers_4.23.0,tests/models/resnet/test_modeling_resnet.py,275,162,193,4,15,12,19,19,31,66.6033589341278,2.53333333333333,333.603907389103,18.5335504105057,131.685752916751,33,52.3620953964745,0,0
transformers_4.23.0,tests/models/resnet/__init__.py,0,0,0,0,0,0,0,0,0,0,0,0,0,0,1,100,0,0
transformers_4.23.0,tests/models/marian/test_modeling_flax_marian.py,489,261,388,6,37,39,62,43,101,208.259549532598,5.02702702702703,2755.07593734685,153.059774297048,548.052740224912,40,35.6684979770651,0,0
transformers_4.23.0,tests/models/marian/test_modeling_marian.py,850,471,663,10,54,49,82,64,131,343.983206065701,7.59259259259259,5967.77777777778,331.543209876543,786,85,25.8783072820159,0,0
transformers_4.23.0,tests/models/marian/__init__.py,0,0,0,0,0,0,0,0,0,0,0,0,0,0,1,100,0,0
transformers_4.23.0,tests/models/marian/test_modeling_tf_marian.py,437,268,328,9,43,34,63,52,97,261.858709465171,6.59302325581395,3645.56376811677,202.531320450931,552.942652659686,59,37.2845875413674,0,0
transformers_4.23.0,tests/models/marian/test_tokenization_marian.py,152,95,101,4,10,8,14,14,22,41.2192809488736,2.8,234.533063198748,13.0296146221527,83.7618082852673,17,63.0754577829388,0,0
transformers_4.23.0,tests/models/xlm_roberta/test_tokenization_xlm_roberta.py,346,122,253,5,17,26,49,22,75,81.0965087756926,7.20588235294118,2410.06047036648,133.892248353693,334.457371397797,25,55.8719843617692,0,0
transformers_4.23.0,tests/models/xlm_roberta/__init__.py,0,0,0,0,0,0,0,0,0,0,0,0,0,0,1,100,0,0
transformers_4.23.0,tests/models/xlm_roberta/test_modeling_tf_xlm_roberta.py,57,22,32,1,3,3,3,4,6,4.75488750216347,0.5,6,0.333333333333333,12,3,91.8333281749974,0,0
transformers_4.23.0,tests/models/xlm_roberta/test_modeling_flax_xlm_roberta.py,47,22,23,1,4,4,4,5,8,8,0.5,9.28771237954945,0.51598402108608,18.5754247590989,3,90.3059460543788,0,0
transformers_4.23.0,tests/models/xlm_roberta/test_modeling_xlm_roberta.py,69,30,32,1,11,11,11,12,22,38.0537478050103,0.5,39.4345875079327,2.19081041710737,78.8691750158654,4,81.9179877584145,0,0
transformers_4.23.0,tests/models/detr/test_feature_extraction_detr.py,341,180,229,5,6,7,13,11,20,27.1194154787637,5.41666666666667,374.771758685707,20.8206532603171,69.188632372746,26,59.2685028494106,0,0
transformers_4.23.0,tests/models/detr/__init__.py,0,0,0,0,0,0,0,0,0,0,0,0,0,0,1,100,0,0
transformers_4.23.0,tests/models/detr/test_modeling_detr.py,554,333,418,8,79,66,93,87,159,521.998679105991,4.70886075949367,4823.88888471469,267.993826928594,1024.42801583995,60,32.1170518600005,0,0
transformers_4.23.0,tests/models/vit_mae/test_modeling_vit_mae.py,331,188,229,8,36,24,41,44,65,210.117300051923,4.55555555555556,1616.59836262982,89.8110201461012,354.863055211424,33,49.5070900152931,0,0
transformers_4.23.0,tests/models/vit_mae/test_modeling_tf_vit_mae.py,502,276,336,11,73,44,80,84,124,489.910940603252,6.02739726027397,4777.60052858643,265.422251588135,792.647360424566,54,42.3009569128811,0,0
transformers_4.23.0,tests/models/vit_mae/__init__.py,0,0,0,0,0,0,0,0,0,0,0,0,0,0,1,100,0,0
transformers_4.23.0,tests/models/beit/test_modeling_beit.py,482,281,351,12,80,70,87,92,157,548.773797599643,6.525,6682.89995683371,371.272219824095,1024.19922710095,50,36.7904586448139,0,0
transformers_4.23.0,tests/models/beit/__init__.py,0,0,0,0,0,0,0,0,0,0,0,0,0,0,1,100,0,0
transformers_4.23.0,tests/models/beit/test_modeling_flax_beit.py,296,167,206,5,20,16,20,25,36,98.0482023721841,2.5,417.947057079725,23.2192809488736,167.17882283189,28,51.8134020601331,0,0
transformers_4.23.0,tests/models/beit/test_feature_extraction_beit.py,344,133,264,3,18,13,25,21,38,79.8135375281251,2.08333333333333,347.725129303319,19.3180627390733,166.908062065593,19,55.3467925016145,0,0
transformers_4.23.0,tests/models/transfo_xl/__init__.py,0,0,0,0,0,0,0,0,0,0,0,0,0,0,1,100,0,0
transformers_4.23.0,tests/models/transfo_xl/test_modeling_tf_transfo_xl.py,262,139,173,5,17,11,22,22,33,81.0965087756926,3.23529411764706,476.109905166276,26.4505502870153,147.161243415031,34,58.9618142651459,0,0
transformers_4.23.0,tests/models/transfo_xl/test_tokenization_transfo_xl.py,131,46,91,1,4,2,4,5,6,8,0.5,6.96578428466209,0.38698801581456,13.9315685693242,10,76.700457308402,0,0
transformers_4.23.0,tests/models/transfo_xl/test_modeling_transfo_xl.py,487,274,353,11,79,63,122,90,185,536.052426911001,8.49367088607595,10200.8377735808,566.713209643379,1200.99282282099,78,37.2184176706275,0,0
transformers_4.23.0,tests/models/mt5/test_modeling_mt5.py,53,20,19,4,9,6,9,13,15,36.5293250129808,2,111.013191544233,6.16739953023515,55.5065957721164,3,81.195587443302,0,0
transformers_4.23.0,tests/models/mt5/test_modeling_flax_mt5.py,61,26,25,4,9,7,10,13,17,36.5293250129808,2.22222222222222,139.794389351997,7.76635496399982,62.9074752083986,3,82.87381844139,0,0
transformers_4.23.0,tests/models/mt5/__init__.py,0,0,0,0,0,0,0,0,0,0,0,0,0,0,1,100,0,0
transformers_4.23.0,tests/models/mt5/test_modeling_tf_mt5.py,73,34,32,3,6,4,6,9,10,20.2646625064904,1.5,47.5488750216347,2.64160416786859,31.6992500144231,4,83.1819994650858,0,0
transformers_4.23.0,tests/repo_utils/test_check_dummies.py,127,49,79,0,0,0,0,0,0,0,0,0,0,0,5,100,0,0
transformers_4.23.0,tests/repo_utils/test_check_copies.py,209,60,157,4,12,8,16,16,24,51.0195500086539,2.66666666666667,256,14.2222222222222,96,9,66.955033962147,0,0
transformers_4.23.0,tests/mixed_int8/test_mixed_int8.py,233,105,123,6,15,11,21,21,32,74.1131339384547,4.2,590.327461621465,32.7959700900814,140.55415752892,16,67.953147202709,0,0
transformers_4.23.0,tests/mixed_int8/__init__.py,0,0,0,0,0,0,0,0,0,0,0,0,0,0,1,100,0,0
transformers_4.23.0,tests/sagemaker/test_multi_node_model_parallel.py,124,46,96,4,14,8,16,18,24,61.3029689088065,2.28571428571429,228.750171507693,12.7083428615385,100.078200034616,12,66.2372854890966,0,0
transformers_4.23.0,tests/sagemaker/__init__.py,5,3,3,1,2,1,2,3,3,2,0.5,2.37744375108173,0.13208020839343,4.75488750216347,1,84.7162462759479,0,0
transformers_4.23.0,tests/sagemaker/conftest.py,65,36,50,1,4,2,4,5,6,8,0.5,6.96578428466209,0.38698801581456,13.9315685693242,7,71.3107646450788,0,0
transformers_4.23.0,tests/sagemaker/test_single_node_gpu.py,96,38,73,4,12,7,14,16,21,51.0195500086539,2.33333333333333,196,10.8888888888889,84,11,69.1059155122177,0,0
transformers_4.23.0,tests/sagemaker/test_multi_node_data_parallel.py,110,42,84,6,15,9,18,21,27,74.1131339384547,3.6,426.933253494096,23.7185140830053,118.592570415027,13,67.4880486198285,0,0
transformers_4.23.0,tests/sagemaker/scripts/tensorflow/run_tf_dist.py,194,118,139,6,23,15,28,29,43,119.551699993638,3.65217391304348,762.914232800035,42.3841240444464,208.893182790486,26,52.3761255167188,0,0
transformers_4.23.0,tests/sagemaker/scripts/tensorflow/run_tf.py,91,50,64,2,4,2,4,6,6,10,1,15.5097750043269,0.861654166907052,15.5097750043269,5,75.2893720187177,0,0
transformers_4.23.0,tests/sagemaker/scripts/pytorch/run_glue_model_parallelism.py,541,266,390,15,101,83,157,116,240,731.082718692059,11.6584158415842,19188.7666259708,1066.04259033171,1645.91543883062,88,37.5360007373857,0,0
transformers_4.23.0,tests/sagemaker/scripts/pytorch/run_ddp.py,52,32,42,2,4,2,4,6,6,10,1,15.5097750043269,0.861654166907052,15.5097750043269,8,57.7540537588094,0,0
transformers_4.23.0,tests/utils/test_file_utils.py,113,60,64,1,3,2,4,4,6,4.75488750216347,0.666666666666667,8,0.444444444444444,12,11,80.678630682467,0,0
transformers_4.23.0,tests/utils/test_skip_decorators.py,120,48,48,2,4,2,4,6,6,10,1,15.5097750043269,0.861654166907052,15.5097750043269,11,79.4504276353346,0,0
transformers_4.23.0,tests/utils/test_doc_samples.py,114,63,72,5,10,9,18,15,27,44.8289214233104,4.5,474.687207366435,26.3715115203575,105.48604608143,25,70.6891589129412,0,0
transformers_4.23.0,tests/utils/test_versions_utils.py,97,51,50,0,0,0,0,0,0,0,0,0,0,0,14,100,0,0
transformers_4.23.0,tests/utils/test_convert_slow_tokenizer.py,34,22,25,0,0,0,0,0,0,0,0,0,0,0,2,100,0,0
transformers_4.23.0,tests/utils/test_hub_utils.py,125,70,79,1,2,1,2,3,3,2,0.5,2.37744375108173,0.13208020839343,4.75488750216347,8,80.2274122166512,0,0
transformers_4.23.0,tests/utils/test_cli.py,47,21,23,0,0,0,0,0,0,0,0,0,0,0,3,100,0,0
transformers_4.23.0,tests/utils/test_add_new_model_like.py,1342,441,1021,3,17,9,17,20,26,74.2417558034193,1.5,168.555195700607,9.36417753892262,112.370130467071,66,28.9160501417786,0,0
transformers_4.23.0,tests/utils/test_modeling_tf_core.py,404,235,314,12,53,38,69,65,107,346.599334100503,7.81132075471698,5033.56319587801,279.642399771001,644.393355994045,70,37.1542430301966,0,0
transformers_4.23.0,tests/utils/__init__.py,0,0,0,0,0,0,0,0,0,0,0,0,0,0,1,100,0,0
transformers_4.23.0,tests/utils/test_generic.py,45,9,26,0,0,0,0,0,0,0,0,0,0,0,2,100,0,0
transformers_4.23.0,tests/utils/test_model_output.py,109,87,78,0,0,0,0,0,0,0,0,0,0,0,8,100,0,0
transformers_4.23.0,tests/utils/test_hf_argparser.py,305,231,220,2,6,6,12,8,18,17.5097750043269,2,108,6,54,22,49.6842273906623,0,0
transformers_4.23.0,tests/utils/test_activations_tf.py,60,35,35,3,7,6,9,10,15,24.4063719565667,1.92857142857143,96.0986341735273,5.3388130096404,49.8289214233104,4,81.7580233365582,0,0
transformers_4.23.0,tests/utils/test_offline.py,121,34,57,0,0,0,0,0,0,0,0,0,0,0,3,100,0,0
transformers_4.23.0,tests/utils/test_image_utils.py,487,305,328,7,70,52,102,77,154,448.701295640551,5.1,4921.93414906178,273.440786058987,965.085127267015,40,43.0817551861199,0,0
transformers_4.23.0,tests/utils/test_model_card.py,84,38,57,0,0,0,0,0,0,0,0,0,0,0,7,100,0,0
transformers_4.23.0,tests/utils/test_logging.py,133,70,74,3,7,5,9,10,14,24.4063719565667,1.92857142857143,89.6920585619588,4.98289214233104,46.5069933284231,9,75.0163771356812,0,0
transformers_4.23.0,tests/utils/test_activations.py,65,40,40,4,11,10,14,15,24,46.0537478050103,2.54545454545455,238.675498204448,13.2597499002471,93.7653742946045,5,77.6212880977393,0,0
transformers_4.23.0,tests/pipelines/test_pipelines_feature_extraction.py,106,54,77,6,426,442,448,432,890,3736.49607322053,3.15492957746479,24582.7376398776,1365.70764665987,7791.84987692549,16,56.9872494781566,0,0
transformers_4.23.0,tests/pipelines/test_pipelines_object_detection.py,251,86,204,1,2,1,2,3,3,2,0.5,2.37744375108173,0.13208020839343,4.75488750216347,14,67.2079163175176,0,0
transformers_4.23.0,tests/pipelines/test_pipelines_zero_shot_image_classification.py,229,56,167,1,10,6,12,11,18,33.2192809488736,0.6,37.3618614812828,2.07565897118238,62.2697691354714,7,74.8519208845236,0,0
transformers_4.23.0,tests/pipelines/test_pipelines_common.py,979,579,717,14,75,51,97,89,148,520.464370695997,9.05333333333333,8676.79205259567,482.044002921982,958.408547783027,109,22.9545899997488,0,0
transformers_4.23.0,tests/pipelines/test_pipelines_automatic_speech_recognition.py,803,462,636,5,16,10,20,21,30,75.6096404744368,3.125,411.779758385509,22.8766532436394,131.769522683363,65,35.5405559300196,0,0
transformers_4.23.0,tests/pipelines/test_pipelines_image_to_text.py,170,66,135,0,0,0,0,0,0,0,0,0,0,0,9,100,0,0
transformers_4.23.0,tests/pipelines/test_pipelines_summarization.py,139,44,109,4,6,5,8,10,13,23.5097750043269,2.66666666666667,115.160173956095,6.39778744200529,43.1850652335357,8,71.9499777211752,0,0
transformers_4.23.0,tests/pipelines/test_pipelines_text_classification.py,186,106,132,2,13,7,14,15,21,50.1057163358342,1.07692307692308,88.3558334699157,4.90865741499532,82.0447025077789,8,63.5948242086591,0,0
transformers_4.23.0,tests/pipelines/__init__.py,0,0,0,0,0,0,0,0,0,0,0,0,0,0,1,100,0,0
transformers_4.23.0,tests/pipelines/test_pipelines_text_generation.py,295,112,237,9,17,12,24,26,36,98.0161933142366,6.35294117647059,1075.01821318427,59.7232340657927,169.215829853079,13,57.6020754641791,0,0
transformers_4.23.0,tests/pipelines/test_pipelines_zero_shot_object_detection.py,255,78,211,0,0,0,0,0,0,0,0,0,0,0,14,100,0,0
transformers_4.23.0,tests/pipelines/test_pipelines_table_question_answering.py,664,232,612,0,0,0,0,0,0,0,0,0,0,0,10,100,0,0
transformers_4.23.0,tests/pipelines/test_pipelines_fill_mask.py,402,163,327,2,5,3,6,7,9,13.6096404744368,1.2,30.3194331582221,1.68441295323456,25.2661942985184,28,55.0761631550353,0,0
transformers_4.23.0,tests/pipelines/test_pipelines_question_answering.py,483,258,384,1,5,4,8,6,12,11.6096404744368,0.8,24.8156400069231,1.37864666705128,31.0195500086539,31,47.2573523399262,0,0
transformers_4.23.0,tests/pipelines/test_pipelines_text2text_generation.py,126,51,94,0,0,0,0,0,0,0,0,0,0,0,6,100,0,0
transformers_4.23.0,tests/pipelines/test_pipelines_image_classification.py,219,69,175,0,0,0,0,0,0,0,0,0,0,0,9,100,0,0
transformers_4.23.0,tests/pipelines/test_pipelines_translation.py,174,95,132,0,0,0,0,0,0,0,0,0,0,0,13,100,0,0
transformers_4.23.0,tests/pipelines/test_pipelines_visual_question_answering.py,107,58,76,1,2,1,2,3,3,2,0.5,2.37744375108173,0.13208020839343,4.75488750216347,8,77.816718541563,0,0
transformers_4.23.0,tests/pipelines/test_pipelines_audio_classification.py,118,54,82,0,0,0,0,0,0,0,0,0,0,0,7,100,0,0
transformers_4.23.0,tests/pipelines/test_pipelines_zero_shot.py,295,104,242,2,3,2,3,5,5,6.75488750216347,1,11.6096404744368,0.644980026357601,11.6096404744368,11,62.7233080097087,0,0
transformers_4.23.0,tests/pipelines/test_pipelines_token_classification.py,815,311,711,0,0,0,0,0,0,0,0,0,0,0,32,100,0,0
transformers_4.23.0,tests/pipelines/test_pipelines_image_segmentation.py,377,136,300,2,15,11,22,17,33,60.6033589341278,1.46666666666667,197.833201516516,10.9907334175842,134.886273761261,28,52.8464212731071,0,0
transformers_4.23.0,tests/pipelines/test_pipelines_document_question_answering.py,273,114,208,1,6,3,6,7,9,15.5097750043269,0.5,12.6330971492592,0.701838730514401,25.2661942985184,10,64.9391469909809,0,0
transformers_4.23.0,tests/pipelines/test_pipelines_conversational.py,383,178,306,3,7,4,7,10,11,24.4063719565667,1.5,54.8118135656415,3.04510075364675,36.541209043761,17,59.5686384559972,0,0
transformers_4.23.0,tests/benchmark/test_benchmark.py,264,125,229,0,0,0,0,0,0,0,0,0,0,0,18,100,0,0
transformers_4.23.0,tests/benchmark/__init__.py,0,0,0,0,0,0,0,0,0,0,0,0,0,0,1,100,0,0
transformers_4.23.0,tests/benchmark/test_benchmark_tf.py,226,106,193,0,0,0,0,0,0,0,0,0,0,0,16,100,0,0
transformers_4.23.0,tests/extended/test_trainer_ext.py,377,147,281,9,40,27,50,49,77,241.406448808475,5.625,2431.8712012324,135.103955624022,432.332657996871,35,52.7634750679502,0,0
transformers_4.23.0,tests/trainer/test_trainer.py,2469,1492,1843,20,290,239,459,310,698,2458.61219800208,15.8275862068966,91431.768593468,5079.54269963711,5776.73483488142,204,0,0,0
transformers_4.23.0,tests/trainer/test_data_collator.py,864,651,657,6,77,75,133,83,208,498.052338637834,5.18181818181818,6871.13340891356,381.729633828531,1326.00820172016,81,20.6499976942789,0,0
transformers_4.23.0,tests/trainer/test_trainer_tpu.py,131,70,77,4,16,10,20,20,30,72,2.5,324.144607116552,18.0080337286973,129.657842846621,15,69.709572476659,0,0
transformers_4.23.0,tests/trainer/__init__.py,0,0,0,0,0,0,0,0,0,0,0,0,0,0,1,100,0,0
transformers_4.23.0,tests/trainer/test_trainer_callback.py,245,152,172,8,40,31,54,48,85,236.877123795494,5.4,2563.49778783101,142.41654376839,474.721812561298,40,48.7236464469182,0,0
transformers_4.23.0,tests/trainer/test_trainer_seq2seq.py,126,48,83,3,11,6,11,14,17,42.8086353071737,1.5,97.0875505124689,5.39375280624827,64.7250336749793,3,75.1124263228115,0,0
transformers_4.23.0,tests/trainer/test_trainer_distributed.py,143,75,95,7,25,16,30,32,46,135.747889198771,4.2,966,53.6666666666667,230,19,63.8016480137341,0,0
transformers_4.23.0,tests/trainer/test_trainer_utils.py,499,324,352,11,85,63,110,96,173,582.851977376715,7.11764705882353,8108.41294279976,450.467385711098,1139.19851262476,69,36.7603114287142,0,0
transformers_4.23.0,tests/deepspeed/test_model_zoo.py,367,121,240,2,14,7,14,16,21,55.3029689088065,1,84,4.66666666666667,84,10,67.6024177950422,0,0
transformers_4.23.0,tests/deepspeed/test_deepspeed.py,1141,508,762,12,90,53,100,102,153,627.286328678325,6.66666666666667,6805.87384881093,378.104102711718,1020.88107732164,72,35.9367630238135,0,0
transformers_4.23.0,tests/generation/test_generation_flax_logits_process.py,301,184,183,8,48,32,58,56,90,292.078200034615,4.83333333333333,2526.19939109506,140.344410616392,522.661942985184,11,56.472235582206,0,0
transformers_4.23.0,tests/generation/test_generation_flax_utils.py,296,195,188,9,29,24,33,38,57,169.41077387168,5.12068965517241,1531.76146336356,85.0978590757533,299.131868266284,31,48.2630780557191,0,0
transformers_4.23.0,tests/generation/test_generation_stopping_criteria.py,109,54,65,2,4,2,4,6,6,10,1,15.5097750043269,0.861654166907052,15.5097750043269,8,76.7774449780822,0,0
transformers_4.23.0,tests/generation/test_generation_beam_constraints.py,115,66,66,4,33,32,60,37,92,174.465005938829,3.63636363636364,1742.79894413769,96.8221635632047,479.269709637863,12,67.8972884972489,0,0
transformers_4.23.0,tests/generation/test_generation_tf_logits_process.py,480,292,323,11,85,66,121,96,187,582.851977376715,7.82941176470588,9641.04359730585,535.613533183658,1231.38798763486,34,44.1520546080668,0,0
transformers_4.23.0,tests/generation/test_generation_utils.py,2740,1043,2230,16,218,182,280,234,462,1757.46418280137,10.2752293577982,37361.848811938,2075.65826732989,3636.10850044753,193,0,0,0
transformers_4.23.0,tests/generation/__init__.py,0,0,0,0,0,0,0,0,0,0,0,0,0,0,1,100,0,0
transformers_4.23.0,tests/generation/test_generation_beam_search.py,572,287,385,12,80,81,133,92,214,548.773797599643,9.975,13925.5215294971,773.640084972061,1396.0422585962,48,41.3926793934983,0,0
transformers_4.23.0,tests/generation/test_generation_tf_utils.py,183,57,144,3,35,33,35,38,68,184.279793095237,1.5,535.288606371246,29.7382559095136,356.859070914164,6,66.9942632775268,0,0
transformers_4.23.0,tests/generation/test_generation_logits_process.py,555,275,348,8,80,68,114,88,182,529.754247590989,5.7,6701.01436117433,372.278575620796,1175.61655459199,20,47.6686286213708,0,0
transformers_4.23.0,tests/tokenization/test_tokenization_fast.py,176,106,106,1,2,1,2,3,3,2,0.5,2.37744375108173,0.13208020839343,4.75488750216347,20,76.0492042895211,0,0
transformers_4.23.0,tests/tokenization/test_tokenization_utils.py,287,200,208,0,0,0,0,0,0,0,0,0,0,0,25,100,0,0
transformers_4.23.0,tests/tokenization/__init__.py,0,0,0,0,0,0,0,0,0,0,0,0,0,0,1,100,0,0
transformers_4.23.0,tests/optimization/test_optimization_tf.py,100,70,71,2,5,11,12,7,23,13.6096404744368,2.4,154.96599169758,8.60922176097665,64.5691632073249,7,68.7952418304477,0,0
transformers_4.23.0,tests/optimization/__init__.py,0,0,0,0,0,0,0,0,0,0,0,0,0,0,1,100,0,0
transformers_4.23.0,tests/optimization/test_optimization.py,166,80,125,4,13,12,15,17,27,56.1057163358342,2.30769230769231,254.680377031752,14.1489098350973,110.361496713759,17,63.4495451453121,0,0
transformers_4.23.0,tests/onnx/test_onnx.py,195,116,116,2,4,3,6,6,9,10,1.5,34.8969937597356,1.93872187554087,23.2646625064904,24,70.021195390472,0,0
transformers_4.23.0,tests/onnx/test_onnx_v2.py,525,212,369,11,25,15,28,36,43,154.150152549378,6.16,1369.40973438204,76.07831857678,222.306775062019,42,50.7901062959736,0,0
transformers_4.23.0,tests/onnx/test_features.py,111,66,66,0,0,0,0,0,0,0,0,0,0,0,7,100,0,0
transformers_4.23.0,tests/onnx/__init__.py,0,0,0,0,0,0,0,0,0,0,0,0,0,0,1,100,0,0
transformers_4.23.0,utils/update_metadata.py,286,134,203,8,29,18,34,37,52,164.8814488587,4.68965517241379,1270.38807592165,70.5771153289807,270.891575012705,37,55.4344664613021,0,0
transformers_4.23.0,utils/past_ci_versions.py,141,17,134,1,4,2,4,5,6,8,0.5,6.96578428466209,0.38698801581456,13.9315685693242,3,74.9909025730058,0,0
transformers_4.23.0,utils/check_dummies.py,169,94,106,11,31,24,45,42,69,191.633833427003,7.98387096774194,2970.55808991949,165.031004995527,372.069902171734,24,60.4339472375361,0,0
transformers_4.23.0,utils/check_repo.py,800,329,637,15,194,116,221,209,337,1532.98645031843,8.54381443298969,22191.5329670098,1232.86294261166,2597.38002751126,135,27.8184907909091,0,0
transformers_4.23.0,utils/notification_service_doc_tests.py,382,221,279,16,73,52,99,89,151,515.857192798241,10.8493150684932,10608.8481161114,589.380450895079,977.835748075926,55,36.2652026661527,0,0
transformers_4.23.0,utils/download_glue_data.py,157,97,117,5,23,15,25,28,40,115.651565463748,2.71739130434783,522.538578484522,29.0299210269179,192.294196882304,18,58.5232937830922,0,0
transformers_4.23.0,utils/tests_fetcher.py,706,378,474,16,193,116,220,209,336,1529.34420819274,9.11917098445596,23615.667856722,1311.98154759567,2589.67266837918,152,25.6194650937663,0,0
transformers_4.23.0,utils/check_table.py,232,144,152,14,75,55,105,89,160,520.464370695997,9.8,10153.9500197553,564.108334430851,1036.11734895462,37,52.3766007059829,0,0
transformers_4.23.0,utils/get_github_job_time.py,68,43,39,4,13,7,14,17,21,56.1057163358342,2.15384615384615,184.879088511938,10.2710604728855,85.8367196662571,7,69.6439635489697,0,0
transformers_4.23.0,utils/check_copies.py,552,304,407,16,162,119,228,178,347,1253.05570046731,11.2592592592593,29207.4136357698,1622.6340908761,2594.07950054534,86,30.8353365729823,0,0
transformers_4.23.0,utils/notification_service.py,918,536,666,17,181,129,248,198,377,1426.95897386332,11.646408839779,33498.1866059845,1861.01036699914,2876.26744577001,165,11.4526591518694,0,0
transformers_4.23.0,utils/check_tf_ops.py,101,41,60,5,18,10,20,23,30,86.6682905003984,2.77777777777778,376.963496338084,20.9424164632269,135.70685868171,14,75.7944135602514,0,0
transformers_4.23.0,utils/check_doc_toc.py,98,53,56,5,20,12,24,25,36,98.0482023721841,3,501.53646849567,27.8631371386483,167.17882283189,20,72.2942753044921,0,0
transformers_4.23.0,utils/print_env.py,57,28,28,0,0,0,0,0,0,0,0,0,0,0,4,100,0,0
transformers_4.23.0,utils/get_modified_files.py,34,10,9,0,0,0,0,0,0,0,0,0,0,0,3,100,0,0
transformers_4.23.0,utils/check_inits.py,299,196,199,18,89,90,168,107,258,651.398925381971,16.9887640449438,29548.5315227769,1641.58508459872,1739.2984824915,72,43.6714306479462,0,0
transformers_4.23.0,utils/prepare_for_doc_test.py,148,58,56,8,26,15,27,34,42,146.211432671668,4.15384615384615,887.566594150444,49.3092552305802,213.673439332514,17,67.7676897268236,0,0
transformers_4.23.0,utils/release.py,158,100,102,5,23,17,29,28,46,115.651565463748,3.15217391304348,697.066463698353,38.7259146499085,221.13832641465,21,61.1218782072162,0,0
transformers_4.23.0,utils/custom_init_isort.py,250,157,143,15,96,72,131,111,203,690.759759003359,10.234375,14115.9297760819,784.218320893439,1379.26642086907,53,51.785467262805,0,0
transformers_4.23.0,utils/get_ci_error_statistics.py,278,197,189,13,54,32,63,67,95,358.869641452662,7.58333333333333,4370.11175429229,242.783986349571,576.278473093488,54,41.2130056991468,0,0
transformers_4.23.0,utils/check_config_docstrings.py,87,30,45,5,11,6,11,16,17,49.6633882794471,2.5,170,9.44444444444444,68,8,82.9937861003701,0,0
transformers_4.23.0,utils/check_self_hosted_runner.py,53,27,38,3,8,4,8,11,12,28.7548875021635,1.5,62.2697691354714,3.4594316186373,41.5131794236476,6,70.0207280509346,0,0
transformers_4.23.0,utils/sort_auto_mappings.py,89,51,52,8,28,22,40,36,62,158.605937817613,5.71428571428571,1831.63057193956,101.757253996642,320.535350089423,17,70.9725272595385,0,0
transformers_4.23.0,utils/test_module/custom_tokenization.py,5,3,3,0,0,0,0,0,0,0,0,0,0,0,1,100,0,0
transformers_4.23.0,utils/test_module/__init__.py,0,0,0,0,0,0,0,0,0,0,0,0,0,0,1,100,0,0
transformers_4.23.0,utils/test_module/custom_processing.py,6,4,4,0,0,0,0,0,0,0,0,0,0,0,1,100,0,0
transformers_4.23.0,utils/test_module/custom_tokenization_fast.py,8,5,5,0,0,0,0,0,0,0,0,0,0,0,1,100,0,0
transformers_4.23.0,utils/test_module/custom_feature_extraction.py,5,3,3,0,0,0,0,0,0,0,0,0,0,0,1,100,0,0
transformers_4.23.0,utils/test_module/custom_modeling.py,33,21,21,0,0,0,0,0,0,0,0,0,0,0,7,100,0,0
transformers_4.23.0,utils/test_module/custom_pipeline.py,33,25,24,4,7,5,8,11,13,27.6514844544032,2.28571428571429,102.794539525223,5.71080775140125,44.9726110422849,6,57.1244050293025,0,0
transformers_4.23.0,utils/test_module/custom_configuration.py,16,10,10,0,0,0,0,0,0,0,0,0,0,0,3,100,0,0
transformers_4.23.0,scripts/check_tokenizers.py,169,118,123,11,67,53,106,78,159,444.481723565681,8.70149253731343,8696.08849972946,483.116027762748,999.378952799098,42,46.9666284537726,0,0
transformers_4.23.0,scripts/stale.py,66,19,39,8,31,18,38,39,56,177.580085621993,4.90322580645161,1451.26915119211,80.6260639551173,295.982524256286,15,81.7973011670692,0,0
transformers_4.23.0,scripts/pegasus/build_test_sample_spm_no_bos.py,33,2,2,0,0,0,0,0,0,0,0,0,0,0,1,100,0,0
transformers_4.23.0,scripts/benchmark/trainer-benchmark.py,448,174,251,14,77,48,92,91,140,535.845532542314,8.36363636363636,7620.03590597811,423.335328109895,911.091249627818,33,55.164742932217,0,0
transformers_4.23.0,scripts/distributed/torch-distributed-gpu-test.py,92,33,32,1,2,1,2,3,3,2,0.5,2.37744375108173,0.13208020839343,4.75488750216347,3,80.216177384299,0,0
transformers_4.23.0,scripts/fsmt/gen-card-facebook-wmt19.py,164,20,107,1,6,3,6,7,9,15.5097750043269,0.5,12.6330971492592,0.701838730514401,25.2661942985184,2,83.937937049477,0,0
transformers_4.23.0,scripts/fsmt/gen-card-allenai-wmt19.py,152,19,97,1,6,3,6,7,9,15.5097750043269,0.5,12.6330971492592,0.701838730514401,25.2661942985184,2,85.2267104798243,0,0
transformers_4.23.0,scripts/fsmt/fsmt-make-super-tiny-model.py,87,31,42,1,4,3,6,5,9,8,0.75,15.6730146404897,0.870723035582761,20.8973528539863,1,86.6908735221516,0,0
transformers_4.23.0,scripts/fsmt/gen-card-allenai-wmt16.py,155,19,100,1,6,3,6,7,9,15.5097750043269,0.5,12.6330971492592,0.701838730514401,25.2661942985184,2,84.9780137675216,0,0
transformers_4.23.0,scripts/fsmt/fsmt-make-tiny-model.py,59,15,19,0,0,0,0,0,0,0,0,0,0,0,1,100,0,0
transformers_4.23.0,examples/flax/test_flax_examples.py,257,97,210,2,4,2,4,6,6,10,1,15.5097750043269,0.861654166907052,15.5097750043269,12,62.0874887453788,0,0
transformers_4.23.0,examples/flax/conftest.py,45,14,14,0,0,0,0,0,0,0,0,0,0,0,2,100,0,0
transformers_4.23.0,examples/flax/text-classification/run_flax_glue.py,666,339,493,19,131,99,190,150,289,1002.08903595683,13.7786259541985,28785.3215710208,1599.18453172338,2089.12860155331,73,33.3074761461806,0,0
transformers_4.23.0,examples/flax/image-captioning/run_image_captioning_flax.py,1256,660,923,18,199,173,318,217,491,1594.74694951415,14.3819095477387,54808.3305376017,3044.90725208898,3810.92165513024,111,20.8030022458641,0,0
transformers_4.23.0,examples/flax/image-captioning/create_model_from_encoder_decoder_models.py,122,48,72,2,5,3,6,7,9,13.6096404744368,1.2,30.3194331582221,1.68441295323456,25.2661942985184,6,81.1456359708442,0,0
transformers_4.23.0,examples/flax/token-classification/run_flax_ner.py,799,437,610,18,126,95,178,144,273,954.195920386951,12.7142857142857,24886.8096800063,1382.60053777813,1957.38952539375,77,29.6117892303176,0,0
transformers_4.23.0,examples/flax/summarization/run_summarization_flax.py,982,522,751,15,135,104,196,150,300,1013.97346453599,10.8888888888889,23614.1410556199,1311.89672531222,2168.64560714876,101,24.7512772931831,0,0
transformers_4.23.0,examples/flax/question-answering/utils_qa.py,443,190,250,15,131,94,182,146,276,979.981772135534,10.4198473282443,20677.0572848279,1148.72540471266,1984.39157825088,83,45.2713819160691,0,0
transformers_4.23.0,examples/flax/question-answering/run_qa.py,1066,519,746,20,162,128,245,182,373,1275.49426236506,15.1234567901235,42351.8403206517,2352.88001781398,2800.40740079411,92,29.2279772673845,0,0
transformers_4.23.0,examples/flax/vision/run_image_classification.py,570,284,421,11,66,38,76,77,114,436.983759682668,6.33333333333333,4524.61988238172,251.367771243429,714.413665639219,43,42.4673196511632,0,0
transformers_4.23.0,examples/flax/language-modeling/run_mlm_flax.py,888,423,623,19,138,101,188,157,289,1061.68699779082,12.9420289855072,27283.6788262566,1515.75993479203,2108.14539642968,92,31.7676819401231,0,0
transformers_4.23.0,examples/flax/language-modeling/run_bart_dlm_flax.py,964,504,682,21,182,137,257,203,394,1458.65729039452,14.8269230769231,44779.4183251348,2487.74546250749,3020.14235137096,111,26.2642657691817,0,0
transformers_4.23.0,examples/flax/language-modeling/run_clm_flax.py,842,438,633,17,130,94,181,147,275,982.394683994955,11.8346153846154,23431.4721015073,1301.74845008374,1979.90989483,97,28.5542744930335,0,0
transformers_4.23.0,examples/flax/language-modeling/t5_tokenizer_model.py,112,38,82,1,2,1,2,3,3,2,0.5,2.37744375108173,0.13208020839343,4.75488750216347,7,75.3999153073977,0,0
transformers_4.23.0,examples/flax/language-modeling/run_t5_mlm_flax.py,991,467,653,20,162,127,235,182,362,1275.49426236506,14.5061728395062,39425.190743315,2190.28837462861,2717.82165975193,97,31.2586926924481,0,0
transformers_4.23.0,examples/tensorflow/test_tensorflow_examples.py,296,110,240,2,6,3,6,8,9,17.5097750043269,1,27,1.5,27,15,58.7491417379867,0,0
transformers_4.23.0,examples/tensorflow/text-classification/run_glue.py,586,273,418,13,72,57,106,85,163,492.340316439681,9.56944444444444,9997.49260923357,555.416256068532,1044.73072259045,77,40.2548973500782,0,0
transformers_4.23.0,examples/tensorflow/text-classification/run_text_classification.py,564,264,398,14,106,85,155,120,240,766.462537092506,10.2358490566038,16967.49350091,942.638527828333,1657.65374294604,84,39.1822697633134,0,0
transformers_4.23.0,examples/tensorflow/multiple-choice/run_swag.py,554,229,379,14,65,54,96,79,150,444.756876755656,10.3384615384615,9775.70922178849,543.094956766027,945.567112226565,58,46.2217548742627,0,0
transformers_4.23.0,examples/tensorflow/token-classification/run_ner.py,588,280,423,11,59,56,97,70,153,385.129687717359,9.04237288135593,8479.75916779053,471.097731543919,937.78030159258,50,43.8819735245755,0,0
transformers_4.23.0,examples/tensorflow/summarization/run_summarization.py,725,307,537,12,93,82,148,105,230,651.161319441701,9.54838709677419,14745.3495110552,819.186083947508,1544.27646906321,77,36.99574511863,0,0
transformers_4.23.0,examples/tensorflow/question-answering/utils_qa.py,443,190,250,15,131,94,182,146,276,979.981772135534,10.4198473282443,20677.0572848279,1148.72540471266,1984.39157825088,83,45.2713819160691,0,0
transformers_4.23.0,examples/tensorflow/question-answering/run_qa.py,801,338,561,18,96,91,165,114,256,707.215050095193,15.46875,27058.2444560924,1503.23580311624,1749.21984362617,77,37.4405536471692,0,0
transformers_4.23.0,examples/tensorflow/translation/run_translation.py,690,295,509,12,92,78,141,104,219,643.187249965899,9.19565217391304,13493.6659602051,749.648108900285,1467.3962982729,76,37.6629994243439,0,0
transformers_4.23.0,examples/tensorflow/language-modeling/run_clm.py,614,267,450,15,80,79,146,95,225,564.357606525117,13.6875,20233.1021937817,1124.06123298787,1478.21751187446,69,40.2116858519593,0,0
transformers_4.23.0,examples/tensorflow/language-modeling/run_mlm.py,637,276,465,15,87,83,152,102,235,619.139443072967,13.1034482758621,20546.4683806226,1141.47046559014,1568.0199553633,70,39.7630226805167,0,0
transformers_4.23.0,examples/tensorflow/benchmarking/plot_csv_file.py,178,99,126,7,14,10,18,21,28,72.9544533632097,4.5,553.431995270124,30.7462219594513,122.984887837805,25,59.9601780008079,0,0
transformers_4.23.0,examples/tensorflow/benchmarking/run_benchmark_tf.py,48,27,24,5,12,8,14,17,22,54.6291904830907,2.91666666666667,262.278865646897,14.5710480914943,89.9241825075075,6,82.7995569673769,0,0
transformers_4.23.0,examples/pytorch/conftest.py,45,14,14,0,0,0,0,0,0,0,0,0,0,0,2,100,0,0
transformers_4.23.0,examples/pytorch/test_accelerate_examples.py,333,155,271,4,30,15,30,34,45,155.206717868256,2,457.871655712531,25.4373142062517,228.935827856265,20,48.2570587609958,0,0
transformers_4.23.0,examples/pytorch/test_pytorch_examples.py,588,216,497,6,22,11,22,28,33,113.617270614347,3,475.928137283703,26.4404520713168,158.642712427901,39,39.657051667495,0,0
transformers_4.23.0,examples/pytorch/xla_spawn.py,83,23,34,2,6,3,6,8,9,17.5097750043269,1,27,1.5,27,2,87.2054647193187,0,0
transformers_4.23.0,examples/pytorch/test_xla_examples.py,94,38,61,1,2,1,2,3,3,2,0.5,2.37744375108173,0.13208020839343,4.75488750216347,4,85.2889945460733,0,0
transformers_4.23.0,examples/pytorch/text-classification/run_glue.py,622,315,468,15,116,101,192,131,293,854.129154368926,12.4137931034483,25582.2571793852,1421.23650996584,2060.79293945047,107,30.9661736810388,1,1
transformers_4.23.0,examples/pytorch/text-classification/run_xnli.py,436,172,330,10,25,23,42,35,65,149.315685693242,8.4,2800.58852725195,155.588251513997,333.403396101423,43,50.1087896884428,1,1
transformers_4.23.0,examples/pytorch/text-classification/run_glue_no_trainer.py,633,324,491,19,112,111,210,131,321,843.13437402588,17.8125,40215.7939559783,2234.21077533213,2257.72878349352,103,29.7032813691871,1,1
transformers_4.23.0,examples/pytorch/multiple-choice/run_swag_no_trainer.py,658,307,484,18,70,65,122,88,187,504.108461212109,15.6857142857143,18946.989378976,1052.61052105422,1207.91371268517,79,37.4230971951191,1,1
transformers_4.23.0,examples/pytorch/multiple-choice/run_swag.py,480,198,338,13,54,45,83,67,128,358.869641452662,9.99074074074074,7757.40472474541,430.966929152523,776.459416378595,55,47.5593627171701,0,0
transformers_4.23.0,examples/pytorch/text-generation/run_generation.py,290,125,193,9,50,32,60,59,92,310.722134501717,5.4,2922.49706692296,162.360948162387,541.20316054129,32,54.6843841082088,0,0
transformers_4.23.0,examples/pytorch/token-classification/run_ner_no_trainer.py,770,389,606,20,113,102,190,133,292,857.118784650664,16.8141592920354,34639.5636744784,1924.42020413769,2060.14247116635,101,28.271429321539,1,1
transformers_4.23.0,examples/pytorch/token-classification/run_ner.py,630,305,480,12,80,67,122,92,189,548.773797599643,9.15,11281.5218687072,626.751214928178,1232.95320969478,80,35.7901454297516,1,1
transformers_4.23.0,examples/pytorch/summarization/run_summarization_no_trainer.py,759,340,610,18,97,92,172,115,264,715.250195718113,15.9587628865979,28840.8258773148,1602.26810429527,1807.20937344932,91,29.3665189489927,2,1
transformers_4.23.0,examples/pytorch/summarization/run_summarization.py,732,324,580,13,93,84,156,106,240,656.247485768881,10.9032258064516,17605.4486217473,978.080478985962,1614.70090909517,90,30.5990487961151,1,1
transformers_4.23.0,examples/pytorch/image-classification/run_image_classification.py,388,166,290,12,50,35,69,62,104,325.21235949739,8.28,5127.27752680035,284.848751488908,619.236416280235,44,47.9355501195484,1,1
transformers_4.23.0,examples/pytorch/image-classification/run_image_classification_no_trainer.py,576,270,450,19,77,71,139,96,210,563.253186388936,17.1493506493506,23714.8444969153,1317.49136093974,1382.84212515144,73,35.6176916504501,1,1
transformers_4.23.0,examples/pytorch/image-pretraining/run_mae.py,384,184,282,13,53,36,71,66,107,351.685500427684,8.70754716981132,5631.6076190751,312.867089948616,646.750170771355,47,47.4661903876407,0,0
transformers_4.23.0,examples/pytorch/image-pretraining/run_mim.py,467,220,346,16,62,45,89,78,134,433.160171243986,11.4838709677419,9672.22024027757,537.34556890431,842.243897327541,57,43.2345205648342,0,0
transformers_4.23.0,examples/pytorch/question-answering/utils_qa.py,443,190,250,15,131,94,182,146,276,979.981772135534,10.4198473282443,20677.0572848279,1148.72540471266,1984.39157825088,83,45.2713819160691,0,0
transformers_4.23.0,examples/pytorch/question-answering/run_qa_beam_search_no_trainer.py,1014,465,732,20,137,134,243,157,377,1058.86895726334,17.7372262773723,48778.649739176,2709.92498550978,2750.07202233214,95,29.3450128042833,1,1
transformers_4.23.0,examples/pytorch/question-answering/trainer_seq2seq_qa.py,141,63,96,7,22,17,32,29,49,117.758980064424,5.09090909090909,1211.84544096637,67.3247467203538,238.041068761251,23,67.0582338312984,0,0
transformers_4.23.0,examples/pytorch/question-answering/trainer_qa.py,105,52,65,5,16,13,24,21,37,75.6096404744368,3.75,609.434042410553,33.8574468005863,162.515744642814,21,72.5166546044194,0,0
transformers_4.23.0,examples/pytorch/question-answering/run_qa_beam_search.py,714,304,522,16,101,90,169,117,259,736.479359757931,13.3861386138614,23819.6225062087,1323.31236145604,1779.4244623721,68,38.3685555790612,1,1
transformers_4.23.0,examples/pytorch/question-answering/run_seq2seq_qa.py,715,320,548,11,85,82,152,96,234,582.851977376715,9.83529411764706,15155.020049895,841.9455583275,1540.88122516875,83,33.8162411411502,1,1
transformers_4.23.0,examples/pytorch/question-answering/run_qa.py,681,285,493,15,87,81,152,102,233,619.139443072967,13.1034482758621,20371.6048199364,1131.7558233298,1554.67510467936,69,39.5062544778766,1,1
transformers_4.23.0,examples/pytorch/question-answering/run_qa_no_trainer.py,992,441,715,20,124,121,225,144,346,948.75890438572,18.1451612903226,45014.4081743777,2500.8004541321,2480.79405049904,103,29.077279362022,1,1
transformers_4.23.0,examples/pytorch/speech-recognition/run_speech_recognition_seq2seq.py,524,223,373,11,45,34,65,56,99,285.187137139846,7.94444444444444,4567.48464619831,253.749147011017,574.928137283703,50,46.7725607451904,1,1
transformers_4.23.0,examples/pytorch/speech-recognition/run_speech_recognition_ctc.py,772,301,544,14,62,46,86,76,132,422.463140152793,9.70967741935484,8007.82761174647,444.879311763693,824.726431774553,51,43.0865379636882,1,1
transformers_4.23.0,examples/pytorch/translation/run_translation.py,656,293,504,12,89,79,146,101,225,619.359825364663,9.84269662921348,14745.3200365211,819.184446473395,1498.09758361915,83,34.0704841827038,1,1
transformers_4.23.0,examples/pytorch/translation/run_translation_no_trainer.py,750,334,579,19,108,104,196,127,300,810.238472989083,17.2407407407407,36147.0302410272,2008.16834672373,2096.60540603165,94,30.2725199465469,1,1
transformers_4.23.0,examples/pytorch/semantic-segmentation/run_semantic_segmentation.py,512,265,374,14,64,46,89,78,135,437.302968908806,9.734375,8259.90240027202,458.883466681779,848.529299546404,68,38.7849938191208,1,1
transformers_4.23.0,examples/pytorch/semantic-segmentation/run_semantic_segmentation_no_trainer.py,684,359,527,19,80,72,139,99,211,586.464870346417,16.50625,23088.8475368499,1282.71375204722,1398.7942468368,88,29.2183761056945,1,1
transformers_4.23.0,examples/pytorch/audio-classification/run_audio_classification.py,411,176,307,15,45,32,61,60,93,305.736748268963,10.1666666666667,5584.96505814786,310.27583656377,549.340825391592,39,48.7635857800171,1,1
transformers_4.23.0,examples/pytorch/language-modeling/run_plm.py,553,240,420,16,74,61,115,90,176,523.499549056542,12.4324324324324,14204.8763967257,789.159799818094,1142.56614495402,66,40.5652937763967,0,0
transformers_4.23.0,examples/pytorch/language-modeling/run_clm_no_trainer.py,670,308,516,19,91,88,166,110,254,672.91993501351,17.3296703296703,29849.7569684617,1658.3198315812,1722.46536723526,81,34.0489346485133,0,0
transformers_4.23.0,examples/pytorch/language-modeling/run_mlm_no_trainer.py,715,319,547,19,97,92,173,116,265,720.90216844758,16.9432989690722,30792.1579160353,1710.67543977974,1817.36496370881,84,33.8259385419715,0,0
transformers_4.23.0,examples/pytorch/language-modeling/run_clm.py,580,258,437,17,82,72,132,99,204,590.806132679939,13.6829268292683,18504.6363177656,1028.03535098698,1352.38875049624,74,38.375999974074,1,1
transformers_4.23.0,examples/pytorch/language-modeling/run_mlm.py,613,266,465,15,89,75,136,104,211,634.943634290137,11.4606741573034,16203.0183835767,900.167687976483,1413.79278052777,77,37.8014157978928,1,1
transformers_4.23.0,examples/pytorch/speech-pretraining/run_wav2vec2_pretraining_no_trainer.py,741,295,544,18,104,89,171,122,260,771.904380712635,14.7980769230769,26666.0119062732,1481.44510590407,1801.99170776635,66,37.3033518956557,0,0
transformers_4.23.0,examples/pytorch/contrastive-image-text/run_clip.py,531,257,399,12,55,57,105,67,162,360.99433425251,11.4545454545455,11256.4556868749,625.358649270829,982.706448854159,72,39.2180601180647,0,0
transformers_4.23.0,examples/pytorch/benchmarking/plot_csv_file.py,178,99,126,7,14,10,18,21,28,72.9544533632097,4.5,553.431995270124,30.7462219594513,122.984887837805,25,59.9601780008079,0,0
transformers_4.23.0,examples/pytorch/benchmarking/run_benchmark.py,48,26,23,5,12,8,14,17,22,54.6291904830907,2.91666666666667,262.278865646897,14.5710480914943,89.9241825075075,6,82.8856038242335,0,0
transformers_4.23.0,examples/research_projects/movement-pruning/counts_parameters.py,97,44,66,10,30,21,41,40,62,180.425998817129,6.83333333333333,2254.72353620061,125.262418677812,329.959541883016,10,71.383321784432,0,0
transformers_4.23.0,examples/research_projects/movement-pruning/masked_run_glue.py,964,468,800,19,325,280,523,344,803,2792.60679282807,15.2876923076923,103440.96872705,5746.72048483609,6766.29059802579,173,8.69012906127323,0,0
transformers_4.23.0,examples/research_projects/movement-pruning/masked_run_squad.py,1149,511,935,20,327,281,522,347,803,2817.91757383562,15.9633027522936,108172.924332655,6009.60690736972,6776.34985762034,183,6.4063666158778,0,0
transformers_4.23.0,examples/research_projects/movement-pruning/bertarize.py,137,76,103,9,32,29,54,41,83,188.529325012981,7.59375,3376.76457441069,187.598031911705,444.676816383301,18,60.286510975837,0,0
transformers_4.23.0,examples/research_projects/movement-pruning/emmental/modeling_bert_masked.py,1019,429,667,15,112,133,224,127,357,821.027110204579,15,37424.406497665,2079.13369431472,2494.96043317766,96,32.8414524720457,0,0
transformers_4.23.0,examples/research_projects/movement-pruning/emmental/__init__.py,10,3,9,0,0,0,0,0,0,0,0,0,0,0,1,100,0,0
transformers_4.23.0,examples/research_projects/movement-pruning/emmental/configuration_bert_masked.py,71,24,41,0,0,0,0,0,0,0,0,0,0,0,2,100,0,0
transformers_4.23.0,examples/research_projects/movement-pruning/emmental/modules/__init__.py,3,2,2,0,0,0,0,0,0,0,0,0,0,0,1,100,0,0
transformers_4.23.0,examples/research_projects/movement-pruning/emmental/modules/masked_nn.py,106,44,49,7,32,21,40,39,61,179.651484454403,4.375,1410.54171715886,78.3634287310479,322.409535350597,14,70.6379598448219,0,0
transformers_4.23.0,examples/research_projects/movement-pruning/emmental/modules/binarizer.py,144,52,41,5,13,9,18,18,27,59.715356810271,3.46153846153846,389.727605904031,21.6515336613351,112.587975038942,8,51.2244264788087,0,0
transformers_4.23.0,examples/research_projects/quantization-qdqbert/trainer_quant_qa.py,212,104,139,8,28,21,40,36,61,158.605937817613,5.71428571428571,1802.08814335989,100.116007964438,315.365425087981,33,59.493769604741,0,0
transformers_4.23.0,examples/research_projects/quantization-qdqbert/utils_qa.py,434,189,243,15,124,89,169,139,258,920.923701422101,10.2217741935484,18774.1977007797,1043.01098337665,1836.68679676267,79,46.1003680338296,0,0
transformers_4.23.0,examples/research_projects/quantization-qdqbert/run_quant_qa.py,688,295,495,16,86,86,162,102,248,616.65876890438,15.0697674418605,24936.8707478183,1385.38170821213,1654.76148480893,74,38.2853974327079,0,0
transformers_4.23.0,examples/research_projects/quantization-qdqbert/ort-infer-benchmark.py,51,29,43,3,6,3,6,9,9,20.2646625064904,1.5,42.7939875194712,2.37744375108173,28.5293250129808,2,57.6403266213612,0,0
transformers_4.23.0,examples/research_projects/quantization-qdqbert/quant_trainer.py,305,210,202,11,55,34,61,66,95,356.028532048867,6.1,3502.72639216822,194.595910676012,574.217441339053,63,41.6423765812851,0,0
transformers_4.23.0,examples/research_projects/quantization-qdqbert/evaluate-hf-trt-qa.py,458,190,309,12,36,28,50,48,78,229.136850060577,8.33333333333333,3630.22562546875,201.679201414931,435.62707505625,42,50.986460708139,0,0
transformers_4.23.0,examples/research_projects/adversarial/run_hans.py,242,85,166,8,25,14,27,33,41,140.096404744368,4.32,893.463086420769,49.6368381344872,206.820158893697,20,64.2577673543155,0,0
transformers_4.23.0,examples/research_projects/adversarial/utils_hans.py,340,142,207,6,25,14,27,31,41,131.606179748695,3.24,658.115437871793,36.5619687706551,203.122048725862,31,59.8408147683371,0,0
transformers_4.23.0,examples/research_projects/longform-qa/eli5_app.py,351,166,316,10,46,31,60,56,91,287.303130927496,6.52173913043478,3446.53889939506,191.474383299725,528.469297907242,34,34.6859259183569,0,0
transformers_4.23.0,examples/research_projects/longform-qa/eli5_utils.py,688,403,582,19,196,129,254,215,383,1573.19375220201,12.3112244897959,36534.271018065,2029.68172322583,2967.55786139276,105,20.6616896760081,0,0
transformers_4.23.0,examples/research_projects/performer/run_mlm_performer.py,692,317,438,19,140,105,196,159,301,1078.81024512772,13.3,29275.6643348899,1626.42579638277,2201.17776954059,59,41.4431261652499,0,0
transformers_4.23.0,examples/research_projects/performer/modeling_flax_performer.py,553,287,384,11,44,38,66,55,104,278.268739025051,8.25,4960.40663420416,275.578146344675,601.261410206565,41,43.7958502331159,0,0
transformers_4.23.0,examples/research_projects/performer/modeling_flax_performer_utils.py,660,309,433,14,146,128,238,160,366,1103.01735450529,11.4109589041096,30579.3807357955,1698.85448532197,2679.82568272877,39,43.4028711491159,0,0
transformers_4.23.0,examples/research_projects/bert-loses-patience/run_glue_with_pabee.py,755,376,611,16,174,152,275,190,427,1359.07216827768,12.6436781609195,40868.5193015293,2270.4732945294,3232.32834475731,123,20.5124152791131,0,0
transformers_4.23.0,examples/research_projects/bert-loses-patience/test_run_glue_with_pabee.py,50,23,40,0,0,0,0,0,0,0,0,0,0,0,3,100,0,0
transformers_4.23.0,examples/research_projects/bert-loses-patience/pabee/__init__.py,0,0,0,0,0,0,0,0,0,0,0,0,0,0,1,100,0,0
transformers_4.23.0,examples/research_projects/bert-loses-patience/pabee/modeling_pabee_bert.py,346,139,195,10,43,47,88,53,135,266.548665401064,10.2325581395349,7912.52267444312,439.584593024618,773.269261366032,37,57.0060047948014,0,0
transformers_4.23.0,examples/research_projects/bert-loses-patience/pabee/modeling_pabee_albert.py,320,141,197,10,52,54,101,62,155,329.64214629221,9.71153846153846,8962.78300376025,497.932389097791,922.900428109966,35,55.5739082426198,0,0
transformers_4.23.0,examples/research_projects/tapex/run_wikisql_with_tapex.py,649,296,497,12,78,66,120,90,186,533.280923079909,9.23076923076923,11146.012393083,619.22291072683,1207.48467591732,65,37.4741894302296,0,0
transformers_4.23.0,examples/research_projects/tapex/run_wikitablequestions_with_tapex.py,625,275,478,12,78,66,120,90,186,533.280923079909,9.23076923076923,11146.012393083,619.22291072683,1207.48467591732,65,38.1814953240232,0,0
transformers_4.23.0,examples/research_projects/tapex/wikisql_utils.py,257,161,155,12,61,44,82,73,126,404.79452759999,8.0655737704918,6290.48531236213,349.471406242341,779.917894418882,51,49.5485903715576,0,0
transformers_4.23.0,examples/research_projects/tapex/run_tabfact_with_tapex.py,471,220,334,12,60,47,88,72,135,397.432985745165,8.8,7329.87090171347,407.215050095193,832.939875194712,58,45.4757484328647,0,0
transformers_4.23.0,examples/research_projects/zero-shot-distillation/distill_classifier.py,338,169,269,11,46,36,60,57,96,292.137597783633,7.17391304347826,4017.08599236389,223.171444020216,559.957441359815,31,43.6440768164196,0,0
transformers_4.23.0,examples/research_projects/codeparrot/scripts/validation_loss.py,99,74,74,7,18,11,21,25,32,94.7101344803648,4.08333333333333,606.797208797231,33.7109560442906,148.603398072791,14,59.5313439346418,0,0
transformers_4.23.0,examples/research_projects/codeparrot/scripts/pretokenizing.py,49,24,40,3,8,5,10,11,15,28.7548875021635,1.875,97.296514274174,5.40536190412078,51.8914742795595,2,57.6139909499438,0,0
transformers_4.23.0,examples/research_projects/codeparrot/scripts/human_eval.py,228,112,130,8,22,13,24,30,37,122.107495610021,4.36363636363636,792.239790709157,44.0133217060643,181.554952037515,22,64.5758906156623,0,0
transformers_4.23.0,examples/research_projects/codeparrot/scripts/codeparrot_training.py,326,231,262,16,92,59,115,108,174,664.167699957245,10,11753.5042537644,652.972458542469,1175.35042537644,43,40.0219461271822,0,0
transformers_4.23.0,examples/research_projects/codeparrot/scripts/preprocessing.py,215,175,149,12,60,36,71,72,107,397.432985745165,7.1,4687.29202359572,260.405112421985,660.181975154327,34,44.6223193477306,0,0
transformers_4.23.0,examples/research_projects/codeparrot/scripts/initialize_model.py,26,10,13,0,0,0,0,0,0,0,0,0,0,0,1,100,0,0
transformers_4.23.0,examples/research_projects/codeparrot/scripts/bpe_training.py,32,16,18,0,0,0,0,0,0,0,0,0,0,0,3,100,0,0
transformers_4.23.0,examples/research_projects/codeparrot/scripts/arguments.py,220,159,178,1,1,3,3,2,6,0,1.5,9,0.5,6,1,65.4931334460374,0,0
transformers_4.23.0,examples/research_projects/codeparrot/scripts/minhash_deduplication.py,269,126,131,11,32,17,34,43,51,198.05374780501,5.84375,1617.19646767481,89.8442482041561,276.739502489807,34,61.4358428955048,0,0
transformers_4.23.0,examples/research_projects/codeparrot/scripts/tests/__init__.py,0,0,0,0,0,0,0,0,0,0,0,0,0,0,1,100,0,0
transformers_4.23.0,examples/research_projects/codeparrot/scripts/tests/test_deduplicate.py,30,20,23,1,5,3,6,6,9,11.6096404744368,0.6,13.9587975038942,0.775488750216347,23.2646625064904,3,61.6462410287617,0,0
transformers_4.23.0,examples/research_projects/codeparrot/examples/train_complexity_predictor.py,132,65,108,1,2,1,2,3,3,2,0.5,2.37744375108173,0.13208020839343,4.75488750216347,7,54.7703078573012,0,0
transformers_4.23.0,examples/research_projects/fsner/setup.py,27,5,24,0,0,0,0,0,0,0,0,0,0,0,1,100,0,0
transformers_4.23.0,examples/research_projects/fsner/src/fsner/__init__.py,5,3,3,0,0,0,0,0,0,0,0,0,0,0,1,100,0,0
transformers_4.23.0,examples/research_projects/fsner/src/fsner/tokenizer_utils.py,102,45,63,5,16,8,16,21,24,75.6096404744368,2.5,263.539045366726,14.6410580759292,105.41561814669,19,75.2199636645161,0,0
transformers_4.23.0,examples/research_projects/fsner/src/fsner/model.py,80,47,43,5,13,10,20,18,30,59.715356810271,3.84615384615385,481.145192474113,26.7302884707841,125.097750043269,9,76.098077250786,0,0
transformers_4.23.0,examples/research_projects/bertology/run_prune_gpt.py,391,195,294,17,97,77,136,114,213,709.678413993407,11.9175257731959,17344.8334268841,963.601857049116,1455.40557301709,45,42.666112857791,0,0
transformers_4.23.0,examples/research_projects/bertology/run_bertology.py,452,206,327,18,105,83,147,123,230,780.054429380905,12.6,20119.4070364731,1117.74483535962,1596.77833622803,46,44.3640392624022,0,0
transformers_4.23.0,examples/research_projects/robust-speech-event/eval.py,137,63,83,5,14,9,17,19,26,64.9126093832433,3.03571428571429,335.282850168226,18.6268250093459,110.446115349533,6,70.1035272989544,0,0
transformers_4.23.0,examples/research_projects/robust-speech-event/run_speech_recognition_ctc_bnb.py,781,302,556,14,64,48,90,78,138,437.302968908806,9.84375,8538.32607668569,474.35144870476,867.38550620299,55,41.9271503741211,0,0
transformers_4.23.0,examples/research_projects/robust-speech-event/run_speech_recognition_ctc_streaming.py,680,275,493,12,56,36,67,68,103,368.23142564388,7.17857142857143,4501.02654294306,250.057030163504,627.008672648785,42,45.2087207685558,0,0
transformers_4.23.0,examples/research_projects/jax-projects/model_parallel/run_clm_mp.py,664,326,481,15,116,86,162,131,248,854.129154368926,10.4741379310345,18269.9225760626,1014.99569867015,1744.28890438129,61,37.2909064588901,0,0
transformers_4.23.0,examples/research_projects/jax-projects/model_parallel/partitions.py,85,35,47,4,10,5,10,14,15,41.2192809488736,2,114.220647661728,6.34559153676267,57.1103238308641,8,82.1290811392078,0,0
transformers_4.23.0,examples/research_projects/jax-projects/big_bird/bigbird_flax.py,321,255,249,12,60,39,72,72,111,397.432985745165,7.2,4931.0040611527,273.944670064039,684.861675160097,23,36.8909136542936,0,0
transformers_4.23.0,examples/research_projects/jax-projects/big_bird/evaluate.py,165,108,119,17,74,47,89,91,136,528.986417357798,10.222972972973,9047.94518597571,502.663621443095,885.060071067023,21,46.2674168393145,0,0
transformers_4.23.0,examples/research_projects/jax-projects/big_bird/train.py,78,47,62,6,18,10,20,24,30,90.5684250302886,3.33333333333333,458.496250072116,25.4720138928953,137.548875021635,4,58.6457107662884,0,0
transformers_4.23.0,examples/research_projects/jax-projects/big_bird/prepare_natural_questions.py,330,207,264,14,95,87,151,109,238,677.439251700246,11.1263157894737,17922.5795562824,995.698864237914,1610.82786929691,48,38.2692622337096,0,0
transformers_4.23.0,examples/research_projects/jax-projects/dataset-streaming/run_mlm_flax_stream.py,636,296,416,19,112,78,146,131,224,843.13437402588,12.3839285714286,19510.7154062649,1083.92863368138,1575.48675234439,53,42.4916987607983,0,0
transformers_4.23.0,examples/research_projects/jax-projects/wav2vec2/run_wav2vec2_pretrain_flax.py,614,268,425,18,110,77,137,128,214,821.008218513674,11.2090909090909,16791.2181818182,932.845454545455,1498,28,44.3160486277951,0,0
transformers_4.23.0,examples/research_projects/jax-projects/hybrid_clip/configuration_hybrid_clip.py,112,40,37,2,6,4,8,8,12,17.5097750043269,1.33333333333333,48,2.66666666666667,36,8,75.652735932817,0,0
transformers_4.23.0,examples/research_projects/jax-projects/hybrid_clip/modeling_hybrid_clip.py,423,147,259,10,45,38,67,55,105,280.352670283709,7.44444444444444,4519.09617607178,251.060898670654,607.042769920089,40,55.394699649548,0,0
transformers_4.23.0,examples/research_projects/jax-projects/hybrid_clip/run_hybrid_clip.py,579,268,409,11,68,45,88,79,133,452.001221010033,7.11764705882353,5967.45550473024,331.525305818347,838.402839507555,43,43.7718284480901,0,0
transformers_4.23.0,examples/research_projects/deebert/test_glue_deebert.py,104,36,84,1,2,1,2,3,3,2,0.5,2.37744375108173,0.13208020839343,4.75488750216347,6,75.8800371103732,0,0
transformers_4.23.0,examples/research_projects/deebert/run_glue_deebert.py,735,409,618,18,218,187,338,236,525,1768.52283282733,13.954128440367,57747.5921191896,3208.1995621772,4138.38760091497,146,13.7286600226157,0,0
transformers_4.23.0,examples/research_projects/deebert/src/modeling_highway_roberta.py,156,76,103,6,17,23,33,23,56,84.9966433055827,5.82352941176471,1475.21338143412,81.9562989685624,253.319469539193,14,67.0062222619852,0,0
transformers_4.23.0,examples/research_projects/deebert/src/__init__.py,0,0,0,0,0,0,0,0,0,0,0,0,0,0,1,100,0,0
transformers_4.23.0,examples/research_projects/deebert/src/modeling_highway_bert.py,396,203,253,13,72,63,109,85,172,492.340316439681,9.84027777777778,10848.0721980502,602.670677669454,1102.41524101568,55,48.5790550982671,0,0
transformers_4.23.0,examples/research_projects/rag/callbacks_rag.py,117,78,90,5,23,15,29,28,44,115.651565463748,3.15217391304348,666.75922614625,37.0421792303472,211.523616570535,21,56.5554901370497,0,0
transformers_4.23.0,examples/research_projects/rag/lightning_base.py,404,178,338,11,43,25,49,54,74,271.3831322572,6.26744186046512,2669.06328966619,148.281293870344,425.861675160097,51,40.3869249950565,0,0
transformers_4.23.0,examples/research_projects/rag/test_distributed_retriever.py,338,165,290,5,15,11,16,20,27,70.2129994085646,2.66666666666667,311.17882283189,17.2877123795495,116.692058561959,31,47.776010799966,0,0
transformers_4.23.0,examples/research_projects/rag/distributed_ray_retriever.py,151,57,82,6,19,10,20,25,30,96.2203977597551,3.15789473684211,439.944270610237,24.4413483672354,139.315685693242,21,73.0676978305568,0,0
transformers_4.23.0,examples/research_projects/rag/__init__.py,5,3,3,0,0,0,0,0,0,0,0,0,0,0,1,100,0,0
transformers_4.23.0,examples/research_projects/rag/_test_finetune_rag.py,110,62,95,3,6,3,6,9,9,20.2646625064904,1.5,42.7939875194712,2.37744375108173,28.5293250129808,11,49.2313297839637,0,0
transformers_4.23.0,examples/research_projects/rag/use_own_knowledge_dataset.py,209,95,143,5,18,10,20,23,30,86.6682905003984,2.77777777777778,376.963496338084,20.9424164632269,135.70685868171,11,63.356954984399,0,0
transformers_4.23.0,examples/research_projects/rag/utils_rag.py,244,155,187,11,49,30,57,60,87,313.174530166655,6.39795918367347,3287.90790918213,182.661550510119,513.899481817941,34,37.3916007859281,0,0
transformers_4.23.0,examples/research_projects/rag/parse_dpr_relevance_data.py,47,19,33,2,5,3,6,7,9,13.6096404744368,1.2,30.3194331582221,1.68441295323456,25.2661942985184,4,84.3486848748723,0,0
transformers_4.23.0,examples/research_projects/rag/eval_rag.py,320,163,272,12,44,31,60,56,91,283.234541228695,8.18181818181818,4323.83971015016,240.213317230564,528.469297907242,38,34.8358785628199,0,0
transformers_4.23.0,examples/research_projects/rag/finetune_rag.py,649,320,550,16,95,65,123,111,188,688.13628279144,10.3578947368421,13230.658736293,735.036596460725,1277.35018287382,98,22.4433506860752,0,0
transformers_4.23.0,examples/research_projects/rag/distributed_pytorch_retriever.py,138,59,62,4,10,6,10,14,16,41.2192809488736,2,121.835357505843,6.76863097254685,60.9176787529217,18,74.3121998509071,0,0
transformers_4.23.0,examples/research_projects/rag/consolidate_rag_checkpoint.py,102,37,77,3,11,8,16,14,24,42.8086353071737,2.18181818181818,199.366948645925,11.0759415914403,91.3765181293825,7,67.1052001931944,0,0
transformers_4.23.0,examples/research_projects/luke/luke_utils.py,115,71,70,11,47,31,60,58,91,299.119423833859,7.02127659574468,3742.87594220598,207.937552344777,533.076270556609,27,64.7561906352045,0,0
transformers_4.23.0,examples/research_projects/luke/run_luke_ner_no_trainer.py,712,352,561,19,114,91,168,133,259,859.660084370209,14,25582.4541111273,1421.24745061818,1827.31815079481,60,32.8514930919156,0,0
transformers_4.23.0,examples/research_projects/xtreme-s/run_xtreme_s.py,951,395,729,14,89,70,131,103,201,629.643244264816,10.3033707865169,13847.5923333576,769.310685186535,1343.98660596383,90,29.8876767950557,0,0
transformers_4.23.0,examples/research_projects/visual_bert/utils.py,560,367,426,16,111,71,130,127,201,818.180161164862,9.36936936936937,13161.3932155212,731.1885119734,1404.72562204121,94,26.899776032768,0,0
transformers_4.23.0,examples/research_projects/visual_bert/extracting_data.py,149,101,120,9,28,21,36,37,57,163.135262830594,5.78571428571429,1718.00329922206,95.444627734559,296.93884184085,31,51.958422504243,0,0
transformers_4.23.0,examples/research_projects/visual_bert/modeling_frcnn.py,1922,1047,1339,21,381,301,546,402,847,3358.79824431331,15.0472440944882,110257.79004111,6125.43278006166,7327.44078242855,258,0,0,0
transformers_4.23.0,examples/research_projects/visual_bert/processing_image.py,149,100,102,9,36,28,51,45,79,214.646625064904,6.375,2765.83451563903,153.657473091057,433.856394610044,26,60.2737989332999,0,0
transformers_4.23.0,examples/research_projects/visual_bert/visualizing_image.py,499,171,451,16,105,71,135,121,206,768.995779354943,10.2857142857143,14660.082790751,814.44904393061,1425.28582687857,54,34.3003563606783,0,0
transformers_4.23.0,examples/research_projects/seq2seq-distillation/utils.py,645,432,470,15,102,76,138,117,214,739.19074381522,10.1470588235294,14918.7949190248,828.821939945821,1470.25804999085,112,22.4166753541796,0,0
transformers_4.23.0,examples/research_projects/seq2seq-distillation/run_eval.py,167,90,122,11,29,17,34,40,51,178.93519666371,6.44827586206897,1750.18028417037,97.2322380094651,271.418332839255,25,57.8590550451287,0,0
transformers_4.23.0,examples/research_projects/seq2seq-distillation/_test_seq2seq_examples_multi_gpu.py,164,62,141,8,20,16,27,28,43,110.438561897747,5.4,1116.26781290178,62.0148784945431,206.716261648477,13,54.0619037503401,0,0
transformers_4.23.0,examples/research_projects/seq2seq-distillation/lightning_base.py,393,174,331,10,35,21,41,45,62,212.744186541947,5.85714285714286,1994.32722441001,110.795956911667,340.49489197244,48,39.4222119925002,0,0
transformers_4.23.0,examples/research_projects/seq2seq-distillation/sentence_splitter.py,22,15,14,0,0,0,0,0,0,0,0,0,0,0,4,100,0,0
transformers_4.23.0,examples/research_projects/seq2seq-distillation/convert_pl_checkpoint_to_hf.py,74,47,44,4,7,4,7,11,11,27.6514844544032,2,76.1074956100206,4.2281942005567,38.0537478050103,14,75.7335882213974,0,0
transformers_4.23.0,examples/research_projects/seq2seq-distillation/callbacks.py,116,78,89,5,23,16,31,28,47,115.651565463748,3.3695652173913,761.338708851949,42.2965949362194,225.945681336707,22,55.3353772675303,0,0
transformers_4.23.0,examples/research_projects/seq2seq-distillation/make_student.py,187,99,142,7,18,17,34,25,51,94.7101344803648,6.61111111111111,1565.75351198571,86.9863062214284,236.836665678511,25,60.3037431492067,0,0
transformers_4.23.0,examples/research_projects/seq2seq-distillation/distillation.py,310,204,248,14,68,56,93,82,149,467.25044211383,9.57352941176471,9068.7674543522,503.820414130678,947.275248688095,45,42.0189981797744,0,0
transformers_4.23.0,examples/research_projects/seq2seq-distillation/finetune.py,454,269,389,16,86,58,108,102,166,616.65876890438,10.046511627907,11127.74339822,618.207966567778,1107.62260676727,76,27.0301669579008,0,0
transformers_4.23.0,examples/research_projects/seq2seq-distillation/_test_bash_script.py,203,107,151,8,45,28,52,53,80,271.133389334835,4.62222222222222,2118.05769697626,117.669872054237,458.233636365056,31,54.4280077355467,0,0
transformers_4.23.0,examples/research_projects/seq2seq-distillation/_test_make_student.py,39,29,29,0,0,0,0,0,0,0,0,0,0,0,7,100,0,0
transformers_4.23.0,examples/research_projects/seq2seq-distillation/_test_seq2seq_examples.py,444,236,384,10,46,41,67,56,108,287.303130927496,7.28260869565217,4567.61089304444,253.756160724691,627.194331582221,57,32.6259217782878,0,0
transformers_4.23.0,examples/research_projects/bertabs/modeling_bertabs.py,1058,559,608,17,161,142,250,178,392,1249.76448567771,13.1987577639752,38678.7947080435,2148.82192822464,2930.48750493883,126,27.3047660763773,0,0
transformers_4.23.0,examples/research_projects/bertabs/__init__.py,0,0,0,0,0,0,0,0,0,0,0,0,0,0,1,100,0,0
transformers_4.23.0,examples/research_projects/bertabs/configuration_bertabs.py,97,23,37,0,0,0,0,0,0,0,0,0,0,0,2,100,0,0
transformers_4.23.0,examples/research_projects/bertabs/utils_summarization.py,167,86,75,10,24,16,27,34,43,143.258380966181,5.625,1230.53007472743,68.3627819293014,218.760902173765,25,66.7815704983386,0,0
transformers_4.23.0,examples/research_projects/bertabs/test_utils_summarization.py,98,58,62,0,0,0,0,0,0,0,0,0,0,0,12,100,0,0
transformers_4.23.0,examples/research_projects/bertabs/run_summarization.py,348,136,252,6,27,18,29,33,47,143.891737562741,3.22222222222222,763.945464965064,42.4414147202813,237.086523609847,23,53.9037031712686,0,0
transformers_4.23.0,examples/research_projects/bertabs/convert_bertabs_original_pytorch_checkpoint.py,185,62,117,3,16,9,18,19,27,68.7548875021635,1.6875,193.546197331273,10.7525665184041,114.694042862977,4,73.315104043426,0,0
transformers_4.23.0,examples/research_projects/lxmert/utils.py,560,367,426,16,111,71,130,127,201,818.180161164862,9.36936936936937,13161.3932155212,731.1885119734,1404.72562204121,94,26.899776032768,0,0
transformers_4.23.0,examples/research_projects/lxmert/extracting_data.py,149,101,120,9,28,21,36,37,57,163.135262830594,5.78571428571429,1718.00329922206,95.444627734559,296.93884184085,31,51.958422504243,0,0
transformers_4.23.0,examples/research_projects/lxmert/modeling_frcnn.py,1922,1047,1339,21,381,301,546,402,847,3358.79824431331,15.0472440944882,110257.79004111,6125.43278006166,7327.44078242855,258,0,0,0
transformers_4.23.0,examples/research_projects/lxmert/processing_image.py,149,100,102,9,36,28,51,45,79,214.646625064904,6.375,2765.83451563903,153.657473091057,433.856394610044,26,60.2737989332999,0,0
transformers_4.23.0,examples/research_projects/lxmert/visualizing_image.py,499,171,451,16,105,71,135,121,206,768.995779354943,10.2857142857143,14660.082790751,814.44904393061,1425.28582687857,54,34.3003563606783,0,0
transformers_4.23.0,examples/research_projects/mlm_wwm/run_chinese_ref.py,163,95,123,12,77,52,106,89,158,525.562113642161,8.25974025974026,8451.08442871365,469.504690484092,1023.16588209269,47,51.9282890715925,0,0
transformers_4.23.0,examples/research_projects/mlm_wwm/run_mlm_wwm.py,434,199,320,12,66,47,87,78,134,441.949561886312,7.90909090909091,6661.38355159055,370.076863977253,842.243897327541,59,45.1855350731905,0,0
transformers_4.23.0,examples/research_projects/layoutlmv3/run_funsd_cord.py,533,247,407,12,64,52,96,76,148,427.019550008654,9,8322.23944790686,462.346635994825,924.693271989651,62,40.3624691783852,0,0
transformers_4.23.0,examples/research_projects/wav2vec2/run_asr.py,480,233,338,10,51,31,59,61,90,322.51297338942,5.7843137254902,3087.4720845548,171.526226919711,533.76636038066,39,48.9406097206965,0,0
transformers_4.23.0,examples/research_projects/wav2vec2/test_wav2vec2_deepspeed.py,201,65,140,2,8,4,8,10,12,26,1,39.8631371386484,2.21461872992491,39.8631371386484,12,74.1378274285996,0,0
transformers_4.23.0,examples/research_projects/wav2vec2/alignment.py,224,149,150,13,58,52,96,71,148,387.868614053233,10.7586206896552,9792.09389621546,544.005216456414,910.162573686693,20,54.2381473678651,0,0
transformers_4.23.0,examples/research_projects/wav2vec2/run_pretrain.py,396,160,264,15,37,30,53,52,83,251.353133462399,10.7432432432432,5083.02047029108,282.390026127282,473.136496605711,24,55.6740284133835,0,0
transformers_4.23.0,examples/research_projects/wav2vec2/run_common_voice.py,513,228,358,12,47,34,62,59,96,304.085226037503,7.91489361702128,4469.80741657043,248.322634253913,564.733732738737,39,47.9139597979098,0,0
transformers_4.23.0,examples/research_projects/pplm/run_pplm_discrim_train.py,523,309,398,12,67,45,88,79,133,449.447525769325,7.88059701492537,6607.11491432819,367.0619396849,838.402839507555,52,32.7313190517509,0,0
transformers_4.23.0,examples/research_projects/pplm/run_pplm.py,827,384,648,17,151,135,238,168,373,1162.48598393934,13.3973509933775,36940.9767454502,2052.27648585834,2757.33439869648,83,26.7806197622101,0,0
transformers_4.23.0,examples/research_projects/pplm/pplm_classification_head.py,19,11,10,0,0,0,0,0,0,0,0,0,0,0,3,100,0,0
transformers_4.23.0,examples/research_projects/mm-imdb/run_mmimdb.py,576,306,461,17,130,120,214,147,334,982.394683994955,13.9923076923077,33647.1702647381,1869.28723692989,2404.69056317535,87,29.1458931674159,0,0
transformers_4.23.0,examples/research_projects/mm-imdb/utils_mmimdb.py,146,71,104,1,2,3,3,3,6,2,0.75,7.1323312532452,0.396240625180289,9.50977500432694,16,72.3447174106491,0,0
transformers_4.23.0,examples/research_projects/rag-end2end-retriever/callbacks_rag.py,120,80,92,5,24,16,31,29,47,121.648740491745,3.22916666666667,737.299823948008,40.9611013304449,228.325106770996,22,55.7873865104558,0,0
transformers_4.23.0,examples/research_projects/rag-end2end-retriever/lightning_base.py,414,185,345,11,55,32,63,66,95,356.028532048867,6.3,3617.56988043603,200.976104468669,574.217441339053,54,38.2670163382608,0,0
transformers_4.23.0,examples/research_projects/rag-end2end-retriever/distributed_ray_retriever.py,185,69,103,6,19,10,20,25,30,96.2203977597551,3.15789473684211,439.944270610237,24.4413483672354,139.315685693242,25,70.6481313757007,0,0
transformers_4.23.0,examples/research_projects/rag-end2end-retriever/use_own_knowledge_dataset.py,176,84,123,5,16,10,20,21,30,75.6096404744368,3.125,411.779758385509,22.8766532436394,131.769522683363,10,63.5218243815522,0,0
transformers_4.23.0,examples/research_projects/rag-end2end-retriever/utils_rag.py,244,155,187,11,49,30,57,60,87,313.174530166655,6.39795918367347,3287.90790918213,182.661550510119,513.899481817941,34,37.3916007859281,0,0
transformers_4.23.0,examples/research_projects/rag-end2end-retriever/eval_rag.py,320,163,272,12,44,31,60,56,91,283.234541228695,8.18181818181818,4323.83971015016,240.213317230564,528.469297907242,38,34.8358785628199,0,0
transformers_4.23.0,examples/research_projects/rag-end2end-retriever/finetune_rag.py,822,407,689,17,133,87,164,150,251,1007.83943222291,10.4812030075188,19017.445766108,1056.52476478378,1814.43349131447,112,18.3567345820226,0,0
transformers_4.23.0,examples/research_projects/rag-end2end-retriever/kb_encode_utils.py,81,49,59,2,9,5,10,11,15,30.5293250129808,1.11111111111111,57.657193643955,3.20317742466416,51.8914742795595,8,63.2152865599177,0,0
transformers_4.23.0,examples/research_projects/distillation/utils.py,133,72,78,12,41,42,78,53,120,262.679182197995,11.4146341463415,7845.85396898218,435.880776054565,687.350454547584,15,66.1162866051217,0,0
transformers_4.23.0,examples/research_projects/distillation/train.py,324,158,251,11,62,52,99,73,151,407.213919048997,8.78225806451613,8208.45613417477,456.025340787487,934.663508390883,40,45.3177333888926,0,0
transformers_4.23.0,examples/research_projects/distillation/distiller.py,600,363,426,21,182,165,291,203,456,1458.65729039452,16.7884615384615,58682.2739346233,3260.1263297013,3495.39317823644,101,31.5029834629402,0,0
transformers_4.23.0,examples/research_projects/distillation/grouped_batch_sampler.py,108,61,57,8,22,17,33,30,50,122.107495610021,6,1472.06717868256,81.7815099268086,245.344529780426,14,71.3792163039776,0,0
transformers_4.23.0,examples/research_projects/distillation/run_squad_w_distillation.py,878,391,700,18,184,165,297,202,462,1459.39404994045,14.5271739130435,51398.5025736345,2855.47236520192,3538.09370503133,127,19.3413912175474,0,0
transformers_4.23.0,examples/research_projects/distillation/lm_seqs_dataset.py,166,100,91,13,50,32,60,63,92,330.29852582457,7.8,4289.29607310354,238.29422628353,549.909752961992,33,61.9853951624288,0,0
transformers_4.23.0,examples/research_projects/distillation/scripts/token_counts.py,56,26,33,2,4,2,4,6,6,10,1,15.5097750043269,0.861654166907052,15.5097750043269,4,89.3968683714619,0,0
transformers_4.23.0,examples/research_projects/distillation/scripts/extract_distilbert.py,95,44,64,2,6,3,6,8,9,17.5097750043269,1,27,1.5,27,9,78.9607271185457,0,0
transformers_4.23.0,examples/research_projects/distillation/scripts/binarized_data.py,96,62,65,6,16,10,20,22,30,79.5097750043269,3.75,501.686057096696,27.8714476164831,133.782948559119,10,72.2499464344665,0,0
transformers_4.23.0,examples/research_projects/distillation/scripts/extract.py,105,56,73,2,7,8,16,9,24,21.6514844544032,2.28571428571429,173.89302865055,9.66072381391943,76.0782000346155,20,72.2100899918302,0,0
transformers_4.23.0,examples/research_projects/decision_transformer/run_decision_transformer.py,173,70,146,6,30,35,50,36,85,162.716492872583,5,2197.21812561298,122.067673645166,439.443625122597,5,54.2057189106473,0,0
transformers_4.23.0,examples/research_projects/information-gain-filtration/run_clm_igf.py,446,125,279,10,26,22,43,36,65,155.430713620542,8.26923076923077,2778.83468827524,154.37970490418,336.04512509375,17,61.5630874068195,0,0
transformers_4.23.0,examples/research_projects/information-gain-filtration/igf/igf.py,419,195,206,12,58,39,77,70,116,382.782447726053,7.96551724137931,5663.45750765715,314.636528203175,710.996829965616,31,54.9806052906462,0,0
transformers_4.23.0,examples/research_projects/information-gain-filtration/igf/__init__.py,0,0,0,0,0,0,0,0,0,0,0,0,0,0,1,100,0,0
transformers_4.23.0,examples/research_projects/self-training-text-classification/finetuning.py,811,461,611,16,114,103,194,130,297,842.949461614781,13.6140350877193,28394.0202562157,1577.44556978976,2085.64324046945,112,24.3759784088027,0,0
transformers_4.23.0,examples/research_projects/self-training-text-classification/selftraining.py,388,228,283,15,42,36,69,57,105,285.080690690836,12.3214285714286,7546.30145582564,419.238969768091,612.453451487298,49,43.9614121529825,0,0
transformers_4.23.0,examples/research_projects/onnx/summarization/run_onnx_exporter.py,207,80,148,3,6,3,6,9,9,20.2646625064904,1.5,42.7939875194712,2.37744375108173,28.5293250129808,7,66.6924149882509,0,0
transformers_4.23.0,examples/research_projects/onnx/summarization/bart_onnx/generation_onnx.py,758,378,565,19,176,142,259,195,401,1393.57058763559,13.9801136363636,42646.8882444849,2369.27156913805,3050.53945581359,94,26.8767433713545,0,0
transformers_4.23.0,examples/research_projects/onnx/summarization/bart_onnx/reduce_onnx_size.py,122,81,79,7,33,25,50,40,75,186.116490393232,5.3030303030303,2116.6759468302,117.593108157233,399.144607116552,23,54.9747964408018,0,0
transformers_4.23.0,examples/legacy/run_language_modeling.py,375,148,282,13,40,26,47,53,73,260.982840131329,7.6375,3193.53045043603,177.418358357557,418.138193183114,34,51.4424692725917,0,0
transformers_4.23.0,examples/legacy/run_chinese_ref.py,148,95,106,12,77,52,106,89,158,525.562113642161,8.25974025974026,8451.08442871365,469.504690484092,1023.16588209269,47,53.5005332687855,0,0
transformers_4.23.0,examples/legacy/run_swag.py,724,365,526,18,173,143,260,191,403,1361.24933340712,13.5260115606936,41304.433141123,2294.69073006239,3053.70381769841,110,27.7951362486135,0,0
transformers_4.23.0,examples/legacy/run_openai_gpt.py,320,198,230,13,76,50,93,89,143,522.948207357547,7.95394736842105,7365.59293210189,409.199607338994,926.029880628195,34,48.2811623586228,0,0
transformers_4.23.0,examples/legacy/run_transfo_xl.py,145,81,88,10,35,23,45,45,68,212.744186541947,6.42857142857143,2400.7243535384,133.373575196578,373.446010550418,14,66.3918012785162,0,0
transformers_4.23.0,examples/legacy/run_camembert.py,47,26,39,2,6,3,6,8,9,17.5097750043269,1,27,1.5,27,5,76.4492276593583,0,0
transformers_4.23.0,examples/legacy/text-classification/run_tf_text_classification.py,313,134,224,6,34,20,41,40,61,188.483511606839,3.61764705882353,1174.42430870411,65.2457949280063,324.637613788129,32,53.7440276453376,0,0
transformers_4.23.0,examples/legacy/token-classification/tasks.py,163,103,143,7,32,23,46,39,69,179.651484454403,5.03125,1834.8604140419,101.936689668994,364.692753101495,36,41.9556575788578,0,0
transformers_4.23.0,examples/legacy/token-classification/utils_ner.py,372,164,243,13,76,57,112,89,169,522.948207357547,9.57894736842105,10483.1899405087,582.39944113937,1094.39894983332,41,52.0239116685642,0,0
transformers_4.23.0,examples/legacy/token-classification/run_ner.py,324,128,233,7,22,13,25,29,38,117.758980064424,3.97727272727273,734.217582218145,40.7898656787858,184.603277814848,28,57.849271022363,0,0
transformers_4.23.0,examples/legacy/token-classification/run_tf_ner.py,310,124,220,10,31,17,34,41,51,186.799366570867,5.48387096774194,1498.38631871093,83.2436843728294,273.235152235522,25,56.3053623007033,0,0
transformers_4.23.0,examples/legacy/token-classification/scripts/preprocess.py,41,26,26,5,7,6,11,12,17,31.26112492884,3.92857142857143,239.424281298163,13.3013489610091,60.9443625122597,5,71.8572040458364,0,0
transformers_4.23.0,examples/legacy/pytorch-lightning/lightning_base.py,393,174,331,10,35,21,41,45,62,212.744186541947,5.85714285714286,1994.32722441001,110.795956911667,340.49489197244,48,39.4222119925002,0,0
transformers_4.23.0,examples/legacy/pytorch-lightning/run_ner.py,217,133,168,7,22,14,26,29,40,117.758980064424,4.13636363636364,803.775037375653,44.6541687430918,194.319239805103,39,50.7464201709682,0,0
transformers_4.23.0,examples/legacy/pytorch-lightning/run_glue.py,203,129,155,7,27,17,31,34,48,148.033447012817,4.01851851851852,981.315054712288,54.5175030395715,244.198216380016,39,41.5492564673778,0,0
transformers_4.23.0,examples/legacy/question-answering/run_squad.py,843,378,652,16,167,146,260,183,406,1297.07861684317,12.4550898203593,38005.1389187671,2111.39660659817,3051.37413434332,125,21.5659627437264,0,0
transformers_4.23.0,examples/legacy/question-answering/run_squad_trainer.py,186,57,121,6,17,10,19,23,29,84.9966433055827,3.35294117647059,439.849877256603,24.4361042920335,131.183296725653,18,71.7643133612507,0,0
transformers_4.23.0,examples/legacy/seq2seq/finetune_trainer.py,375,146,272,8,29,21,38,37,59,164.8814488587,5.24137931034483,1610.97854424001,89.4988080133341,307.357748572108,36,53.5390208806422,0,0
transformers_4.23.0,examples/legacy/seq2seq/utils.py,664,437,475,15,105,78,141,120,219,763.599138289071,10.0714285714286,15234.1339072711,846.340772626172,1512.60904043827,112,24.1637457942975,0,0
transformers_4.23.0,examples/legacy/seq2seq/run_eval.py,185,91,123,11,33,19,38,44,57,204.518753743839,6.33333333333333,1970.85481432806,109.491934129337,311.187602262326,27,61.6406396848574,0,0
transformers_4.23.0,examples/legacy/seq2seq/old_test_fsmt_bleu_score.py,71,33,45,2,4,2,4,6,6,10,1,15.5097750043269,0.861654166907052,15.5097750043269,5,85.4779996147926,0,0
transformers_4.23.0,examples/legacy/seq2seq/sentence_splitter.py,35,15,14,0,0,0,0,0,0,0,0,0,0,0,4,100,0,0
transformers_4.23.0,examples/legacy/seq2seq/run_distributed_eval.py,262,140,214,13,36,22,44,49,66,234.223016387757,7.94444444444444,2943.97952826441,163.554418236912,370.570849711604,29,51.499293339555,0,0
transformers_4.23.0,examples/legacy/seq2seq/old_test_seq2seq_examples_multi_gpu.py,55,20,30,1,4,2,4,5,6,8,0.5,6.96578428466209,0.38698801581456,13.9315685693242,3,92.3969012832702,0,0
transformers_4.23.0,examples/legacy/seq2seq/rouge_cli.py,31,13,11,2,4,2,4,6,6,10,1,15.5097750043269,0.861654166907052,15.5097750043269,5,87.7474176305963,0,0
transformers_4.23.0,examples/legacy/seq2seq/old_test_tatoeba_conversion.py,38,19,19,1,2,1,2,3,3,2,0.5,2.37744375108173,0.13208020839343,4.75488750216347,5,95.632079094799,0,0
transformers_4.23.0,examples/legacy/seq2seq/__init__.py,5,3,3,0,0,0,0,0,0,0,0,0,0,0,1,100,0,0
transformers_4.23.0,examples/legacy/seq2seq/pack_dataset.py,88,52,51,5,23,15,30,28,45,115.651565463748,3.26086956521739,705.427080954105,39.1903933863392,216.330971492592,11,73.5081676749319,0,0
transformers_4.23.0,examples/legacy/seq2seq/old_test_seq2seq_examples.py,131,71,94,5,23,14,26,28,40,115.651565463748,2.82608695652174,543.440121623903,30.1911178679946,192.294196882304,16,64.9390393765469,0,0
transformers_4.23.0,examples/legacy/seq2seq/seq2seq_trainer.py,262,121,182,11,48,39,68,59,107,306.131947839626,7.79166666666667,4904.40853227838,272.467140682132,629.442806281717,50,52.7741131893944,0,0
transformers_4.23.0,examples/legacy/seq2seq/seq2seq_training_args.py,59,27,30,0,0,0,0,0,0,0,0,0,0,0,1,100,0,0
transformers_4.23.0,examples/legacy/seq2seq/download_wmt.py,67,30,29,3,9,5,10,12,15,33.2842125151443,1.66666666666667,89.6240625180289,4.97911458433494,53.7744375108174,7,81.7500751511226,0,0
transformers_4.23.0,examples/legacy/seq2seq/save_len_file.py,56,29,33,1,2,1,2,3,3,2,0.5,2.37744375108173,0.13208020839343,4.75488750216347,2,91.6164746622838,0,0
transformers_4.23.0,examples/legacy/seq2seq/old_test_datasets.py,247,151,202,13,78,50,95,91,145,538.36708940709,7.91666666666667,7470.40593072809,415.022551707116,943.630222828811,57,45.1844335082117,0,0
transformers_4.23.0,examples/legacy/seq2seq/save_randomly_initialized_model.py,39,11,10,1,2,1,2,3,3,2,0.5,2.37744375108173,0.13208020839343,4.75488750216347,2,74.2654504356407,0,0
transformers_4.23.0,examples/legacy/seq2seq/xla_spawn.py,83,23,34,2,6,3,6,8,9,17.5097750043269,1,27,1.5,27,2,87.2054647193187,0,0
transformers_4.23.0,examples/legacy/seq2seq/run_eval_search.py,157,68,86,5,15,8,16,20,24,70.2129994085646,2.66666666666667,276.603398072791,15.3668554484884,103.726274277297,22,72.1835571216451,0,0
transformers_4.23.0,examples/legacy/seq2seq/convert_model_to_fp16.py,36,16,15,3,5,3,5,8,8,16.3645279766003,1.5,36,2,24,5,89.0389097782268,0,0
transformers_4.23.0,examples/legacy/seq2seq/minify_dataset.py,34,15,13,1,2,1,2,3,3,2,0.5,2.37744375108173,0.13208020839343,4.75488750216347,4,93.5313910858761,0,0
transformers_4.23.0,examples/legacy/seq2seq/old_test_calculate_rouge.py,110,38,77,2,10,5,10,12,15,35.2192809488736,1,53.7744375108174,2.98746875060096,53.7744375108174,9,74.2048333469388,0,0
transformers_4.23.0,examples/legacy/seq2seq/test_data/fsmt/build-eval-data.py,33,20,24,0,0,0,0,0,0,0,0,0,0,0,2,100,0,0
transformers_4.23.0,examples/legacy/multiple_choice/utils_multiple_choice.py,579,319,405,11,79,49,95,90,144,536.052426911001,6.61392405063291,6182.87375908664,343.492986615925,934.826845871473,73,34.834657098631,0,0
transformers_4.23.0,examples/legacy/multiple_choice/run_multiple_choice.py,245,87,167,8,21,12,23,29,35,116.238665878354,4.38095238095238,744.890419252895,41.3828010696053,170.029334829465,20,64.2077982747307,0,0
transformers_4.23.0,templates/adding_a_missing_tokenization_test/cookiecutter-template-{{cookiecutter.modelname}}/test_tokenization_{{cookiecutter.lowercase_modelname}}.py,78,46,48,2,9,5,10,11,15,30.5293250129808,1.11111111111111,57.657193643955,3.20317742466416,51.8914742795595,8,63.2152865599177,0,0
transformers_4.23.0,templates/adding_a_new_example_script/{{cookiecutter.directory_name}}/run_{{cookiecutter.example_shortcut}}.py,905,413,692,14,89,70,131,103,201,629.643244264816,10.3033707865169,13847.5923333576,769.310685186535,1343.98660596383,90,29.8876767950557,0,0
transformers_4.23.0,templates/adding_a_new_model/cookiecutter-template-{{cookiecutter.modelname}}/configuration_{{cookiecutter.lowercase_modelname}}.py,242,54,110,12,61,44,82,73,126,404.79452759999,8.0655737704918,6290.48531236213,349.471406242341,779.917894418882,51,49.5485903715576,0,0
transformers_4.23.0,templates/adding_a_new_model/cookiecutter-template-{{cookiecutter.modelname}}/__init__.py,291,147,251,18,89,90,168,107,258,651.398925381971,16.9887640449438,29548.5315227769,1641.58508459872,1739.2984824915,72,43.6714306479462,0,0
transformers_4.23.0,templates/adding_a_new_model/cookiecutter-template-{{cookiecutter.modelname}}/modeling_{{cookiecutter.lowercase_modelname}}.py,3352,1365,2327,24,686,643,1201,710,1844,6573.57552961186,21.0087463556851,366933.91283094,20385.2173794967,17465.7690953389,469,0,0,0
transformers_4.23.0,templates/adding_a_new_model/cookiecutter-template-{{cookiecutter.modelname}}/modeling_flax_{{cookiecutter.lowercase_modelname}}.py,3240,1280,2658,20,501,421,748,521,1169,4579.74062528855,14.9301397205589,157518.769160301,8751.04273112783,10550.3881483036,462,0,0,0
transformers_4.23.0,templates/adding_a_new_model/cookiecutter-template-{{cookiecutter.modelname}}/modeling_tf_{{cookiecutter.lowercase_modelname}}.py,3040,1107,2159,21,579,396,771,600,1167,5405.96457837412,13.9818652849741,150585.128314849,8365.84046193603,10770.0314118087,439,0,0,0
transformers_4.23.0,templates/adding_a_new_model/cookiecutter-template-{{cookiecutter.modelname}}/test_modeling_{{cookiecutter.lowercase_modelname}}.py,1070,524,861,17,161,142,250,178,392,1249.76448567771,13.1987577639752,38678.7947080435,2148.82192822464,2930.48750493883,126,27.3047660763773,0,0
transformers_4.23.0,templates/adding_a_new_model/cookiecutter-template-{{cookiecutter.modelname}}/test_modeling_flax_{{cookiecutter.lowercase_modelname}}.py,669,326,547,15,116,86,162,131,248,854.129154368926,10.4741379310345,18269.9225760626,1014.99569867015,1744.28890438129,61,37.2909064588901,0,0
transformers_4.23.0,templates/adding_a_new_model/cookiecutter-template-{{cookiecutter.modelname}}/test_modeling_tf_{{cookiecutter.lowercase_modelname}}.py,1054,525,808,20,137,134,243,157,377,1058.86895726334,17.7372262773723,48778.649739176,2709.92498550978,2750.07202233214,95,29.3450128042833,0,0
transformers_4.23.0,templates/adding_a_new_model/cookiecutter-template-{{cookiecutter.modelname}}/tokenization_{{cookiecutter.lowercase_modelname}}.py,332,122,156,11,46,36,60,57,96,292.137597783633,7.17391304347826,4017.08599236389,223.171444020216,559.957441359815,31,43.6440768164196,0,0
transformers_4.23.0,templates/adding_a_new_model/cookiecutter-template-{{cookiecutter.modelname}}/tokenization_fast_{{cookiecutter.lowercase_modelname}}.py,201,73,110,8,28,21,40,36,61,158.605937817613,5.71428571428571,1802.08814335989,100.116007964438,315.365425087981,33,59.493769604741,0,0
transformers_4.23.0,templates/adding_a_new_model/cookiecutter-template-{{cookiecutter.modelname}}/to_replace_{{cookiecutter.lowercase_modelname}}.py,472,146,259,11,85,66,121,96,187,582.851977376715,7.82941176470588,9641.04359730585,535.613533183658,1231.38798763486,34,44.1520546080668,0,0
