Project,Files,LOC,LLOC,SLOC,h1,h2,N1,N2,N,Length,Calculated_length,Difficulty,Effort,Time,Halstead_Volume,Cyclomatic_Complexity,Maintainabilty_Index
lightning_1.0.0,./setup.py,129,35,83,2,8,4,8,10,12,26.0,1.0,39.863137138648355,2.2146187299249087,39.863137138648355,7,83.2174222062805
lightning_1.0.0,docs/source/conf.py,364,91,159,2,11,10,20,13,30,40.053747805010275,1.8181818181818181,201.84216644405956,11.213453691336642,111.01319154423277,11,68.61307260945297
lightning_1.0.0,tests/__init__.py,13,8,8,1,1,1,1,2,2,0.0,0.5,1.0,0.05555555555555555,2.0,2,97.47869458230909
lightning_1.0.0,tests/conftest.py,57,38,38,1,2,1,2,3,3,2.0,0.5,2.3774437510817346,0.1320802083934297,4.754887502163469,4,82.96838074622241
lightning_1.0.0,tests/collect_env_details.py,96,55,70,6,30,22,44,36,66,162.7164928725825,4.4,1501.3462204188477,83.40812335660264,341.2150500951926,10,58.331991373171476
lightning_1.0.0,tests/test_deprecated.py,50,35,28,1,2,1,2,3,3,2.0,0.5,2.3774437510817346,0.1320802083934297,4.754887502163469,12,78.30825047911084
lightning_1.0.0,tests/test_profiler.py,186,97,114,5,11,6,11,16,17,49.663388279447084,2.5,170.0,9.444444444444445,68.0,13,63.05948065337338
lightning_1.0.0,tests/base/deterministic_model.py,504,341,334,13,135,85,169,148,254,1003.4758219376965,8.137037037037038,14900.551619440177,827.8084233022321,1831.201154869753,104,31.074699065894258
lightning_1.0.0,tests/base/mixins.py,0,0,0,0,0,0,0,0,0,0,0,0,0.0,0,1,100.0
lightning_1.0.0,tests/base/simple_model.py,98,59,59,2,4,2,4,6,6,10.0,1.0,15.509775004326936,0.861654166907052,15.509775004326936,21,77.52946995947276
lightning_1.0.0,tests/base/model_optimizers.py,101,56,57,1,2,1,2,3,3,2.0,0.5,2.3774437510817346,0.1320802083934297,4.754887502163469,13,84.1867575964307
lightning_1.0.0,tests/base/model_template.py,180,73,132,1,4,3,6,5,9,8.0,0.75,15.673014640489694,0.8707230355827608,20.89735285398626,9,71.15272334296984
lightning_1.0.0,tests/base/model_valid_dataloaders.py,42,19,19,0,0,0,0,0,0,0,0,0,0.0,0,8,100.0
lightning_1.0.0,tests/base/model_test_steps.py,204,124,116,6,59,47,90,65,137,362.58571491667556,4.576271186440678,3775.7183966766534,209.76213314870296,825.0643903848983,28,58.46412662703282
lightning_1.0.0,tests/base/model_valid_epoch_ends.py,113,51,45,3,10,5,10,13,15,37.974168451037094,1.5,83.25989365817458,4.625549647676365,55.506595772116384,13,73.06214108270555
lightning_1.0.0,tests/base/model_train_steps.py,217,128,124,7,32,26,43,39,69,179.65148445440323,4.703125,1715.1956044304693,95.28864469058163,364.69275310149516,20,61.49268940023154
lightning_1.0.0,tests/base/model_valid_steps.py,136,70,77,4,30,20,35,34,55,155.20671786825557,2.3333333333333335,652.891064627127,36.271725812618165,279.8104562687687,6,70.70490113359266
lightning_1.0.0,tests/base/__init__.py,6,5,4,0,0,0,0,0,0,0,0,0,0.0,0,1,100.0
lightning_1.0.0,tests/base/model_test_dataloaders.py,44,21,20,0,0,0,0,0,0,0,0,0,0.0,0,9,100.0
lightning_1.0.0,tests/base/model_test_epoch_ends.py,88,46,40,2,12,9,18,14,27,45.01955000865388,1.5,154.19787434333296,8.566548574629609,102.7985828955553,10,76.13039752710958
lightning_1.0.0,tests/base/model_utilities.py,40,14,19,1,2,1,2,3,3,2.0,0.5,2.3774437510817346,0.1320802083934297,4.754887502163469,5,98.19488345103848
lightning_1.0.0,tests/base/develop_pipelines.py,119,61,66,10,22,13,23,32,36,131.32677655889415,5.2272727272727275,940.909090909091,52.27272727272728,180.0,17,70.94912758112815
lightning_1.0.0,tests/base/model_train_dataloaders.py,39,20,17,0,0,0,0,0,0,0,0,0,0.0,0,6,100.0
lightning_1.0.0,tests/base/models.py,222,131,147,5,9,7,12,14,19,40.13896548741762,3.3333333333333335,241.13247839698158,13.39624879983231,72.33974351909447,23,60.07677500848611
lightning_1.0.0,tests/base/dataloaders.py,54,32,30,2,4,4,8,6,12,10.0,2.0,62.039100017307746,3.446616667628208,31.019550008653873,10,84.26511544611714
lightning_1.0.0,tests/base/test_datasets.py,32,11,11,0,0,0,0,0,0,0,0,0,0.0,0,1,100.0
lightning_1.0.0,tests/base/datasets.py,243,123,137,8,23,14,25,31,39,128.0419249893113,4.3478260869565215,840.0593743699484,46.66996524277491,193.21365610508815,40,61.683541543764086
lightning_1.0.0,tests/base/develop_utils.py,127,69,70,10,24,15,27,34,42,143.2583809661814,5.625,1201.9130962453928,66.77294979141071,213.67343933251428,11,69.48589006165257
lightning_1.0.0,tests/base/boring_model.py,131,77,71,1,2,1,2,3,3,2.0,0.5,2.3774437510817346,0.1320802083934297,4.754887502163469,28,78.12458932185297
lightning_1.0.0,tests/base/datamodules.py,115,58,71,4,14,13,26,18,39,61.30296890880645,3.7142857142857144,604.0434216375006,33.55796786875003,162.62707505625016,23,69.01159048430398
lightning_1.0.0,tests/models/test_onnx.py,154,97,97,4,18,11,22,22,33,83.05865002596161,2.4444444444444446,359.72748390340865,19.984860216856035,147.1612434150308,11,61.2772610918034
lightning_1.0.0,tests/models/test_torchscript.py,101,56,69,5,14,13,19,19,32,64.91260938324326,3.392857142857143,461.2035586024464,25.622419922358134,135.93368043019473,15,68.40761289547176
lightning_1.0.0,tests/models/test_hparams.py,556,313,312,7,63,43,82,70,125,396.22011963489797,4.555555555555555,3490.286162426995,193.9047868014997,766.1603771181209,73,42.15688264862396
lightning_1.0.0,tests/models/test_restore.py,462,218,264,8,38,26,46,46,72,223.42124551085624,4.842105263157895,1925.6881261537715,106.98267367520953,397.69646083610496,34,52.87584531829716
lightning_1.0.0,tests/models/test_sync_batchnorm.py,114,60,68,6,12,8,15,18,23,58.52932501298082,3.75,359.65603137439945,19.98089063191108,95.90827503317318,12,71.71637386964596
lightning_1.0.0,tests/models/test_horovod.py,241,97,156,4,21,12,23,25,35,100.23866587835397,2.1904761904761907,356.02897454939557,19.77938747496642,162.53496664211536,15,65.98419952483691
lightning_1.0.0,tests/models/__init__.py,0,0,0,0,0,0,0,0,0,0,0,0,0.0,0,1,100.0
lightning_1.0.0,tests/models/test_tpu.py,299,146,214,1,14,7,14,15,21,53.30296890880645,0.5,41.02235125388945,2.279019514104969,82.0447025077789,9,53.86852281546143
lightning_1.0.0,tests/models/test_hooks.py,144,84,97,6,32,24,44,38,68,175.50977500432694,4.125,1472.0436675209257,81.78020375116255,356.8590709141638,16,61.21018206697473
lightning_1.0.0,tests/models/test_gpu.py,328,163,237,2,48,40,80,50,120,270.0782000346155,1.6666666666666667,1128.771237954945,62.70951321971917,677.2627427729669,30,45.80046798614395
lightning_1.0.0,tests/models/test_cpu.py,521,230,358,6,37,26,50,43,76,208.2595495325981,4.054054054054054,1671.8761676649708,92.8820093147206,412.39612135735945,12,47.22605886364228
lightning_1.0.0,tests/models/test_grad_norm.py,114,62,69,6,18,10,19,24,29,90.56842503028855,3.1666666666666665,421.05238964955953,23.39179942497553,132.96391252091354,18,70.21555001839519
lightning_1.0.0,tests/models/test_amp.py,204,89,133,2,28,16,32,30,48,136.6059378176129,1.1428571428571428,269.1779983876673,14.954333243759294,235.53074858920888,17,61.454875391702274
lightning_1.0.0,tests/models/data/horovod/train_default_model.py,94,49,47,3,11,6,11,14,17,42.808635307173745,1.5,97.08755051246888,5.393752806248271,64.72503367497926,10,78.12890808189752
lightning_1.0.0,tests/core/test_results.py,205,100,149,5,25,14,27,30,41,127.70604521880493,2.7,543.1927889338631,30.177377162992393,201.18251441994926,23,55.51186940013533
lightning_1.0.0,tests/core/__init__.py,0,0,0,0,0,0,0,0,0,0,0,0,0.0,0,1,100.0
lightning_1.0.0,tests/core/test_decorators.py,46,19,23,1,2,1,2,3,3,2.0,0.5,2.3774437510817346,0.1320802083934297,4.754887502163469,2,96.18109053572019
lightning_1.0.0,tests/core/test_datamodules.py,457,254,300,8,52,49,93,60,142,320.4228653433368,7.153846153846154,6000.492092738931,333.36067181882953,838.7784645764096,60,40.205249511222014
lightning_1.0.0,tests/core/test_memory.py,239,116,173,3,35,18,36,38,54,184.27979309523727,1.542857142857143,437.22733226289984,24.29040734793888,283.3880857259536,23,58.62459230313899
lightning_1.0.0,tests/core/test_metric_result_integration.py,143,89,88,3,30,20,40,33,60,151.96160537041902,2.0,605.3272943230144,33.629294129056355,302.6636471615072,26,59.70527248689762
lightning_1.0.0,tests/checkpointing/__init__.py,0,0,0,0,0,0,0,0,0,0,0,0,0.0,0,1,100.0
lightning_1.0.0,tests/checkpointing/test_checkpoint_callback_frequency.py,128,58,71,5,17,12,22,22,34,81.0965087756926,3.235294117647059,490.5374780501027,27.252082113894595,151.6206750336681,10,73.79278908907523
lightning_1.0.0,tests/checkpointing/test_model_checkpoint.py,514,292,372,11,154,96,181,165,277,1157.1388750720253,6.464285714285714,13190.189173415802,732.788287411989,2040.4712533460909,77,30.46524858375051
lightning_1.0.0,tests/backends/test_dp.py,98,39,61,1,5,3,6,6,9,11.60964047443681,0.6,13.95879750389424,0.7754887502163467,23.264662506490403,5,80.08012431375161
lightning_1.0.0,tests/backends/test_accelerator_connector.py,358,184,288,0,0,0,0,0,0,0,0,0,0.0,0,1,100.0
lightning_1.0.0,tests/backends/__init__.py,0,0,0,0,0,0,0,0,0,0,0,0,0.0,0,1,100.0
lightning_1.0.0,tests/backends/ddp_model.py,56,36,32,2,8,5,10,10,15,26.0,1.25,62.28615177913805,3.4603417655076694,49.82892142331044,6,82.43490628743477
lightning_1.0.0,tests/backends/test_ddp.py,70,29,35,2,8,4,8,10,12,26.0,1.0,39.863137138648355,2.2146187299249087,39.863137138648355,6,85.24907329243068
lightning_1.0.0,tests/backends/test_ddp_spawn.py,85,31,54,1,2,1,2,3,3,2.0,0.5,2.3774437510817346,0.1320802083934297,4.754887502163469,2,87.8935508018874
lightning_1.0.0,tests/callbacks/test_callbacks.py,279,216,222,2,27,59,60,29,119,130.38196255841368,2.2222222222222223,1284.6660853781805,71.37033807656559,578.0997384201812,90,32.62983857141109
lightning_1.0.0,tests/callbacks/test_progress_bar.py,241,117,158,7,85,63,122,92,185,564.4497140261079,5.023529411764706,6062.691490808514,336.8161939338063,1206.8589618705473,41,50.18400828272755
lightning_1.0.0,tests/callbacks/__init__.py,0,0,0,0,0,0,0,0,0,0,0,0,0.0,0,1,100.0
lightning_1.0.0,tests/callbacks/test_gpu_stats_monitor.py,114,51,68,2,4,2,4,6,6,10.0,1.0,15.509775004326936,0.861654166907052,15.509775004326936,5,81.5483422322024
lightning_1.0.0,tests/callbacks/test_callback_hook_outputs.py,65,29,36,2,9,8,16,11,24,30.529325012980813,1.7777777777777777,147.60241572852468,8.200134207140259,83.02635884729514,1,83.2432482893439
lightning_1.0.0,tests/callbacks/test_early_stopping.py,207,108,140,5,27,14,28,32,42,139.9916030328505,2.5925925925925926,544.4444444444445,30.246913580246915,210.0,16,59.35016104806091
lightning_1.0.0,tests/callbacks/test_lr_monitor.py,140,63,96,3,19,10,20,22,30,85.46551025759159,1.5789473684210527,211.23623456702987,11.735346364834992,133.78294855911892,17,63.77052904681969
lightning_1.0.0,tests/trainer/test_trainer_cli.py,189,93,128,3,16,8,16,19,24,68.75488750216347,1.5,152.92539048396907,8.49585502688717,101.95026032264605,17,63.564249831877575
lightning_1.0.0,tests/trainer/test_dataloaders.py,1080,516,761,6,159,92,181,165,273,1178.2581648945395,3.4150943396226414,6867.775086274122,381.54306034856234,2011.0059644891076,111,20.1657064345346
lightning_1.0.0,tests/trainer/test_config_validator.py,94,51,47,0,0,0,0,0,0,0,0,0,0.0,0,1,100.0
lightning_1.0.0,tests/trainer/test_trainer.py,1213,562,831,16,220,167,319,236,486,1775.8991369754253,11.6,44439.188455082316,2468.8438030601287,3830.9645219898553,106,22.528410709079537
lightning_1.0.0,tests/trainer/test_optimizers.py,361,185,240,5,120,74,154,125,228,840.436511947459,3.2083333333333335,5095.471204230317,283.08173356835096,1588.198816902956,44,43.89395318300085
lightning_1.0.0,tests/trainer/__init__.py,0,0,0,0,0,0,0,0,0,0,0,0,0.0,0,1,100.0
lightning_1.0.0,tests/trainer/test_trainer_test_loop.py,76,33,46,1,10,6,12,11,18,33.219280948873624,0.6,37.361861481282816,2.0756589711823787,62.26976913547136,9,80.17232470131549
lightning_1.0.0,tests/trainer/test_lr_finder.py,258,126,160,4,24,13,25,28,38,118.03910001730776,2.0833333333333335,380.58226466289364,21.143459147938536,182.67948703818894,21,58.09798261845556
lightning_1.0.0,tests/trainer/test_states.py,218,110,125,2,35,18,36,37,54,181.5249055930738,1.0285714285714285,289.34792407950505,16.074884671083613,281.3104817439633,22,53.477619304638075
lightning_1.0.0,tests/trainer/test_trainer_tricks.py,343,184,210,5,52,33,66,57,99,308.0325058177736,3.173076923076923,1832.312661180405,101.79514784335583,577.4561114023095,51,50.90541589771477
lightning_1.0.0,tests/trainer/test_correct_freq_accumulation.py,57,25,30,1,10,6,12,11,18,33.219280948873624,0.6,37.361861481282816,2.0756589711823787,62.26976913547136,7,84.85331389920404
lightning_1.0.0,tests/trainer/data_flow/test_eval_loop_flow_1_0.py,237,142,161,4,15,24,44,19,68,66.60335893412778,5.866666666666666,1694.6398826964275,94.14666014980153,288.8590709141638,13,57.40175361517503
lightning_1.0.0,tests/trainer/data_flow/__init__.py,0,0,0,0,0,0,0,0,0,0,0,0,0.0,0,1,100.0
lightning_1.0.0,tests/trainer/data_flow/test_train_loop_flow_scalar_1_0.py,230,120,147,4,21,18,32,25,50,100.23866587835397,3.0476190476190474,707.6352289180533,39.313068273225184,232.19280948873623,13,61.94148237394886
lightning_1.0.0,tests/trainer/data_flow/test_train_loop_flow_dict_1_0.py,199,108,127,3,21,18,32,24,50,96.99355338051744,2.2857142857142856,523.9957143681322,29.11087302045179,229.24812503605784,13,63.04639420616284
lightning_1.0.0,tests/trainer/legacy_deprecate_flow_log_tests/test_trainer_steps_dict_return.py,233,127,145,5,76,41,78,81,119,486.4521314961493,2.5657894736842106,1935.739727854444,107.54109599191355,754.4421503432704,49,54.399791630783184
lightning_1.0.0,tests/trainer/legacy_deprecate_flow_log_tests/test_eval_loop_dict_return.py,318,158,197,5,90,57,103,95,160,595.8764191441076,2.861111111111111,3007.533900702612,167.08521670570065,1051.1768973329517,73,48.58387576462699
lightning_1.0.0,tests/trainer/legacy_deprecate_flow_log_tests/__init__.py,0,0,0,0,0,0,0,0,0,0,0,0,0.0,0,1,100.0
lightning_1.0.0,tests/trainer/legacy_deprecate_flow_log_tests/test_trainer_steps_scalar_return.py,191,105,112,3,60,40,76,63,116,359.1683232386746,1.9,1317.3924951393817,73.18847195218787,693.3644711259903,49,57.591125704175646
lightning_1.0.0,tests/trainer/dynamic_args/test_multiple_optimizers.py,113,57,70,1,6,4,8,7,12,15.509775004326936,0.6666666666666666,22.458839376460833,1.2477132986922685,33.68825906469125,3,77.98942933248112
lightning_1.0.0,tests/trainer/dynamic_args/test_multiple_eval_dataloaders.py,167,95,115,1,16,16,32,17,48,64.0,1.0,196.19821638001633,10.899900910000907,196.19821638001633,9,60.968003919836
lightning_1.0.0,tests/trainer/dynamic_args/__init__.py,0,0,0,0,0,0,0,0,0,0,0,0,0.0,0,1,100.0
lightning_1.0.0,tests/trainer/logging/test_distributed_logging.py,72,30,46,1,4,2,4,5,6,8.0,0.5,6.965784284662087,0.3869880158145604,13.931568569324174,4,87.63773128337144
lightning_1.0.0,tests/trainer/logging/__init__.py,0,0,0,0,0,0,0,0,0,0,0,0,0.0,0,1,100.0
lightning_1.0.0,tests/trainer/logging/test_eval_loop_logging_1_0.py,259,125,183,2,26,15,30,28,45,124.2114326716684,1.1538461538461537,249.61265941452942,13.867369967473856,216.33097149259217,11,59.67411269903167
lightning_1.0.0,tests/trainer/logging/test_train_loop_logging_1_0.py,488,264,340,6,43,26,48,49,74,248.83915945651714,3.3488372093023258,1391.4034441602712,77.30019134223728,415.4885284645254,24,47.691105040616556
lightning_1.0.0,tests/trainer/flags/__init__.py,0,0,0,0,0,0,0,0,0,0,0,0,0.0,0,1,100.0
lightning_1.0.0,tests/trainer/flags/test_overfit_batches.py,67,27,35,0,0,0,0,0,0,0,0,0,0.0,0,1,100.0
lightning_1.0.0,tests/trainer/flags/test_val_check_interval.py,97,51,63,4,15,14,25,19,39,66.60335893412778,3.3333333333333335,552.2305767476661,30.67947648598145,165.66917302429982,4,70.30840123565261
lightning_1.0.0,tests/trainer/flags/test_env_vars.py,41,21,20,3,5,8,16,8,24,16.36452797660028,4.8,345.59999999999997,19.2,72.0,9,85.7945633566016
lightning_1.0.0,tests/trainer/warnings/__init__.py,0,0,0,0,0,0,0,0,0,0,0,0,0.0,0,1,100.0
lightning_1.0.0,tests/trainer/warnings/test_flow_warnings.py,47,18,24,1,2,1,2,3,3,2.0,0.5,2.3774437510817346,0.1320802083934297,4.754887502163469,3,96.49848213014369
lightning_1.0.0,tests/trainer/model_hooks/__init__.py,0,0,0,0,0,0,0,0,0,0,0,0,0.0,0,1,100.0
lightning_1.0.0,tests/trainer/model_hooks/test_model_hooks.py,48,18,24,1,3,4,8,4,12,4.754887502163469,1.3333333333333333,32.0,1.7777777777777777,24.0,5,90.7921199538445
lightning_1.0.0,tests/trainer/optimization/__init__.py,0,0,0,0,0,0,0,0,0,0,0,0,0.0,0,1,100.0
lightning_1.0.0,tests/trainer/optimization/test_manual_optimization.py,357,186,225,4,32,41,82,36,123,168.0,5.125,3258.9914727841974,181.0550818213443,635.9007751774044,7,55.314800652035714
lightning_1.0.0,tests/loggers/test_base.py,214,140,146,7,46,28,56,53,84,273.7353344330258,4.260869565217392,2050.0974426940984,113.89430237189436,481.14531818330875,30,49.362138677873695
lightning_1.0.0,tests/loggers/test_mlflow.py,156,101,103,6,58,41,79,64,120,355.27267272172605,4.086206896551724,2942.0689655172414,163.44827586206895,720.0,30,56.14884223044206
lightning_1.0.0,tests/loggers/test_all.py,319,172,228,5,37,35,69,42,104,204.35941500270798,4.662162162162162,2614.5452585040803,145.2525143613378,560.8010119689911,34,46.24452329372319
lightning_1.0.0,tests/loggers/__init__.py,0,0,0,0,0,0,0,0,0,0,0,0,0.0,0,1,100.0
lightning_1.0.0,tests/loggers/test_csv.py,110,62,69,3,20,12,24,23,36,91.19344939991072,1.8,293.12681475249445,16.284823041805247,162.84823041805248,11,66.82777033374693
lightning_1.0.0,tests/loggers/test_neptune.py,109,61,65,1,10,6,12,11,18,33.219280948873624,0.6,37.361861481282816,2.0756589711823787,62.26976913547136,7,72.58745877893107
lightning_1.0.0,tests/loggers/test_wandb.py,111,68,65,5,27,17,33,32,50,139.9916030328505,3.0555555555555554,763.8888888888888,42.438271604938265,250.0,18,67.82457569862864
lightning_1.0.0,tests/loggers/test_comet.py,203,117,113,6,33,24,47,39,71,181.9747809431559,4.2727272727272725,1603.3988367584839,89.0777131532491,375.2635575392197,21,55.55212886196611
lightning_1.0.0,tests/loggers/test_tensorboard.py,203,106,136,4,39,24,48,43,72,214.1306865356277,2.4615384615384617,961.7010765256641,53.42783758475912,390.69106233855103,15,58.34630914865897
lightning_1.0.0,tests/utilities/test_xla_device_utils.py,44,23,20,2,6,3,6,8,9,17.509775004326936,1.0,27.0,1.5,27.0,4,88.82924707629073
lightning_1.0.0,tests/utilities/dist.py,46,24,24,2,8,5,10,10,15,26.0,1.25,62.28615177913805,3.4603417655076694,49.82892142331044,4,86.64184508870815
lightning_1.0.0,tests/utilities/__init__.py,0,0,0,0,0,0,0,0,0,0,0,0,0.0,0,1,100.0
lightning_1.0.0,tests/utilities/test_dtype_device_mixin.py,102,44,63,5,16,13,22,21,35,75.60964047443682,3.4375,528.4506899280697,29.358371662670535,153.73110979725664,12,74.11775795368206
lightning_1.0.0,tests/utilities/test_upgrade_checkpoint.py,49,13,32,1,2,1,2,3,3,2.0,0.5,2.3774437510817346,0.1320802083934297,4.754887502163469,2,99.02017703177616
lightning_1.0.0,tests/utilities/parsing.py,74,39,40,2,5,3,5,7,8,13.60964047443681,1.0,22.458839376460833,1.2477132986922685,22.458839376460833,9,83.15484395044759
lightning_1.0.0,tests/utilities/test_apply_func.py,79,31,51,3,10,6,12,13,18,37.974168451037094,1.8,119.8942468677714,6.660791492653967,66.60791492653966,19,80.29883461600035
lightning_1.0.0,tests/utilities/test_apply_func_torchtext.py,65,34,39,1,1,3,6,2,9,0.0,3.0,27.0,1.5,9.0,5,88.08997439782716
lightning_1.0.0,benchmarks/__init__.py,0,0,0,0,0,0,0,0,0,0,0,0,0.0,0,1,100.0
lightning_1.0.0,benchmarks/test_parity.py,115,62,73,3,9,5,9,12,14,33.28421251514428,1.5,75.28421251514428,4.182456250841349,50.18947501009619,10,72.25138754686125
lightning_1.0.0,rapid_prototyping_templates/__init__.py,0,0,0,0,0,0,0,0,0,0,0,0,0.0,0,1,100.0
lightning_1.0.0,pl_examples/test_examples.py,94,14,34,1,2,1,2,3,3,2.0,0.5,2.3774437510817346,0.1320802083934297,4.754887502163469,2,87.77845005082264
lightning_1.0.0,pl_examples/__init__.py,0,0,0,0,0,0,0,0,0,0,0,0,0.0,0,1,100.0
lightning_1.0.0,pl_examples/bug_report_model.py,133,65,67,1,2,1,2,3,3,2.0,0.5,2.3774437510817346,0.1320802083934297,4.754887502163469,20,82.1832937181955
lightning_1.0.0,pl_examples/domain_templates/imagenet.py,269,135,209,9,25,14,26,34,40,144.62572975734892,4.68,952.3730438820636,52.90961354900353,203.4985136500136,25,49.86205275659058
lightning_1.0.0,pl_examples/domain_templates/generative_adversarial_net.py,213,112,132,4,10,6,11,14,17,41.219280948873624,2.2,142.3950740849544,7.9108374491641325,64.72503367497926,15,65.26955701356512
lightning_1.0.0,pl_examples/domain_templates/unet.py,122,56,70,4,17,24,41,21,65,77.48686830125578,4.823529411764706,1377.1206978476937,76.50670543598298,285.50063248061946,14,70.65192280041235
lightning_1.0.0,pl_examples/domain_templates/__init__.py,0,0,0,0,0,0,0,0,0,0,0,0,0.0,0,1,100.0
lightning_1.0.0,pl_examples/domain_templates/semantic_segmentation.py,246,137,156,5,13,9,16,18,25,59.715356810271004,3.076923076923077,320.7634616494086,17.820192313856033,104.2481250360578,27,62.44972415841203
lightning_1.0.0,pl_examples/domain_templates/reinforce_learn_Qnet.py,375,172,186,9,22,13,24,31,37,126.63682062300134,4.909090909090909,899.8622025593615,49.9923445866312,183.3052634843144,32,60.20495904427483
lightning_1.0.0,pl_examples/domain_templates/computer_vision_fine_tuning.py,454,201,289,9,40,33,49,49,82,241.40644880847532,5.5125,2537.9892172861773,140.9994009603432,460.4062072174471,48,49.67719787289577
lightning_1.0.0,pl_examples/basic_examples/mnist.py,112,63,63,3,4,3,5,7,8,12.75488750216347,1.875,42.11032383086406,2.3394624350480036,22.458839376460833,10,78.65861317560608
lightning_1.0.0,pl_examples/basic_examples/autoencoder.py,105,50,58,3,4,4,7,7,11,12.75488750216347,2.625,81.06237337441333,4.503465187467407,30.880904142633646,7,80.64321824212207
lightning_1.0.0,pl_examples/basic_examples/image_classifier.py,126,72,72,3,4,3,5,7,8,12.75488750216347,1.875,42.11032383086406,2.3394624350480036,22.458839376460833,12,76.85554066912543
lightning_1.0.0,pl_examples/basic_examples/__init__.py,0,0,0,0,0,0,0,0,0,0,0,0,0.0,0,1,100.0
lightning_1.0.0,.github/prepare-nightly_pkg-name.py,12,10,10,0,0,0,0,0,0,0,0,0,0.0,0,1,100.0
lightning_1.0.0,.github/prepare-nightly_version.py,16,13,13,0,0,0,0,0,0,0,0,0,0.0,0,1,100.0
lightning_1.0.0,pytorch_lightning/__init__.py,79,32,56,1,2,1,2,3,3,2.0,0.5,2.3774437510817346,0.1320802083934297,4.754887502163469,4,84.34163422490609
lightning_1.0.0,pytorch_lightning/accelerators/dp_accelerator.py,164,99,101,3,11,6,12,14,18,42.808635307173745,1.6363636363636365,112.14390861333307,6.23021714518517,68.53238859703687,34,65.9196749052093
lightning_1.0.0,pytorch_lightning/accelerators/ddp_cpu_spawn_accelerator.py,235,121,127,8,30,18,35,38,53,171.20671786825557,4.666666666666667,1297.9874049917134,72.11041138842853,278.14015821251,32,61.963100517170226
lightning_1.0.0,pytorch_lightning/accelerators/cpu_accelerator.py,73,40,40,1,6,3,6,7,9,15.509775004326936,0.5,12.63309714925922,0.701838730514401,25.26619429851844,11,82.6950874828311
lightning_1.0.0,pytorch_lightning/accelerators/gpu_accelerator.py,113,67,66,1,6,3,6,7,9,15.509775004326936,0.5,12.63309714925922,0.701838730514401,25.26619429851844,15,75.54130193000944
lightning_1.0.0,pytorch_lightning/accelerators/ddp_cpu_slurm_accelerator.py,202,99,105,6,20,12,23,26,35,101.94833690207419,3.45,567.5780959655369,31.53211644252983,164.51539013493823,25,66.72142360917688
lightning_1.0.0,pytorch_lightning/accelerators/ddp_torchelastic_accelerator.py,204,101,107,6,20,12,23,26,35,101.94833690207419,3.45,567.5780959655369,31.53211644252983,164.51539013493823,25,66.49454028641598
lightning_1.0.0,pytorch_lightning/accelerators/ddp_accelerator.py,309,170,178,10,45,27,52,55,79,280.35267028370896,5.777777777777778,2638.869522573256,146.60386236518087,456.72741736844813,45,54.43723808607993
lightning_1.0.0,pytorch_lightning/accelerators/ddp_spawn_accelerator.py,262,139,144,9,43,27,52,52,79,261.858709465171,5.441860465116279,2450.658805338517,136.1477114076954,450.3347377331463,38,58.08221572759437
lightning_1.0.0,pytorch_lightning/accelerators/ddp2_accelerator.py,216,115,121,7,16,10,19,23,29,83.65148445440323,4.15625,545.2305770159968,30.290587611999822,131.18329672565338,34,64.0554188917578
lightning_1.0.0,pytorch_lightning/accelerators/horovod_accelerator.py,165,98,100,7,23,12,23,30,35,123.69340944371453,3.5,601.0940979620435,33.394116553446864,171.74117084629816,34,62.84765829447097
lightning_1.0.0,pytorch_lightning/accelerators/accelerator.py,228,141,158,8,32,17,33,40,50,184.0,4.125,1097.6476695705187,60.98042608725104,266.09640474436816,44,52.00268007894106
lightning_1.0.0,pytorch_lightning/accelerators/__init__.py,27,14,14,0,0,0,0,0,0,0,0,0,0.0,0,1,100.0
lightning_1.0.0,pytorch_lightning/accelerators/ddp_slurm_accelerator.py,207,104,110,6,21,13,25,27,38,107.74844088268091,3.5714285714285716,645.3061610078994,35.85034227821663,180.68572508221183,26,65.73341149248041
lightning_1.0.0,pytorch_lightning/accelerators/ddp_cpu_torchelastic_accelerator.py,201,99,105,6,20,12,23,26,35,101.94833690207419,3.45,567.5780959655369,31.53211644252983,164.51539013493823,25,66.72142360917688
lightning_1.0.0,pytorch_lightning/accelerators/tpu_accelerator.py,331,178,190,7,39,24,43,46,67,225.78217099003092,3.858974358974359,1428.124025228228,79.34022362379045,370.0786510558199,48,54.518595408819664
lightning_1.0.0,pytorch_lightning/accelerators/accelerator_connector.py,408,239,277,11,100,76,148,111,224,702.4393667824828,8.14,12388.66611406813,688.2592285593405,1521.9491540624238,108,34.77646432700847
lightning_1.0.0,pytorch_lightning/cluster_environments/__init__.py,16,3,3,0,0,0,0,0,0,0,0,0,0.0,0,1,100.0
lightning_1.0.0,pytorch_lightning/cluster_environments/slurm_environment.py,79,41,40,3,8,5,9,11,14,28.75488750216347,1.6875,81.72907199030617,4.540503999461453,48.43204266092217,11,80.76257570080638
lightning_1.0.0,pytorch_lightning/cluster_environments/cluster_environment.py,26,9,9,0,0,0,0,0,0,0,0,0,0.0,0,5,100.0
lightning_1.0.0,pytorch_lightning/cluster_environments/torchelastic_environment.py,47,23,27,1,4,2,4,5,6,8.0,0.5,6.965784284662087,0.3869880158145604,13.931568569324174,7,90.32501310708747
lightning_1.0.0,pytorch_lightning/overrides/__init__.py,0,0,0,0,0,0,0,0,0,0,0,0,0.0,0,1,100.0
lightning_1.0.0,pytorch_lightning/overrides/data_parallel.py,331,213,206,10,46,28,51,56,79,287.3031309274962,5.543478260869565,2543.242715322836,141.29126196237976,458.78103884255074,53,50.86697561483353
lightning_1.0.0,pytorch_lightning/core/decorators.py,64,13,12,1,1,1,1,2,2,0.0,0.5,1.0,0.05555555555555555,2.0,1,59.52056677344192
lightning_1.0.0,pytorch_lightning/core/memory.py,391,174,171,13,52,31,61,65,92,344.528581679171,7.625,4224.691020839461,234.7050567133034,554.0578387986178,53,52.314027175545434
lightning_1.0.0,pytorch_lightning/core/__init__.py,21,3,6,0,0,0,0,0,0,0,0,0,0.0,0,1,100.0
lightning_1.0.0,pytorch_lightning/core/hooks.py,600,89,58,0,0,0,0,0,0,0,0,0,0.0,0,37,100.0
lightning_1.0.0,pytorch_lightning/core/step_result.py,1005,427,608,14,151,93,173,165,266,1146.3020845468934,8.019867549668874,15714.462977391704,873.0257209662058,1959.4417089893868,187,22.473948671189206
lightning_1.0.0,pytorch_lightning/core/lightning.py,1607,319,399,11,70,45,81,81,126,467.103558991158,6.364285714285714,5083.92571731318,282.44031762851,798.8211003634627,120,11.464620915792892
lightning_1.0.0,pytorch_lightning/core/grads.py,56,18,16,1,2,1,2,3,3,2.0,0.5,2.3774437510817346,0.1320802083934297,4.754887502163469,4,80.05339772250079
lightning_1.0.0,pytorch_lightning/core/saving.py,386,164,156,6,28,19,31,34,50,150.11571282193984,3.3214285714285716,844.8822218505029,46.93790121391683,254.373142062517,40,55.28948487131403
lightning_1.0.0,pytorch_lightning/core/datamodule.py,366,165,169,10,37,24,46,47,70,225.9690554771448,6.216216216216216,2416.996770594864,134.2775983663813,388.8212196174346,47,55.88784218886503
lightning_1.0.0,pytorch_lightning/metrics/utils.py,63,18,20,0,0,0,0,0,0,0,0,0,0.0,0,3,100.0
lightning_1.0.0,pytorch_lightning/metrics/metric.py,254,116,128,8,30,19,36,38,55,171.20671786825557,4.8,1385.4528635491065,76.96960353050592,288.6360132393972,37,61.72580363647937
lightning_1.0.0,pytorch_lightning/metrics/__init__.py,28,3,13,0,0,0,0,0,0,0,0,0,0.0,0,1,100.0
lightning_1.0.0,pytorch_lightning/metrics/functional/reduction.py,78,24,26,4,17,12,24,21,36,77.48686830125578,2.823529411764706,446.4661474448058,24.80367485804477,158.12342722003538,8,69.23420702340063
lightning_1.0.0,pytorch_lightning/metrics/functional/classification.py,1069,293,396,19,182,150,282,201,432,1447.1292472715909,14.719780219780219,48652.617316751246,2702.9231842639583,3305.2543305892973,42,39.29867392710875
lightning_1.0.0,pytorch_lightning/metrics/functional/regression.py,337,88,132,11,82,57,111,93,168,559.3730121836933,7.445121951219512,8179.052247591271,454.3917915328484,1098.5786802661494,19,58.812402687499144
lightning_1.0.0,pytorch_lightning/metrics/functional/__init__.py,47,4,34,0,0,0,0,0,0,0,0,0,0.0,0,1,100.0
lightning_1.0.0,pytorch_lightning/metrics/functional/nlp.py,116,47,49,8,40,25,50,48,75,236.8771237954945,5.0,2094.360937770434,116.35338543169077,418.8721875540868,13,71.12934438378649
lightning_1.0.0,pytorch_lightning/metrics/functional/self_supervised.py,59,14,18,3,8,6,10,11,16,28.75488750216347,1.875,103.78294855911894,5.765719364395497,55.350905898196764,5,75.27279477436434
lightning_1.0.0,pytorch_lightning/metrics/classification/f_beta.py,132,40,52,6,45,31,62,51,93,262.6431643391623,4.133333333333334,2180.4803014538434,121.13779452521352,527.5355568033491,7,69.2054141619466
lightning_1.0.0,pytorch_lightning/metrics/classification/precision_recall.py,237,66,92,11,58,39,76,69,115,377.81664552240943,7.206896551724138,5062.702942022873,281.26127455682627,702.4803125294895,23,61.934705649088954
lightning_1.0.0,pytorch_lightning/metrics/classification/__init__.py,16,3,3,0,0,0,0,0,0,0,0,0,0.0,0,1,100.0
lightning_1.0.0,pytorch_lightning/metrics/classification/accuracy.py,115,33,42,7,29,16,31,36,47,160.53293331310283,3.7413793103448274,909.1045705122438,50.50580947290243,242.98647506778866,11,70.38666174369058
lightning_1.0.0,pytorch_lightning/metrics/regression/mean_squared_log_error.py,77,18,24,3,8,4,8,11,12,28.75488750216347,1.5,62.26976913547136,3.4594316186372978,41.51317942364757,4,73.90124684372024
lightning_1.0.0,pytorch_lightning/metrics/regression/explained_variance.py,134,42,53,9,27,19,37,36,56,156.9112875713945,6.166666666666667,1785.347433831412,99.18596854618956,289.5158000807695,8,69.8374124660878
lightning_1.0.0,pytorch_lightning/metrics/regression/__init__.py,17,4,4,0,0,0,0,0,0,0,0,0,0.0,0,1,100.0
lightning_1.0.0,pytorch_lightning/metrics/regression/mean_squared_error.py,77,18,24,3,8,4,8,11,12,28.75488750216347,1.5,62.26976913547136,3.4594316186372978,41.51317942364757,4,73.90124684372024
lightning_1.0.0,pytorch_lightning/metrics/regression/mean_absolute_error.py,76,18,24,3,8,4,8,11,12,28.75488750216347,1.5,62.26976913547136,3.4594316186372978,41.51317942364757,4,73.90124684372024
lightning_1.0.0,pytorch_lightning/distributed/dist.py,49,30,30,1,2,1,2,3,3,2.0,0.5,2.3774437510817346,0.1320802083934297,4.754887502163469,6,90.84659838485337
lightning_1.0.0,pytorch_lightning/distributed/__init__.py,14,1,1,0,0,0,0,0,0,0,0,0,0.0,0,1,100.0
lightning_1.0.0,pytorch_lightning/callbacks/early_stopping.py,205,99,105,12,29,19,34,41,53,183.90099886735348,7.0344827586206895,1997.4431818596802,110.96906565887112,283.95025624475846,32,64.19687874314288
lightning_1.0.0,pytorch_lightning/callbacks/model_checkpoint.py,558,245,325,15,134,88,169,149,257,1005.4593104554692,9.458955223880597,17549.448489695882,974.9693605386601,1855.3263097587756,107,39.47914028231786
lightning_1.0.0,pytorch_lightning/callbacks/gradient_accumulation_scheduler.py,75,26,25,5,9,7,11,14,18,40.13896548741762,3.0555555555555554,209.4045207131682,11.633584484064901,68.53238859703687,11,74.19262858259711
lightning_1.0.0,pytorch_lightning/callbacks/progress.py,381,177,191,10,58,33,61,68,94,372.9821786662728,5.258620689655173,3009.0958561835737,167.17199201019855,572.221507077532,58,53.05494673072199
lightning_1.0.0,pytorch_lightning/callbacks/lr_monitor.py,159,70,74,10,32,22,42,42,64,193.21928094887363,6.5625,2264.7733175670796,125.82073986483776,345.1083150578407,30,66.78220323890496
lightning_1.0.0,pytorch_lightning/callbacks/__init__.py,32,8,17,0,0,0,0,0,0,0,0,0,0.0,0,1,100.0
lightning_1.0.0,pytorch_lightning/callbacks/base.py,168,109,72,0,0,0,0,0,0,0,0,0,0.0,0,36,100.0
lightning_1.0.0,pytorch_lightning/callbacks/gpu_stats_monitor.py,201,84,105,6,16,10,18,22,28,79.50977500432694,3.375,421.4162879612246,23.412015997845813,124.86408532184433,29,68.54156193628918
lightning_1.0.0,pytorch_lightning/trainer/logging.py,199,112,107,7,18,14,28,25,42,94.71013448036484,5.444444444444445,1061.8951153951537,58.994173077508535,195.04195997053841,39,63.207146966861444
lightning_1.0.0,pytorch_lightning/trainer/states.py,60,27,25,3,6,4,7,9,11,20.264662506490406,1.75,61.021056277764515,3.3900586820980285,34.86917501586544,1,84.57962431003929
lightning_1.0.0,pytorch_lightning/trainer/model_hooks.py,36,17,16,2,4,2,4,6,6,10.0,1.0,15.509775004326936,0.861654166907052,15.509775004326936,5,92.10992073626446
lightning_1.0.0,pytorch_lightning/trainer/data_loading.py,355,219,232,13,79,57,111,92,168,546.1043954418253,9.132911392405063,10009.291035665603,556.0717242036446,1095.9584086175782,81,42.431755871630884
lightning_1.0.0,pytorch_lightning/trainer/configuration_validator.py,90,35,47,3,10,9,12,13,21,37.974168451037094,1.8,139.87662134573327,7.770923408096293,77.70923408096293,14,80.39015180133505
lightning_1.0.0,pytorch_lightning/trainer/supporters.py,176,107,98,11,31,18,35,42,53,191.63383342700342,6.209677419354839,1774.6812421258167,98.59340234032315,285.79282340727434,38,61.888797889747906
lightning_1.0.0,pytorch_lightning/trainer/ignored_warnings.py,25,4,6,0,0,0,0,0,0,0,0,0,0.0,0,1,100.0
lightning_1.0.0,pytorch_lightning/trainer/evaluation_loop.py,357,235,241,9,63,38,71,72,109,405.09796019347556,5.071428571428571,3410.646399011575,189.48035550064304,672.521825157212,89,38.95468419267707
lightning_1.0.0,pytorch_lightning/trainer/properties.py,193,156,134,6,25,13,25,31,38,131.60617974869504,3.0,564.7783793841038,31.37657663245021,188.25945979470129,41,52.481870517571245
lightning_1.0.0,pytorch_lightning/trainer/__init__.py,1568,4,3,0,0,0,0,0,0,0,0,0,0.0,0,1,100.0
lightning_1.0.0,pytorch_lightning/trainer/trainer.py,838,295,424,12,58,37,71,70,108,382.782447726053,7.344827586206897,4862.0009145448985,270.111161919161,661.9625658300565,68,46.45096983927267
lightning_1.0.0,pytorch_lightning/trainer/training_tricks.py,66,35,36,3,6,4,6,9,10,20.264662506490406,1.5,47.548875021634686,2.6416041678685938,31.699250014423125,11,83.2527150729398
lightning_1.0.0,pytorch_lightning/trainer/optimizers.py,180,93,118,7,27,15,31,34,46,148.0334470128169,4.018518518518518,940.4269274326091,52.24594041292273,234.02329069751565,43,61.496854164478286
lightning_1.0.0,pytorch_lightning/trainer/training_loop.py,874,435,494,16,188,118,222,204,340,1484.2627041153958,9.446808510638299,24643.177226042913,1369.0654014468284,2608.6246162703083,151,26.374881058888068
lightning_1.0.0,pytorch_lightning/trainer/callback_hook.py,211,158,121,0,0,0,0,0,0,0,0,0,0.0,0,73,100.0
lightning_1.0.0,pytorch_lightning/trainer/connectors/logger_connector.py,530,288,309,11,88,57,111,99,168,606.4837302450925,6.9375,7726.515140702785,429.2508411501547,1113.7319121733744,102,39.445786902771715
lightning_1.0.0,pytorch_lightning/trainer/connectors/profiler_connector.py,26,8,8,2,3,2,4,5,6,6.754887502163469,1.3333333333333333,18.575424759098897,1.0319680421721609,13.931568569324174,5,83.01691259900444
lightning_1.0.0,pytorch_lightning/trainer/connectors/slurm_connector.py,155,98,99,8,25,15,28,33,43,140.0964047443681,4.48,971.7520831532125,53.98622684184514,216.9089471324135,29,61.83853005254509
lightning_1.0.0,pytorch_lightning/trainer/connectors/debugging_connector.py,69,34,45,5,8,7,13,13,20,35.60964047443681,4.0625,300.6607270989638,16.70337372772021,74.00879436282185,9,78.53116227361758
lightning_1.0.0,pytorch_lightning/trainer/connectors/callback_connector.py,87,37,54,4,14,8,16,18,24,61.30296890880645,2.2857142857142856,228.75017150769253,12.708342861538474,100.07820003461549,17,77.34641776123402
lightning_1.0.0,pytorch_lightning/trainer/connectors/precision_connector.py,81,45,51,4,11,8,13,15,21,46.053747805010275,2.3636363636363638,193.92384229111377,10.773546793950764,82.0447025077789,15,75.73050894609177
lightning_1.0.0,pytorch_lightning/trainer/connectors/__init__.py,0,0,0,0,0,0,0,0,0,0,0,0,0.0,0,1,100.0
lightning_1.0.0,pytorch_lightning/trainer/connectors/optimizer_connector.py,92,40,57,7,14,9,17,21,26,72.95445336320968,4.25,485.3510752170531,26.963948623169617,114.20025299224778,15,77.12191296535218
lightning_1.0.0,pytorch_lightning/trainer/connectors/data_connector.py,147,76,79,5,28,18,36,33,54,146.2155782920497,3.2142857142857144,875.5626935743602,48.64237186524223,272.3972824453565,35,66.11243080686614
lightning_1.0.0,pytorch_lightning/trainer/connectors/training_trick_connector.py,55,23,29,3,5,3,5,8,8,16.36452797660028,1.5,36.0,2.0,24.0,8,88.78011792820277
lightning_1.0.0,pytorch_lightning/trainer/connectors/checkpoint_connector.py,362,191,206,14,76,45,87,90,132,528.145459930519,8.013157894736842,6866.672193523025,381.481788529057,856.924608715517,71,48.663266956841134
lightning_1.0.0,pytorch_lightning/trainer/connectors/model_connector.py,57,31,33,1,2,1,2,3,3,2.0,0.5,2.3774437510817346,0.1320802083934297,4.754887502163469,8,90.78781448763925
lightning_1.0.0,pytorch_lightning/trainer/connectors/env_vars_connector.py,43,15,13,0,0,0,0,0,0,0,0,0,0.0,0,1,100.0
lightning_1.0.0,pytorch_lightning/loggers/test_tube.py,213,93,115,3,11,7,13,14,20,42.808635307173745,1.7727272727272727,134.9880381456787,7.499335452537705,76.14709844115208,23,70.02795481594603
lightning_1.0.0,pytorch_lightning/loggers/neptune.py,375,120,131,2,14,7,14,16,21,55.30296890880645,1.0,84.0,4.666666666666667,84.0,34,55.86636745775007
lightning_1.0.0,pytorch_lightning/loggers/__init__.py,63,36,41,0,0,0,0,0,0,0,0,0,0.0,0,11,100.0
lightning_1.0.0,pytorch_lightning/loggers/base.py,451,209,199,8,27,16,30,35,46,152.38196255841368,4.444444444444445,1048.6534167976376,58.258523155424314,235.94701877946846,75,50.680042675830784
lightning_1.0.0,pytorch_lightning/loggers/mlflow.py,181,83,86,5,13,8,15,18,23,59.715356810271004,2.8846153846153846,276.658485672615,15.369915870700831,95.90827503317318,24,69.75376441287155
lightning_1.0.0,pytorch_lightning/loggers/tensorboard.py,259,149,154,8,35,21,37,43,58,203.5249055930738,4.228571428571429,1330.8301901246516,73.93501056248064,314.7233557727217,46,57.35252698212543
lightning_1.0.0,pytorch_lightning/loggers/wandb.py,158,65,76,4,12,6,12,16,18,51.01955000865388,2.0,144.0,8.0,72.0,22,73.09938107693324
lightning_1.0.0,pytorch_lightning/loggers/csv_logs.py,220,117,115,6,15,9,15,21,24,74.11313393845472,3.0,316.2468544400708,17.569269691115046,105.41561814669026,32,65.42833127881583
lightning_1.0.0,pytorch_lightning/loggers/comet.py,301,130,152,5,28,21,42,33,63,146.2155782920497,3.75,1191.7381106984346,66.2076728165797,317.79682951958256,37,60.453247730100465
lightning_1.0.0,pytorch_lightning/utilities/apply_func.py,125,45,42,4,11,6,11,15,17,46.053747805010275,2.0,132.83428025068963,7.379682236149424,66.41714012534482,14,67.80949608609951
lightning_1.0.0,pytorch_lightning/utilities/device_parser.py,207,86,84,10,44,27,48,54,75,273.4342721689147,5.454545454545454,2354.2721599759648,130.7928977764425,431.6165626622602,33,61.98720634599306
lightning_1.0.0,pytorch_lightning/utilities/model_utils.py,43,16,16,3,6,5,7,9,12,20.264662506490406,1.75,66.56842503028857,3.6982458350160314,38.03910001730775,5,82.30315573684446
lightning_1.0.0,pytorch_lightning/utilities/upgrade_checkpoint.py,58,25,33,4,10,5,10,14,15,41.219280948873624,2.0,114.22064766172811,6.345591536762672,57.110323830864054,6,84.57620123016477
lightning_1.0.0,pytorch_lightning/utilities/exceptions.py,16,2,2,0,0,0,0,0,0,0,0,0,0.0,0,1,100.0
lightning_1.0.0,pytorch_lightning/utilities/memory.py,77,29,32,4,24,10,24,28,34,118.03910001730776,2.0,326.90013469991703,18.161118594439834,163.45006734995852,13,78.49061498026481
lightning_1.0.0,pytorch_lightning/utilities/distributed.py,141,63,62,5,16,9,18,21,27,75.60964047443682,2.8125,333.54160429226215,18.530089127347896,118.59257041502654,13,73.52739667544638
lightning_1.0.0,pytorch_lightning/utilities/__init__.py,40,20,19,1,2,1,2,3,3,2.0,0.5,2.3774437510817346,0.1320802083934297,4.754887502163469,4,95.28064554563043
lightning_1.0.0,pytorch_lightning/utilities/seed.py,67,30,31,4,6,4,8,10,12,23.509775004326936,2.6666666666666665,106.3016990363956,5.905649946466422,39.863137138648355,5,84.47116166440017
lightning_1.0.0,pytorch_lightning/utilities/debugging.py,199,116,153,6,18,14,24,24,38,90.56842503028855,4.0,696.9143001096159,38.717461117200884,174.22857502740396,32,54.04491034449895
lightning_1.0.0,pytorch_lightning/utilities/xla_device_utils.py,87,46,42,4,12,6,12,16,18,51.01955000865388,2.0,144.0,8.0,72.0,10,77.97974792889225
lightning_1.0.0,pytorch_lightning/utilities/cloud_io.py,64,29,28,2,4,2,4,6,6,10.0,1.0,15.509775004326936,0.861654166907052,15.509775004326936,4,85.85224949721906
lightning_1.0.0,pytorch_lightning/utilities/parsing.py,248,134,127,7,41,23,45,48,68,239.31111664374467,3.841463414634146,1458.901180066429,81.05006555924606,379.7774500490387,44,58.85741901226903
lightning_1.0.0,pytorch_lightning/utilities/data.py,47,19,23,3,9,4,9,12,13,33.28421251514428,1.5,69.90676876406255,3.883709375781253,46.604512509375034,8,87.9405136422446
lightning_1.0.0,pytorch_lightning/utilities/argparse_utils.py,228,100,104,10,55,32,63,65,95,351.1940651927299,5.7272727272727275,3276.715578270482,182.03975434836013,572.1249422377032,38,60.30862838598967
lightning_1.0.0,pytorch_lightning/utilities/device_dtype_mixin.py,183,59,52,2,4,3,5,6,8,10.0,1.25,25.84962500721156,1.43609027817842,20.67970000576925,14,58.02283768716347
lightning_1.0.0,pytorch_lightning/utilities/warning_utils.py,25,8,8,1,2,1,2,3,3,2.0,0.5,2.3774437510817346,0.1320802083934297,4.754887502163469,4,89.04410039846756
lightning_1.0.0,pytorch_lightning/tuner/auto_gpu_select.py,36,17,17,1,2,1,2,3,3,2.0,0.5,2.3774437510817346,0.1320802083934297,4.754887502163469,5,95.59488731942952
lightning_1.0.0,pytorch_lightning/tuner/batch_size_scaling.py,275,131,155,13,32,24,44,45,68,208.1057163358342,8.9375,3337.67371929436,185.42631773857556,373.4460105504179,26,61.54088255473388
lightning_1.0.0,pytorch_lightning/tuner/__init__.py,0,0,0,0,0,0,0,0,0,0,0,0,0.0,0,1,100.0
lightning_1.0.0,pytorch_lightning/tuner/tuning.py,134,33,69,0,0,0,0,0,0,0,0,0,0.0,0,11,100.0
lightning_1.0.0,pytorch_lightning/tuner/lr_finder.py,502,224,251,16,71,48,96,87,144,500.6320454848324,10.816901408450704,10035.746578773276,557.5414765985154,927.783863402217,45,51.138605331918754
lightning_1.0.0,pytorch_lightning/profiler/__init__.py,122,3,7,0,0,0,0,0,0,0,0,0,0.0,0,1,100.0
lightning_1.0.0,pytorch_lightning/profiler/profilers.py,241,141,133,7,18,12,23,25,35,94.71013448036484,4.472222222222222,726.8924897050159,40.38291609472311,162.53496664211536,44,60.212352015916736
lightning_1.0.0,pytorch_lightning/plugins/apex.py,97,39,44,0,0,0,0,0,0,0,0,0,0.0,0,9,100.0
lightning_1.0.0,pytorch_lightning/plugins/__init__.py,0,0,0,0,0,0,0,0,0,0,0,0,0.0,0,1,100.0
lightning_1.0.0,pytorch_lightning/plugins/native_amp.py,43,19,19,0,0,0,0,0,0,0,0,0,0.0,0,6,100.0
lightning_1.0.0,pytorch_lightning/plugins/plugin_connector.py,44,21,21,3,5,3,6,8,9,16.36452797660028,1.8,48.6,2.7,27.0,8,88.82381161406921
