Project,Files,LOC,LLOC,SLOC,h1,h2,N1,N2,N,Length,Calculated_length,Difficulty,Effort,Time,Halstead_Volume,Cyclomatic_Complexity,Maintainabilty_Index
ray_2.0.0,.buildkite/copy_files.py,124,74,102,6,15,10,19,21,29,74.11313393845472,3.8,484.03337999021943,26.890743332789967,127.37720526058406,10,43.139737372249236
ray_2.0.0,java/test/src/main/resources/test_cross_language_invocation.py,160,96,118,4,24,12,24,28,36,118.03910001730776,2.0,346.1295543881475,19.229419688230415,173.06477719407374,15,55.65658011490191
ray_2.0.0,java/serve/src/test/resources/test_deployment_cross_language_invocation.py,24,14,14,2,4,2,4,6,6,10.0,1.0,15.509775004326936,0.861654166907052,15.509775004326936,3,86.8878208969922
ray_2.0.0,python/setup.py,786,386,593,11,157,101,197,168,298,1183.3092053809958,6.901273885350318,15202.889340248883,844.6049633471602,2202.910591988071,103,28.381020477038625
ray_2.0.0,python/ray/client_builder.py,385,191,244,10,45,25,49,55,74,280.35267028370896,5.444444444444445,2329.2455912489354,129.4025328471631,427.82061880082483,51,53.18202188801036
ray_2.0.0,python/ray/exceptions.py,693,287,415,10,75,46,93,85,139,500.38068273606467,6.2,5523.613108763472,306.86739493130403,890.9053401231407,72,43.14849472322657
ray_2.0.0,python/ray/__init__.py,261,82,201,8,29,15,30,37,45,164.8814488586996,4.137931034482759,970.0361439447012,53.89089688581673,234.42540145330275,18,62.77708768549472
ray_2.0.0,python/ray/types.py,12,6,6,0,0,0,0,0,0,0,0,0,0.0,0,1,100.0
ray_2.0.0,python/ray/actor.py,1392,481,796,11,117,83,149,128,232,841.8864199962686,7.004273504273504,11374.940170940172,631.9411206077873,1624.0,129,30.87579117949234
ray_2.0.0,python/ray/cluster_utils.py,369,162,222,11,38,22,41,49,63,237.47499331586653,5.934210526315789,2099.088826326913,116.61604590705072,353.7267201792581,43,56.82263769369064
ray_2.0.0,python/ray/remote_function.py,404,142,216,10,48,31,56,58,87,301.29748098348915,5.833333333333333,2972.925355027243,165.16251972373573,509.64434657609877,28,59.373737070596064
ray_2.0.0,python/ray/runtime_context.py,363,140,140,6,35,23,36,41,59,195.03468059740075,3.085714285714286,975.3806106693266,54.18781170385148,316.09556827246695,46,53.58617124698711
ray_2.0.0,python/ray/job_config.py,152,74,99,5,16,10,20,21,30,75.60964047443682,3.125,411.77975838550884,22.87665324363938,131.76952268336282,27,66.83479665443949
ray_2.0.0,python/ray/cross_language.py,134,43,71,2,4,3,5,6,8,10.0,1.25,25.84962500721156,1.43609027817842,20.67970000576925,5,83.64121420285129
ray_2.0.0,python/ray/setup-dev.py,122,66,96,6,22,15,24,28,39,113.61727061434748,3.272727272727273,613.5933009608069,34.08851672004483,187.48684196024655,17,63.466405496589694
ray_2.0.0,python/ray/internal/__init__.py,3,2,2,0,0,0,0,0,0,0,0,0,0.0,0,1,100.0
ray_2.0.0,python/ray/util/iter_metrics.py,69,36,36,1,4,2,4,5,6,8.0,0.5,6.965784284662087,0.3869880158145604,13.931568569324174,10,85.62039758962999
ray_2.0.0,python/ray/util/rpdb.py,350,195,264,6,27,19,32,33,51,143.89173756274062,3.5555555555555554,914.7168003103328,50.817600017240714,257.2641000872811,44,47.72420691868824
ray_2.0.0,python/ray/util/iter.py,1286,611,720,16,180,111,211,196,322,1412.5335573393415,9.377777777777778,22993.71627683891,1277.4286820466061,2451.936569805097,133,26.673621127082566
ray_2.0.0,python/ray/util/timer.py,66,47,46,7,19,12,21,26,33,100.36210720983135,3.8684210526315788,600.0482387553274,33.33601326418486,155.11451069865606,17,67.04321574590543
ray_2.0.0,python/ray/util/placement_group.py,462,175,243,13,51,38,66,64,104,337.3994087763805,8.411764705882353,5248.941176470588,291.6078431372549,624.0,52,53.7439490474619
ray_2.0.0,python/ray/util/__init__.py,68,26,50,0,0,0,0,0,0,0,0,0,0.0,0,4,100.0
ray_2.0.0,python/ray/util/actor_pool.py,346,117,119,9,28,18,31,37,49,163.13526283059372,4.982142857142857,1271.7578028841674,70.65321127134263,255.26321491581857,39,49.47299369282125
ray_2.0.0,python/ray/util/check_serialize.py,245,126,188,9,38,34,58,47,92,227.95057052383706,6.868421052631579,3509.9154606969323,194.9953033720518,511.02217435434267,38,49.14033611867247
ray_2.0.0,python/ray/util/debug.py,58,36,32,4,8,4,8,12,12,32.0,2.0,86.03910001730776,4.779950000961542,43.01955000865388,5,76.79338608744519
ray_2.0.0,python/ray/util/client_connect.py,68,19,54,0,0,0,0,0,0,0,0,0,0.0,0,2,100.0
ray_2.0.0,python/ray/util/serialization_addons.py,57,22,40,0,0,0,0,0,0,0,0,0,0.0,0,3,100.0
ray_2.0.0,python/ray/util/serialization.py,52,21,21,0,0,0,0,0,0,0,0,0,0.0,0,3,100.0
ray_2.0.0,python/ray/util/annotations.py,139,54,59,5,41,24,48,46,72,231.26927266377825,2.926829268292683,1163.9896414715267,64.6660911928626,397.69646083610496,17,69.67058452110822
ray_2.0.0,python/ray/util/actor_group.py,226,105,142,8,24,13,26,32,39,134.03910001730776,4.333333333333333,844.9999999999999,46.944444444444436,195.0,34,61.87305871036844
ray_2.0.0,python/ray/util/scheduling_strategies.py,70,19,27,1,1,1,1,2,2,0.0,0.5,1.0,0.05555555555555555,2.0,4,92.74615491370335
ray_2.0.0,python/ray/util/metrics.py,339,127,174,10,37,28,46,47,74,225.9690554771448,6.216216216216216,2555.110871771713,141.95060398731738,411.03957502414517,48,58.58066826813233
ray_2.0.0,python/ray/util/queue.py,299,142,141,7,38,25,44,45,69,219.07272996525947,4.052631578947368,1535.6955526736613,85.31641959298118,378.9378636467476,56,56.42067115632939
ray_2.0.0,python/ray/util/accelerators/__init__.py,17,2,16,0,0,0,0,0,0,0,0,0,0.0,0,1,100.0
ray_2.0.0,python/ray/util/accelerators/accelerators.py,6,6,6,0,0,0,0,0,0,0,0,0,0.0,0,1,100.0
ray_2.0.0,python/ray/util/collective/collective.py,789,366,427,11,79,58,92,90,150,536.0524269110014,6.405063291139241,6237.109493815473,346.5060829897485,973.7779644494512,69,42.89986580103609
ray_2.0.0,python/ray/util/collective/__init__.py,51,2,50,0,0,0,0,0,0,0,0,0,0.0,0,1,100.0
ray_2.0.0,python/ray/util/collective/util.py,68,36,31,2,2,3,3,4,6,4.0,1.5,18.0,1.0,12.0,8,86.63885222769603
ray_2.0.0,python/ray/util/collective/const.py,34,19,14,3,4,3,5,7,8,12.75488750216347,1.875,42.11032383086406,2.3394624350480036,22.458839376460833,4,90.86997858078198
ray_2.0.0,python/ray/util/collective/types.py,115,75,75,2,4,3,5,6,8,10.0,1.25,25.84962500721156,1.43609027817842,20.67970000576925,6,67.39050499748636
ray_2.0.0,python/ray/util/collective/tests/__init__.py,0,0,0,0,0,0,0,0,0,0,0,0,0.0,0,1,100.0
ray_2.0.0,python/ray/util/collective/tests/util.py,373,243,317,3,42,32,64,45,96,231.2322192588714,2.2857142857142856,1205.0694794231972,66.94830441239985,527.2178972476488,75,22.208574333841405
ray_2.0.0,python/ray/util/collective/tests/conftest.py,91,59,65,2,8,5,10,10,15,26.0,1.25,62.28615177913805,3.4603417655076694,49.82892142331044,10,70.15348851770655
ray_2.0.0,python/ray/util/collective/tests/cpu_util.py,137,101,110,3,11,9,18,14,27,42.808635307173745,2.4545454545454546,252.32379437999938,14.017988576666632,102.7985828955553,35,37.482242967416454
ray_2.0.0,python/ray/util/collective/tests/distributed_gpu_tests/test_distributed_sendrecv.py,40,24,36,3,14,9,18,17,27,58.05785641096992,1.9285714285714286,212.84002937653557,11.824446076474198,110.36149671375918,7,54.6467655726826
ray_2.0.0,python/ray/util/collective/tests/distributed_gpu_tests/__init__.py,0,0,0,0,0,0,0,0,0,0,0,0,0.0,0,1,100.0
ray_2.0.0,python/ray/util/collective/tests/distributed_gpu_tests/test_distributed_allgather.py,138,94,116,5,53,35,70,58,105,315.1894245662864,3.30188679245283,2030.950958216399,112.83060878979994,615.0880044883951,43,41.21056815843771
ray_2.0.0,python/ray/util/collective/tests/distributed_gpu_tests/test_distributed_broadcast.py,81,41,70,3,32,18,36,35,54,164.75488750216346,1.6875,467.4059149191101,25.966995273283896,276.9812829150282,16,45.56467419108057
ray_2.0.0,python/ray/util/collective/tests/distributed_gpu_tests/test_distributed_reduce.py,127,72,108,3,61,39,78,64,117,366.52986509349955,1.9180327868852458,1346.4590163934427,74.80327868852459,702.0,37,44.475841788839155
ray_2.0.0,python/ray/util/collective/tests/distributed_gpu_tests/test_distributed_reducescatter.py,130,89,110,4,57,44,88,61,132,340.4747308073903,3.087719298245614,2417.243681162473,134.2913156201374,782.857328558301,39,43.224065698042175
ray_2.0.0,python/ray/util/collective/tests/distributed_gpu_tests/test_distributed_allreduce.py,171,77,141,4,77,47,94,81,141,490.5425636335074,2.4415584415584415,2182.555115278775,121.25306195993193,893.9188504067322,42,44.65505885705975
ray_2.0.0,python/ray/util/collective/tests/distributed_gpu_tests/test_distributed_basic_apis.py,120,82,93,2,15,12,18,17,30,60.60335893412778,1.2,147.14866228501222,8.174925682500678,122.6238852375102,30,54.281261694767096
ray_2.0.0,python/ray/util/collective/tests/distributed_multigpu_tests/test_distributed_multigpu_reducescatter.py,90,45,75,2,22,12,24,24,36,100.10749561002054,1.0909090909090908,180.0639818465036,10.003554547027978,165.05865002596164,18,55.69400894355953
ray_2.0.0,python/ray/util/collective/tests/distributed_multigpu_tests/test_distributed_multigpu_sendrecv.py,54,29,47,3,19,12,24,22,36,85.46551025759159,1.894736842105263,304.180177776523,16.89889876536239,160.5395382709427,6,60.55236689848757
ray_2.0.0,python/ray/util/collective/tests/distributed_multigpu_tests/__init__.py,0,0,0,0,0,0,0,0,0,0,0,0,0.0,0,1,100.0
ray_2.0.0,python/ray/util/collective/tests/distributed_multigpu_tests/test_distributed_multigpu_broadcast.py,112,57,100,3,35,18,36,38,54,184.27979309523727,1.542857142857143,437.22733226289984,24.29040734793888,283.3880857259536,16,42.37375413711953
ray_2.0.0,python/ray/util/collective/tests/distributed_multigpu_tests/test_distributed_multigpu_reduce.py,194,104,172,4,92,60,120,96,180,608.1676999572452,2.608695652173913,3092.0693481647168,171.78163045359537,1185.293250129808,48,35.92349691843425
ray_2.0.0,python/ray/util/collective/tests/distributed_multigpu_tests/test_distributed_multigpu_allgather.py,87,48,73,2,16,8,16,18,24,66.0,1.0,100.07820003461549,5.559900001923083,100.07820003461549,21,56.32749140790532
ray_2.0.0,python/ray/util/collective/tests/distributed_multigpu_tests/test_distributed_multigpu_basic_apis.py,101,70,76,2,14,11,17,16,28,55.30296890880645,1.2142857142857142,136.0,7.555555555555555,112.0,25,58.117827315741415
ray_2.0.0,python/ray/util/collective/tests/distributed_multigpu_tests/test_distributed_multigpu_allreduce.py,166,94,136,4,83,48,96,87,144,537.1282728017948,2.3132530120481927,2146.1988165448874,119.23326758582708,927.783863402217,40,43.12791100436834
ray_2.0.0,python/ray/util/collective/tests/single_node_gpu_tests/test_reducescatter.py,130,89,110,4,57,44,88,61,132,340.4747308073903,3.087719298245614,2417.243681162473,134.2913156201374,782.857328558301,39,43.224065698042175
ray_2.0.0,python/ray/util/collective/tests/single_node_gpu_tests/test_allreduce.py,168,81,137,4,80,48,96,84,144,513.7542475909889,2.4,2209.184901312339,122.73249451735218,920.4937088801414,43,44.11629991786659
ray_2.0.0,python/ray/util/collective/tests/single_node_gpu_tests/test_basic_apis.py,117,77,90,3,16,14,22,19,36,68.75488750216347,2.0625,315.4086178731862,17.52270099295479,152.92539048396907,29,54.55966374088767
ray_2.0.0,python/ray/util/collective/tests/single_node_gpu_tests/test_sendrecv.py,78,49,68,5,26,17,34,31,51,133.82107314610522,3.269230769230769,826.0169617510426,45.88983120839126,252.66401182973067,14,44.42444216633554
ray_2.0.0,python/ray/util/collective/tests/single_node_gpu_tests/__init__.py,0,0,0,0,0,0,0,0,0,0,0,0,0.0,0,1,100.0
ray_2.0.0,python/ray/util/collective/tests/single_node_gpu_tests/test_reduce.py,151,86,130,3,72,45,90,75,135,448.9894876060099,1.875,1576.6697310317697,87.59276283509831,840.8905232169438,46,40.18732574124256
ray_2.0.0,python/ray/util/collective/tests/single_node_gpu_tests/test_allgather.py,138,94,116,5,53,35,70,58,105,315.1894245662864,3.30188679245283,2030.950958216399,112.83060878979994,615.0880044883951,43,41.21056815843771
ray_2.0.0,python/ray/util/collective/tests/single_node_gpu_tests/test_broadcast.py,79,41,68,3,32,18,36,35,54,164.75488750216346,1.6875,467.4059149191101,25.966995273283896,276.9812829150282,16,45.56467419108057
ray_2.0.0,python/ray/util/collective/tests/single_node_cpu_tests/test_reducescatter.py,131,93,111,4,57,44,88,61,132,340.4747308073903,3.087719298245614,2417.243681162473,134.2913156201374,782.857328558301,39,42.759413653889304
ray_2.0.0,python/ray/util/collective/tests/single_node_cpu_tests/test_gloo_group_isolation.py,46,33,33,1,2,1,2,3,3,2.0,0.5,2.3774437510817346,0.1320802083934297,4.754887502163469,7,75.46933446412363
ray_2.0.0,python/ray/util/collective/tests/single_node_cpu_tests/test_allreduce.py,164,87,133,4,80,48,96,84,144,513.7542475909889,2.4,2209.184901312339,122.73249451735218,920.4937088801414,43,43.61079927089142
ray_2.0.0,python/ray/util/collective/tests/single_node_cpu_tests/test_basic_apis.py,129,84,102,3,16,14,22,19,36,68.75488750216347,2.0625,315.4086178731862,17.52270099295479,152.92539048396907,29,52.9112540414456
ray_2.0.0,python/ray/util/collective/tests/single_node_cpu_tests/test_sendrecv.py,91,57,78,5,28,18,36,33,54,146.2155782920497,3.2142857142857144,875.5626935743602,48.64237186524223,272.3972824453565,15,42.62854336378252
ray_2.0.0,python/ray/util/collective/tests/single_node_cpu_tests/__init__.py,0,0,0,0,0,0,0,0,0,0,0,0,0.0,0,1,100.0
ray_2.0.0,python/ray/util/collective/tests/single_node_cpu_tests/test_reduce.py,166,96,142,3,74,46,92,77,138,464.25443655870583,1.864864864864865,1612.7659848782935,89.59811027101631,864.8165426158964,47,38.546619846108555
ray_2.0.0,python/ray/util/collective/tests/single_node_cpu_tests/test_allgather.py,141,100,121,5,53,35,70,58,105,315.1894245662864,3.30188679245283,2030.950958216399,112.83060878979994,615.0880044883951,43,40.4319063889639
ray_2.0.0,python/ray/util/collective/tests/single_node_cpu_tests/test_broadcast.py,93,50,79,3,34,19,38,37,57,177.72862410467502,1.6764705882352942,497.809234850837,27.656068602824277,296.93884184085016,17,43.33853279715626
ray_2.0.0,python/ray/util/collective/tests/distributed_cpu_tests/test_distributed_sendrecv.py,51,30,44,3,16,10,20,19,30,68.75488750216347,1.875,238.94592263120165,13.274773479511204,127.43782540330756,8,51.96077993443882
ray_2.0.0,python/ray/util/collective/tests/distributed_cpu_tests/__init__.py,0,0,0,0,0,0,0,0,0,0,0,0,0.0,0,1,100.0
ray_2.0.0,python/ray/util/collective/tests/distributed_cpu_tests/test_distributed_allgather.py,143,100,121,5,53,35,70,58,105,315.1894245662864,3.30188679245283,2030.950958216399,112.83060878979994,615.0880044883951,43,40.4319063889639
ray_2.0.0,python/ray/util/collective/tests/distributed_cpu_tests/test_distributed_broadcast.py,95,50,81,3,34,19,38,37,57,177.72862410467502,1.6764705882352942,497.809234850837,27.656068602824277,296.93884184085016,17,43.33853279715626
ray_2.0.0,python/ray/util/collective/tests/distributed_cpu_tests/test_distributed_reduce.py,146,84,124,3,65,42,84,68,126,396.208795349013,1.9384615384615385,1486.8393856567754,82.60218809204308,767.0203179975429,39,41.84034876906911
ray_2.0.0,python/ray/util/collective/tests/distributed_cpu_tests/test_distributed_reducescatter.py,131,93,111,4,57,44,88,61,132,340.4747308073903,3.087719298245614,2417.243681162473,134.2913156201374,782.857328558301,39,42.759413653889304
ray_2.0.0,python/ray/util/collective/tests/distributed_cpu_tests/test_distributed_allreduce.py,180,91,147,4,80,50,100,84,150,513.7542475909889,2.5,2397.1190335420347,133.17327964122416,958.8476134168139,44,42.35521096484262
ray_2.0.0,python/ray/util/collective/tests/distributed_cpu_tests/test_distributed_basic_apis.py,136,89,109,2,15,12,18,17,30,60.60335893412778,1.2,147.14866228501222,8.174925682500678,122.6238852375102,30,52.47827234134268
ray_2.0.0,python/ray/util/collective/collective_group/gloo_collective_group.py,565,249,351,12,76,51,90,88,141,517.8620410303664,7.105263157894737,6471.330571618998,359.5183650899443,910.779858227859,76,43.99869793808992
ray_2.0.0,python/ray/util/collective/collective_group/__init__.py,0,0,0,0,0,0,0,0,0,0,0,0,0.0,0,1,100.0
ray_2.0.0,python/ray/util/collective/collective_group/nccl_util.py,290,135,209,5,20,12,20,25,32,98.04820237218406,2.5,371.50849518197793,20.639360843443217,148.60339807279118,43,55.13876023146757
ray_2.0.0,python/ray/util/collective/collective_group/nccl_collective_group.py,821,342,461,11,113,73,131,124,204,808.7339705579266,6.376106194690266,9045.50161144499,502.52786730249943,1418.6560473189227,88,39.878891021928844
ray_2.0.0,python/ray/util/collective/collective_group/gloo_util.py,304,160,224,4,17,11,17,21,28,77.48686830125578,2.0,245.9697756756106,13.664987537533923,122.9848878378053,53,50.52999534329048
ray_2.0.0,python/ray/util/collective/collective_group/base_collective_group.py,84,53,55,0,0,0,0,0,0,0,0,0,0.0,0,15,100.0
ray_2.0.0,python/ray/util/collective/collective_group/cuda_stream.py,94,52,48,4,8,5,8,12,13,32.0,2.0,93.20902501875007,5.178279167708337,46.604512509375034,9,78.32977657627477
ray_2.0.0,python/ray/util/collective/examples/nccl_allreduce_multigpu_example.py,43,34,34,2,4,2,4,6,6,10.0,1.0,15.509775004326936,0.861654166907052,15.509775004326936,9,57.04521231236129
ray_2.0.0,python/ray/util/collective/examples/nccl_p2p_example_multigpu.py,53,43,43,3,9,5,9,12,14,33.28421251514428,1.5,75.28421251514428,4.182456250841349,50.18947501009619,10,60.20128933077762
ray_2.0.0,python/ray/util/collective/examples/nccl_allreduce_example_declare_collective_group.py,33,22,26,1,2,1,2,3,3,2.0,0.5,2.3774437510817346,0.1320802083934297,4.754887502163469,6,65.16807746426294
ray_2.0.0,python/ray/util/collective/examples/nccl_allreduce_example.py,37,29,29,1,2,1,2,3,3,2.0,0.5,2.3774437510817346,0.1320802083934297,4.754887502163469,8,62.28193436404295
ray_2.0.0,python/ray/util/sgd/__init__.py,6,1,6,0,0,0,0,0,0,0,0,0,0.0,0,1,100.0
ray_2.0.0,python/ray/util/xgboost/__init__.py,5,1,5,0,0,0,0,0,0,0,0,0,0.0,0,1,100.0
ray_2.0.0,python/ray/util/horovod/__init__.py,5,1,5,0,0,0,0,0,0,0,0,0,0.0,0,1,100.0
ray_2.0.0,python/ray/util/client/common.py,929,495,589,17,103,73,139,120,212,758.1964226011272,11.470873786407767,16796.350899095443,933.1306055053024,1464.260806269006,144,26.7548478794118
ray_2.0.0,python/ray/util/client/dataclient.py,591,312,417,18,77,57,106,95,163,557.6012136594691,12.38961038961039,13267.866062424404,737.1036701346891,1070.8864641579446,83,38.78223013622742
ray_2.0.0,python/ray/util/client/client_app.py,90,54,54,5,24,14,28,29,42,121.64874049174458,2.9166666666666665,595.1026719031277,33.06125955017376,204.03520179535806,12,69.8594161578974
ray_2.0.0,python/ray/util/client/client_pickler.py,185,80,142,3,10,7,14,13,21,37.974168451037094,2.1,163.18939157002217,9.066077309445676,77.70923408096293,22,64.29298364624789
ray_2.0.0,python/ray/util/client/__init__.py,321,190,216,8,51,30,58,59,88,313.2936924405463,4.549019607843137,2354.9027548190465,130.82793082328035,517.6725883438421,53,48.3899427647171
ray_2.0.0,python/ray/util/client/ray_client_helpers.py,94,53,58,3,5,3,5,8,8,16.36452797660028,1.5,36.0,2.0,24.0,5,78.79036107287261
ray_2.0.0,python/ray/util/client/runtime_context.py,57,37,37,1,2,1,2,3,3,2.0,0.5,2.3774437510817346,0.1320802083934297,4.754887502163469,12,69.20485910722513
ray_2.0.0,python/ray/util/client/logsclient.py,136,84,86,5,10,7,10,15,17,44.82892142331043,2.5,166.04285031336204,9.22460279518678,66.41714012534482,24,69.91019767378721
ray_2.0.0,python/ray/util/client/options.py,42,26,31,5,12,8,16,17,24,54.62919048309069,3.3333333333333335,326.99702730002724,18.16650151666818,98.09910819000817,10,75.46277628481761
ray_2.0.0,python/ray/util/client/worker.py,886,508,672,18,137,90,159,155,249,1047.4890453915539,10.445255474452555,18924.243590970156,1051.3468661650086,1811.7549769132854,148,21.043461828519543
ray_2.0.0,python/ray/util/client/api.py,399,144,170,6,24,14,28,30,42,125.5488750216347,3.5,721.3129175544523,40.07293986413624,206.0894050155578,46,58.25537495625262
ray_2.0.0,python/ray/util/client/server/dataservicer.py,415,246,320,16,79,62,117,95,179,561.9986791059912,11.848101265822784,13933.416304331648,774.0786835739805,1176.0041538912396,68,41.529230613854416
ray_2.0.0,python/ray/util/client/server/proxier.py,839,469,602,15,75,49,91,90,140,525.7647607213188,9.1,8270.620844724006,459.4789358180003,908.8594334861544,110,29.969830911503028
ray_2.0.0,python/ray/util/client/server/server.py,929,566,779,16,145,91,174,161,265,1105.0868180521654,9.6,18649.852537923587,1036.1029187735326,1942.6929727003737,127,15.86283138752457
ray_2.0.0,python/ray/util/client/server/__init__.py,1,1,1,0,0,0,0,0,0,0,0,0,0.0,0,1,100.0
ray_2.0.0,python/ray/util/client/server/__main__.py,4,3,3,1,2,1,2,3,3,2.0,0.5,2.3774437510817346,0.1320802083934297,4.754887502163469,2,84.58174335197131
ray_2.0.0,python/ray/util/client/server/server_stubs.py,67,49,53,1,7,5,10,8,15,19.651484454403228,0.7142857142857143,32.142857142857146,1.7857142857142858,45.0,12,49.94027264549838
ray_2.0.0,python/ray/util/client/server/logservicer.py,125,98,106,8,13,11,19,21,30,72.10571633583419,5.846153846153846,770.344901841198,42.79693899117766,131.76952268336282,21,48.88342359134186
ray_2.0.0,python/ray/util/client/server/server_pickler.py,131,75,101,3,16,12,24,19,36,68.75488750216347,2.25,344.0821285889304,19.115673810496133,152.92539048396907,23,61.6535122562315
ray_2.0.0,python/ray/util/client/examples/run_tune.py,7,5,4,0,0,0,0,0,0,0,0,0,0.0,0,1,100.0
ray_2.0.0,python/ray/util/dask/scheduler.py,634,235,345,12,54,39,73,66,112,353.78347512548123,8.11111111111111,5490.996257763857,305.05534765354764,676.9721413681468,65,48.92925149320102
ray_2.0.0,python/ray/util/dask/common.py,88,45,55,1,3,2,4,4,6,4.754887502163469,0.6666666666666666,8.0,0.4444444444444444,12.0,3,83.07183336692006
ray_2.0.0,python/ray/util/dask/scheduler_utils.py,371,180,205,11,45,30,54,56,84,285.1871371398456,6.6,3219.5975687887358,178.8665315993742,487.8178134528388,59,53.20485803828308
ray_2.0.0,python/ray/util/dask/__init__.py,63,19,45,0,0,0,0,0,0,0,0,0,0.0,0,1,100.0
ray_2.0.0,python/ray/util/dask/callbacks.py,292,120,134,7,21,12,24,28,36,111.8901503327572,4.0,692.259108776295,38.45883937646083,173.06477719407374,34,62.93981327856328
ray_2.0.0,python/ray/util/dask/optimizations.py,167,74,135,7,21,13,22,28,35,111.8901503327572,3.6666666666666665,616.9438816640591,34.274660092447725,168.25742227201613,26,54.27260509346219
ray_2.0.0,python/ray/util/dask/tests/__init__.py,0,0,0,0,0,0,0,0,0,0,0,0,0.0,0,1,100.0
ray_2.0.0,python/ray/util/dask/tests/test_dask_optimization.py,66,34,49,3,9,5,10,12,15,33.28421251514428,1.6666666666666667,89.62406251802892,4.9791145843349405,53.77443751081735,7,74.16289924191027
ray_2.0.0,python/ray/util/dask/tests/test_dask_scheduler.py,159,99,107,2,16,12,24,18,36,66.0,1.5,225.17595007788483,12.509775004326935,150.11730005192322,12,60.61486255553705
ray_2.0.0,python/ray/util/dask/tests/test_dask_callback.py,243,153,148,4,32,20,38,36,58,168.0,2.375,712.1571689486785,39.56428716381547,299.8556500836541,16,54.84628000678206
ray_2.0.0,python/ray/util/dask/examples/__init__.py,0,0,0,0,0,0,0,0,0,0,0,0,0.0,0,1,100.0
ray_2.0.0,python/ray/util/dask/examples/dask_ray_persist_example.py,36,14,14,0,0,0,0,0,0,0,0,0,0.0,0,1,100.0
ray_2.0.0,python/ray/util/dask/examples/dask_ray_shuffle_optimization.py,30,12,19,1,1,1,1,2,2,0.0,0.5,1.0,0.05555555555555555,2.0,1,100.0
ray_2.0.0,python/ray/util/dask/examples/dask_ray_annotate_example.py,46,15,19,1,2,1,2,3,3,2.0,0.5,2.3774437510817346,0.1320802083934297,4.754887502163469,1,94.31811139955252
ray_2.0.0,python/ray/util/dask/examples/dask_ray_scheduler_example.py,34,16,19,0,0,0,0,0,0,0,0,0,0.0,0,1,100.0
ray_2.0.0,python/ray/util/ray_lightning/__init__.py,4,1,4,0,0,0,0,0,0,0,0,0,0.0,0,1,100.0
ray_2.0.0,python/ray/util/joblib/__init__.py,20,10,14,0,0,0,0,0,0,0,0,0,0.0,0,2,100.0
ray_2.0.0,python/ray/util/joblib/ray_backend.py,93,36,63,5,11,7,11,16,18,49.663388279447084,2.5,180.0,10.0,72.0,9,77.99366308859871
ray_2.0.0,python/ray/util/lightgbm/__init__.py,5,1,5,0,0,0,0,0,0,0,0,0,0.0,0,1,100.0
ray_2.0.0,python/ray/util/tracing/setup_tempo_tracing.py,24,8,19,0,0,0,0,0,0,0,0,0,0.0,0,1,100.0
ray_2.0.0,python/ray/util/tracing/__init__.py,0,0,0,0,0,0,0,0,0,0,0,0,0.0,0,1,100.0
ray_2.0.0,python/ray/util/tracing/setup_local_tmp_tracing.py,25,11,19,1,2,1,2,3,3,2.0,0.5,2.3774437510817346,0.1320802083934297,4.754887502163469,1,90.61673825777324
ray_2.0.0,python/ray/util/tracing/tracing_helper.py,556,264,373,9,62,41,73,71,114,397.6894962569671,5.298387096774194,3714.546449650498,206.36369164724988,701.0711716235338,44,44.75521282841521
ray_2.0.0,python/ray/util/multiprocessing/__init__.py,5,3,3,0,0,0,0,0,0,0,0,0,0.0,0,1,100.0
ray_2.0.0,python/ray/util/multiprocessing/pool.py,997,456,559,18,128,89,161,146,250,971.0586500259616,11.3203125,20347.76520667411,1130.4314003707839,1797.4561397200043,161,26.543565079699125
ray_2.0.0,python/ray/air/data_batch_type.py,10,6,8,0,0,0,0,0,0,0,0,0,0.0,0,2,100.0
ray_2.0.0,python/ray/air/constants.py,24,7,7,1,2,1,2,3,3,2.0,0.5,2.3774437510817346,0.1320802083934297,4.754887502163469,1,91.82524304259606
ray_2.0.0,python/ray/air/result.py,64,38,30,2,3,2,3,5,5,6.754887502163469,1.0,11.60964047443681,0.6449800263576005,11.60964047443681,9,85.72525646481945
ray_2.0.0,python/ray/air/__init__.py,21,5,20,0,0,0,0,0,0,0,0,0,0.0,0,1,100.0
ray_2.0.0,python/ray/air/session.py,268,46,55,1,4,4,4,5,8,8.0,0.5,9.287712379549449,0.5159840210860804,18.575424759098897,6,44.68176914470416
ray_2.0.0,python/ray/air/config.py,620,291,346,13,100,68,127,113,195,712.4913353133068,8.255,10978.612580273792,609.9229211263217,1329.9348976709618,99,40.20909080651094
ray_2.0.0,python/ray/air/checkpoint.py,700,309,362,10,73,54,84,83,138,485.0764737471149,5.7534246575342465,5061.6066498749005,281.2003694374945,879.7554415258757,91,42.06745044112167
ray_2.0.0,python/ray/air/util/check_ingest.py,193,87,150,6,25,18,35,31,53,131.60617974869504,4.2,1102.8040986921185,61.26689437178436,262.5724044505044,8,57.987259041015584
ray_2.0.0,python/ray/air/util/__init__.py,0,0,0,0,0,0,0,0,0,0,0,0,0.0,0,1,100.0
ray_2.0.0,python/ray/air/util/data_batch_conversion.py,178,91,111,5,21,13,23,26,36,103.84830635279079,2.738095238095238,463.32905793105056,25.740503218391698,169.21582985307933,28,65.43662362594331
ray_2.0.0,python/ray/air/util/tensor_extensions/arrow.py,272,103,113,7,23,16,31,30,47,123.69340944371453,4.717391304347826,1087.9429822741583,60.4412767930088,230.62385799360038,29,60.20994720575132
ray_2.0.0,python/ray/air/util/tensor_extensions/__init__.py,0,0,0,0,0,0,0,0,0,0,0,0,0.0,0,1,100.0
ray_2.0.0,python/ray/air/util/tensor_extensions/pandas.py,1363,438,501,13,97,55,102,110,157,688.2972620279857,6.835051546391752,7277.098081860777,404.28322677004314,1064.6734750233716,145,21.588191958280486
ray_2.0.0,python/ray/air/tests/test_mlflow.py,133,83,106,1,19,12,24,20,36,80.71062275542812,0.631578947368421,98.26699668375477,5.459277593541931,155.58941141594505,25,45.271545935588456
ray_2.0.0,python/ray/air/tests/test_checkpoints.py,569,358,341,6,44,25,45,50,70,255.724766224368,3.0681818181818183,1212.1463862129808,67.34146590072116,395.06993328423073,77,39.10781481756158
ray_2.0.0,python/ray/air/tests/test_data_batch_conversion.py,172,114,135,3,5,3,5,8,8,16.36452797660028,1.5,36.0,2.0,24.0,9,44.25596796385956
ray_2.0.0,python/ray/air/tests/__init__.py,0,0,0,0,0,0,0,0,0,0,0,0,0.0,0,1,100.0
ray_2.0.0,python/ray/air/tests/conftest.py,2,1,1,0,0,0,0,0,0,0,0,0,0.0,0,1,100.0
ray_2.0.0,python/ray/air/tests/test_api.py,211,116,142,3,18,11,22,21,33,79.81353752812508,1.8333333333333333,265.73520407811503,14.763066893228613,144.94647495169912,14,54.51694824970109
ray_2.0.0,python/ray/air/tests/test_keras_callback.py,98,49,78,5,10,5,10,15,15,44.82892142331043,2.5,146.50839733531944,8.139355407517748,58.60335893412778,6,59.46875627152645
ray_2.0.0,python/ray/air/tests/test_remote_storage.py,163,105,118,2,3,2,3,5,5,6.754887502163469,1.0,11.60964047443681,0.6449800263576005,11.60964047443681,6,47.64695673688022
ray_2.0.0,python/ray/air/tests/test_configs.py,41,12,33,2,6,3,6,8,9,17.509775004326936,1.0,27.0,1.5,27.0,4,65.89833951474381
ray_2.0.0,python/ray/air/tests/test_checkpoint_manager.py,95,44,67,1,14,7,14,15,21,53.30296890880645,0.5,41.02235125388945,2.279019514104969,82.0447025077789,14,56.18762410879024
ray_2.0.0,python/ray/air/tests/test_resource_changing.py,144,68,122,6,16,10,17,22,27,79.50977500432694,3.1875,383.7898336789724,21.321657426609576,120.40465370320703,11,55.88642986191692
ray_2.0.0,python/ray/air/tests/test_tensor_extension.py,166,102,114,9,40,21,42,49,63,241.40644880847532,4.725,1671.3587528469945,92.85326404705525,353.7267201792581,11,52.937084250565704
ray_2.0.0,python/ray/air/tests/test_dataset_config.py,381,200,299,7,48,34,65,55,99,287.7296844890187,4.739583333333333,2712.7223780803993,150.7067987822444,572.3546116389414,7,42.64306839830336
ray_2.0.0,python/ray/air/tests/_huggingface_data.py,7,2,6,0,0,0,0,0,0,0,0,0,0.0,0,1,100.0
ray_2.0.0,python/ray/air/callbacks/__init__.py,0,0,0,0,0,0,0,0,0,0,0,0,0.0,0,1,100.0
ray_2.0.0,python/ray/air/callbacks/keras.py,192,100,126,10,49,27,51,59,78,308.3400633105188,5.204081632653061,2387.8728622817757,132.65960346009865,458.8461578502236,49,55.08371265045016
ray_2.0.0,python/ray/air/callbacks/mlflow.py,134,43,60,4,7,4,7,11,11,27.651484454403228,2.0,76.10749561002055,4.228194200556697,38.053747805010275,12,80.0647356245559
ray_2.0.0,python/ray/air/callbacks/wandb.py,413,205,262,8,48,32,57,56,89,292.0782000346155,4.75,2455.0592932998525,136.39218296110292,516.8545880631268,68,48.540430794836844
ray_2.0.0,python/ray/air/callbacks/comet.py,249,118,124,6,14,8,15,20,23,68.81274391313339,3.2142857142857144,319.51396987203003,17.75077610400167,99.40434618240934,36,65.20662128073235
ray_2.0.0,python/ray/air/examples/custom_trainer.py,60,31,28,2,4,3,6,6,9,10.0,1.5,34.89699375973561,1.938721875540867,23.264662506490403,6,86.30262504303458
ray_2.0.0,python/ray/air/examples/__init__.py,0,0,0,0,0,0,0,0,0,0,0,0,0.0,0,1,100.0
ray_2.0.0,python/ray/air/examples/pytorch_geometric/distributed_sage_example.py,232,110,169,6,31,20,36,37,56,169.0898606263201,3.4838709677419355,1016.3475469459319,56.46375260810733,291.7293884752212,17,55.0446103614001
ray_2.0.0,python/ray/air/examples/pytorch_geometric/__init__.py,0,0,0,0,0,0,0,0,0,0,0,0,0.0,0,1,100.0
ray_2.0.0,python/ray/air/examples/pytorch/torch_linear_example.py,139,85,105,4,11,6,12,15,18,46.053747805010275,2.1818181818181817,153.43424884571635,8.52412493587313,70.32403072095333,9,53.80074065080394
ray_2.0.0,python/ray/air/examples/pytorch/tune_torch_regression_example.py,82,34,70,1,2,1,2,3,3,2.0,0.5,2.3774437510817346,0.1320802083934297,4.754887502163469,3,68.61526224489643
ray_2.0.0,python/ray/air/examples/pytorch/torch_regression_example.py,174,106,133,3,8,5,10,11,15,28.75488750216347,1.875,97.296514274174,5.405361904120777,51.89147427955947,8,51.688183478963374
ray_2.0.0,python/ray/air/examples/pytorch/torch_fashion_mnist_example.py,159,84,123,6,23,14,28,29,42,119.55169999363824,3.652173913043478,745.1720413395685,41.39844674108714,204.03520179535806,9,55.38312351296191
ray_2.0.0,python/ray/air/examples/pytorch/__init__.py,0,0,0,0,0,0,0,0,0,0,0,0,0.0,0,1,100.0
ray_2.0.0,python/ray/air/examples/horovod/horovod_pytorch_example.py,270,123,222,9,19,12,22,28,34,109.23994776840894,5.2105263157894735,851.6608772445206,47.31449318025115,163.45006734995852,21,50.6256569144017
ray_2.0.0,python/ray/air/examples/horovod/__init__.py,0,0,0,0,0,0,0,0,0,0,0,0,0.0,0,1,100.0
ray_2.0.0,python/ray/air/examples/horovod/horovod_cifar_pbt_example.py,175,83,140,7,19,15,29,26,44,100.36210720983135,5.342105263157895,1104.8507253272694,61.38059585151497,206.81934759820808,17,55.68099379980886
ray_2.0.0,python/ray/air/examples/horovod/horovod_tune_example.py,150,93,121,7,60,43,80,67,123,374.06492019091434,4.666666666666667,3481.9351953227615,193.44084418459786,746.128970426306,12,44.70170348449014
ray_2.0.0,python/ray/air/examples/tf/tune_tensorflow_mnist_example.py,75,29,67,1,2,1,2,3,3,2.0,0.5,2.3774437510817346,0.1320802083934297,4.754887502163469,4,62.819946059949395
ray_2.0.0,python/ray/air/examples/tf/tensorflow_regression_example.py,158,76,129,1,2,1,2,3,3,2.0,0.5,2.3774437510817346,0.1320802083934297,4.754887502163469,6,62.51009035792099
ray_2.0.0,python/ray/air/examples/tf/tune_tensorflow_autoencoder_example.py,77,29,69,1,2,1,2,3,3,2.0,0.5,2.3774437510817346,0.1320802083934297,4.754887502163469,4,62.819946059949395
ray_2.0.0,python/ray/air/examples/tf/tensorflow_autoencoder_example.py,236,115,180,4,9,6,11,13,17,36.52932501298081,2.4444444444444446,153.7738282871965,8.542990460399805,62.907475208398566,6,57.61854255393746
ray_2.0.0,python/ray/air/examples/tf/tensorflow_mnist_example.py,130,56,103,3,6,3,6,9,9,20.264662506490406,1.5,42.793987519471216,2.377443751081734,28.529325012980813,4,66.17477962411145
ray_2.0.0,python/ray/air/examples/tf/__init__.py,0,0,0,0,0,0,0,0,0,0,0,0,0.0,0,1,100.0
ray_2.0.0,python/ray/air/examples/huggingface/__init__.py,0,0,0,0,0,0,0,0,0,0,0,0,0.0,0,1,100.0
ray_2.0.0,python/ray/air/examples/huggingface/huggingface_basic_language_modeling_example.py,215,76,177,5,7,5,9,12,14,31.26112492884004,3.2142857142857144,161.32331253245204,8.962406251802891,50.18947501009619,4,63.58663666532931
ray_2.0.0,python/ray/air/_internal/tensorflow_utils.py,139,48,60,4,7,4,8,11,12,27.651484454403228,2.2857142857142856,94.88726725405158,5.27151484744731,41.51317942364757,13,77.4363365135978
ray_2.0.0,python/ray/air/_internal/torch_utils.py,192,69,105,6,17,9,17,23,26,84.99664330558272,3.0,352.83783257244704,19.60210180958039,117.61261085748234,17,72.32943399048972
ray_2.0.0,python/ray/air/_internal/checkpointing.py,33,22,25,0,0,0,0,0,0,0,0,0,0.0,0,3,100.0
ray_2.0.0,python/ray/air/_internal/__init__.py,0,0,0,0,0,0,0,0,0,0,0,0,0.0,0,1,100.0
ray_2.0.0,python/ray/air/_internal/util.py,19,12,12,1,2,1,2,3,3,2.0,0.5,2.3774437510817346,0.1320802083934297,4.754887502163469,2,71.44842835188814
ray_2.0.0,python/ray/air/_internal/session.py,90,40,36,3,3,4,7,6,11,9.509775004326938,3.5,99.52105627776452,5.528947570986918,28.43458750793272,12,81.54120259368592
ray_2.0.0,python/ray/air/_internal/config.py,47,13,27,3,6,3,6,9,9,20.264662506490406,1.5,42.793987519471216,2.377443751081734,28.529325012980813,7,93.28581327136118
ray_2.0.0,python/ray/air/_internal/remote_storage.py,220,122,145,6,23,16,25,29,41,119.55169999363824,3.260869565217391,649.4909373920559,36.08282985511422,199.1772208002305,28,53.6710041877599
ray_2.0.0,python/ray/air/_internal/checkpoint_manager.py,434,209,271,13,62,37,67,75,104,417.2658875798205,7.024193548387097,4550.252518224829,252.79180656804607,647.7971438115716,68,46.85933096802087
ray_2.0.0,python/ray/air/_internal/mlflow.py,321,126,174,5,20,14,28,25,42,98.04820237218406,3.5,682.6468598968845,37.92482554982692,195.04195997053841,44,61.35333311783052
ray_2.0.0,python/ray/air/_internal/filelock.py,34,22,23,1,4,2,4,5,6,8.0,0.5,6.965784284662087,0.3869880158145604,13.931568569324174,5,62.03362213618932
ray_2.0.0,python/ray/air/_internal/json.py,31,22,22,2,4,2,4,6,6,10.0,1.0,15.509775004326936,0.861654166907052,15.509775004326936,10,73.53591540428108
ray_2.0.0,python/ray/tests/test_dashboard.py,245,123,198,5,24,12,24,29,36,121.64874049174458,2.5,437.2182895614816,24.289904975637867,174.88731582459263,20,46.33664382845008
ray_2.0.0,python/ray/tests/test_serve_ray_minimal.py,28,14,16,1,2,1,2,3,3,2.0,0.5,2.3774437510817346,0.1320802083934297,4.754887502163469,3,96.64108870402347
ray_2.0.0,python/ray/tests/test_component_failures.py,191,100,112,5,25,16,32,30,48,127.70604521880493,3.2,753.6983954854685,41.87213308252603,235.53074858920888,14,64.85643055203516
ray_2.0.0,python/ray/tests/test_runtime_env_complicated.py,1055,576,771,10,114,74,147,124,221,812.1687425636542,6.447368421052632,9908.814716470984,550.4897064706103,1536.8773845954995,61,29.95916427222678
ray_2.0.0,python/ray/tests/test_state_api.py,2731,1413,1999,14,389,261,521,403,782,3400.113617108435,9.375321336760926,63451.47516736363,3525.0819537424236,6767.92537430887,193,0.9809813869540421
ray_2.0.0,python/ray/tests/test_reconstruction_2.py,533,355,421,9,71,62,117,80,179,465.1613704978132,7.415492957746479,8391.558174796015,466.1976763775564,1131.6251289848378,28,34.8092549561164
ray_2.0.0,python/ray/tests/test_client_metadata.py,54,37,35,3,13,8,16,16,24,52.860603837997665,1.8461538461538463,177.23076923076923,9.846153846153847,96.0,13,60.19586354326352
ray_2.0.0,python/ray/tests/test_command_runner.py,447,190,367,3,24,13,24,27,37,114.79398751947123,1.5,263.89625637007254,14.660903131670697,175.93083758004835,19,47.06735974656357
ray_2.0.0,python/ray/tests/test_threaded_actor.py,300,194,219,8,39,24,47,47,71,230.1306865356277,4.82051282051282,1901.093640825464,105.61631337919245,394.37580846911226,36,47.36515797576371
ray_2.0.0,python/ray/tests/test_metrics_agent.py,505,273,364,7,61,39,72,68,111,381.4264620457393,4.131147540983607,2791.450993368107,155.0806107426726,675.7083753787878,21,46.28576074848595
ray_2.0.0,python/ray/tests/test_client_proxy.py,409,194,287,6,43,23,44,49,67,248.83915945651714,3.0697674418604652,1154.802182822207,64.15567682345595,376.18555955571895,26,51.887679909780495
ray_2.0.0,python/ray/tests/test_gcs_utils.py,198,132,153,2,73,44,88,75,132,453.8571927982413,1.2054794520547945,991.1501083397279,55.06389490776266,822.2040671454562,46,35.50936860611944
ray_2.0.0,python/ray/tests/test_basic_5.py,187,98,139,5,45,32,63,50,95,258.7430298092722,3.5,1876.5821831000958,104.2545657277831,536.1663380285988,35,47.457622912731956
ray_2.0.0,python/ray/tests/test_runtime_env_env_vars.py,309,140,232,3,56,37,74,59,111,329.9667631373893,1.9821428571428572,1294.2865180569154,71.90480655871752,652.9733784791645,39,45.64563057387436
ray_2.0.0,python/ray/tests/test_actor_out_of_order.py,60,39,39,1,6,3,6,7,9,15.509775004326936,0.5,12.63309714925922,0.701838730514401,25.26619429851844,5,64.32412389375757
ray_2.0.0,python/ray/tests/test_runtime_env_2.py,134,93,100,6,13,9,17,19,26,63.61549134016113,3.923076923076923,433.2886063712457,24.071589242846983,110.44611534953322,7,54.880033721348106
ray_2.0.0,python/ray/tests/test_memory_scheduling.py,84,70,65,5,32,24,48,37,72,171.60964047443682,3.75,1406.5524087198166,78.14180048443426,375.08064232528443,8,51.0462397764417
ray_2.0.0,python/ray/tests/test_gcs_ha_e2e.py,196,63,133,4,12,10,19,16,29,51.01955000865388,3.1666666666666665,367.3333333333333,20.407407407407405,116.0,15,64.468595609074
ray_2.0.0,python/ray/tests/test_scheduling_performance.py,111,73,79,6,17,12,24,23,36,84.99664330558272,4.235294117647059,689.7101523588105,38.31723068660059,162.84823041805248,15,62.27085972921553
ray_2.0.0,python/ray/tests/test_advanced_8.py,697,340,524,9,75,45,88,84,133,495.69072680017183,5.28,4488.940986972157,249.38561038734204,850.178217229575,59,36.53191718854465
ray_2.0.0,python/ray/tests/test_multi_node.py,434,121,302,5,43,23,46,48,69,244.939024926627,2.6744186046511627,1030.6204056563345,57.256689203129696,385.3624125497598,25,55.25291824856752
ray_2.0.0,python/ray/tests/test_autoscaling_policy.py,628,362,481,10,91,57,106,101,163,625.4285932069549,5.824175824175824,6320.910879065138,351.1617155036188,1085.2884716885426,113,26.582474359806927
ray_2.0.0,python/ray/tests/test_actor_resources.py,673,418,480,10,152,89,178,162,267,1134.9042629922988,5.855263157894737,11474.793132799166,637.4885073777315,1959.7399507701946,94,28.265428302588514
ray_2.0.0,python/ray/tests/test_plasma_unlimited.py,335,200,244,10,54,38,76,64,114,343.983206065701,7.037037037037037,4813.333333333333,267.4074074074074,684.0,11,51.888742726505285
ray_2.0.0,python/ray/tests/test_pydantic_serialization.py,191,124,115,1,2,1,2,3,3,2.0,0.5,2.3774437510817346,0.1320802083934297,4.754887502163469,3,57.08024597797568
ray_2.0.0,python/ray/tests/test_unhandled_error.py,39,22,22,4,10,5,10,14,15,41.219280948873624,2.0,114.22064766172811,6.345591536762672,57.110323830864054,5,82.15363374387339
ray_2.0.0,python/ray/tests/test_typing.py,50,32,32,3,11,7,12,14,19,42.808635307173745,1.6363636363636365,118.37412575851823,6.57634031991768,72.33974351909447,9,79.72434236764036
ray_2.0.0,python/ray/tests/test_basic.py,967,608,699,13,222,138,268,235,406,1778.4660386655578,7.846846846846847,25093.163799513466,1394.064655528526,3197.86588030539,118,16.014764201648152
ray_2.0.0,python/ray/tests/test_client_init.py,239,153,172,7,33,19,38,40,57,186.1164903932322,4.03030303030303,1222.592026889124,67.921779271618,303.3499014085797,29,46.83430981668552
ray_2.0.0,python/ray/tests/test_tls_auth.py,161,42,128,4,14,7,14,18,21,61.30296890880645,2.0,175.1368500605771,9.729825003365395,87.56842503028855,9,62.461525857188356
ray_2.0.0,python/ray/tests/test_serialization.py,691,382,503,15,164,110,207,179,317,1265.2418876914937,9.466463414634147,22457.950037574843,1247.6638909763801,2372.3696013927693,74,27.70787817002825
ray_2.0.0,python/ray/tests/test_autoscaler_yaml.py,669,321,535,8,78,52,100,86,152,514.2613730712553,5.128205128205129,5009.19098828061,278.28838823781166,976.7922427147189,74,34.46974545944405
ray_2.0.0,python/ray/tests/test_cross_language.py,34,22,22,1,2,1,2,3,3,2.0,0.5,2.3774437510817346,0.1320802083934297,4.754887502163469,3,65.57158623619276
ray_2.0.0,python/ray/tests/test_shuffle.py,57,38,40,1,2,1,2,3,3,2.0,0.5,2.3774437510817346,0.1320802083934297,4.754887502163469,5,69.53399966572086
ray_2.0.0,python/ray/tests/test_autoscaler.py,3386,1862,2756,17,366,266,521,383,787,3186.2330091132158,12.099726775956285,81714.35358891265,4539.686310495147,6753.4048579749415,424,0.0
ray_2.0.0,python/ray/tests/test_generators.py,103,60,75,3,6,4,8,9,12,20.264662506490406,2.0,76.0782000346155,4.226566668589751,38.03910001730775,14,65.5616143463527
ray_2.0.0,python/ray/tests/test_job.py,285,140,204,5,45,33,60,50,93,258.7430298092722,3.3333333333333335,1749.5954188301646,97.1997454905647,524.8786256490494,31,46.00034327792714
ray_2.0.0,python/ray/tests/test_worker_capping.py,190,126,127,8,45,30,53,53,83,271.13338933483533,4.711111111111111,2239.7441848554236,124.43023249196797,475.4173977287456,18,50.406510416456165
ray_2.0.0,python/ray/tests/test_exit_observability.py,313,199,212,5,69,35,69,74,104,433.09782799213053,2.5,1614.4578750635274,89.69210417019596,645.7831500254109,6,51.63607122278588
ray_2.0.0,python/ray/tests/mock_setup_worker.py,46,18,36,2,4,2,4,6,6,10.0,1.0,15.509775004326936,0.861654166907052,15.509775004326936,2,77.73141941419031
ray_2.0.0,python/ray/tests/test_advanced_5.py,236,140,167,9,66,42,84,75,126,427.4593368906387,5.7272727272727275,4494.942069559664,249.71900386442576,784.831155002481,31,51.248815806493894
ray_2.0.0,python/ray/tests/test_advanced_9.py,263,134,193,8,37,23,45,45,68,216.74977452827116,4.864864864864865,1816.7643756506816,100.93135420281564,373.4460105504179,18,49.134432848990684
ray_2.0.0,python/ray/tests/test_concurrency_group.py,171,126,122,3,23,16,31,26,47,108.79681249147477,2.0217391304347827,446.6439566955373,24.813553149752074,220.92066675263135,13,58.55420615140561
ray_2.0.0,python/ray/tests/test_multi_tenancy.py,329,155,215,10,75,55,110,85,165,500.38068273606467,7.333333333333333,7755.36303272662,430.85350181814556,1057.549504462721,29,51.243084585368706
ray_2.0.0,python/ray/tests/test_async.py,168,115,121,3,30,22,43,33,65,151.96160537041902,2.15,704.9540781803438,39.16411545446354,327.8856177582995,23,42.03688988129887
ray_2.0.0,python/ray/tests/test_tempfile.py,165,89,127,6,29,17,31,35,48,156.39122386302654,3.206896551724138,789.5558409531837,43.864213386287986,246.20558481335837,27,52.423758590675746
ray_2.0.0,python/ray/tests/test_autoscaler_drain_node_api.py,117,53,69,2,9,6,12,11,18,30.529325012980813,1.3333333333333333,83.02635884729514,4.612575491516397,62.26976913547136,6,75.93889018002977
ray_2.0.0,python/ray/tests/test_object_spilling_3.py,371,229,276,11,73,59,116,84,175,489.91094060325156,8.73972602739726,9776.74301716779,543.152389842655,1118.655548986283,31,41.9665935562958
ray_2.0.0,python/ray/tests/test_scheduling_2.py,713,362,565,9,79,57,110,88,167,526.5280041189719,6.265822784810126,6759.1001867677505,375.5055659315417,1078.7250803124289,42,31.140364870529723
ray_2.0.0,python/ray/tests/test_advanced.py,392,223,267,10,65,43,78,75,121,424.67318879572315,6.0,4522.122369300009,251.2290205166672,753.6870615500015,38,46.02628759011783
ray_2.0.0,python/ray/tests/test_multiprocessing.py,661,452,478,11,120,81,150,131,231,866.8806192780326,6.875,11169.954904316663,620.5530502398146,1624.720713355151,106,23.953203268356376
ray_2.0.0,python/ray/tests/test_healthcheck.py,76,51,53,3,8,11,22,11,33,28.75488750216347,4.125,470.91512908700213,26.161951615944563,114.16124341503082,13,60.43361511708276
ray_2.0.0,python/ray/tests/test_node_manager.py,57,29,33,1,2,1,2,3,3,2.0,0.5,2.3774437510817346,0.1320802083934297,4.754887502163469,4,87.73876675336228
ray_2.0.0,python/ray/tests/test_client_multi.py,203,118,153,2,19,10,20,21,30,82.71062275542812,1.0526315789473684,138.70476071932927,7.705820039962737,131.76952268336282,10,54.647420658107634
ray_2.0.0,python/ray/tests/test_cli.py,913,403,676,16,89,66,122,105,188,640.3402753560094,10.96629213483146,13842.511028601364,769.0283904778536,1262.278157321231,42,36.38593851380955
ray_2.0.0,python/ray/tests/test_runtime_env_conda_and_pip_4.py,133,67,83,7,17,10,19,24,29,89.13835275565901,3.911764705882353,520.1235401553382,28.895752230852125,132.96391252091354,11,67.85176081378759
ray_2.0.0,python/ray/tests/test_object_spilling_no_asan.py,56,28,41,6,16,13,26,22,39,79.50977500432694,4.875,847.8494364934161,47.10274647185645,173.9178331268546,7,76.7695175349824
ray_2.0.0,python/ray/tests/test_actor_failures.py,795,504,533,12,76,66,120,88,186,517.8620410303664,9.473684210526315,11382.198452209303,632.3443584560723,1201.4542810665375,52,36.126590913632775
ray_2.0.0,python/ray/tests/test_stress_sharded.py,99,62,67,3,17,9,18,20,27,74.24175580341925,1.588235294117647,185.3344459513463,10.296358108408128,116.69205856195879,16,61.266460069763724
ray_2.0.0,python/ray/tests/test_raylet_output.py,63,41,45,4,13,7,14,17,21,56.105716335834195,2.1538461538461537,184.87908851193845,10.27106047288547,85.83671966625714,5,67.54300026761938
ray_2.0.0,python/ray/tests/test_asyncio_cluster.py,40,29,27,1,2,1,2,3,3,2.0,0.5,2.3774437510817346,0.1320802083934297,4.754887502163469,3,78.58390317922692
ray_2.0.0,python/ray/tests/test_runtime_env_working_dir.py,582,335,437,7,103,88,174,110,262,708.3610387542747,5.912621359223301,10505.050419131725,583.6139121739848,1776.7162449434609,42,34.5566798328233
ray_2.0.0,python/ray/tests/test_grpc_client_credentials.py,64,41,41,1,6,4,8,7,12,15.509775004326936,0.6666666666666666,22.458839376460833,1.2477132986922685,33.68825906469125,7,68.72596870958137
ray_2.0.0,python/ray/tests/test_chaos.py,255,137,203,8,27,16,29,35,45,152.38196255841368,4.296296296296297,991.6613832760269,55.092299070890384,230.81773576252348,25,49.98050062824227
ray_2.0.0,python/ray/tests/test_memstat.py,386,291,294,6,121,83,169,127,252,852.6922267145529,4.190082644628099,7379.357936535198,409.964329807511,1761.148541066586,68,31.27811785073005
ray_2.0.0,python/ray/tests/test_basic_4.py,285,181,205,10,42,25,49,52,74,259.6966127055816,5.833333333333333,2460.6898116642383,136.70498953690213,421.83253914244085,21,50.09530582720906
ray_2.0.0,python/ray/tests/test_stress.py,109,77,78,4,12,6,12,16,18,51.01955000865388,2.0,144.0,8.0,72.0,22,52.40869524964479
ray_2.0.0,python/ray/tests/test_advanced_4.py,304,168,214,7,40,29,54,47,83,232.52860824989773,4.725,2178.3708829066773,121.02060460592651,461.03087468924394,29,48.53474426537817
ray_2.0.0,python/ray/tests/test_runtime_env_fork_process.py,100,63,78,2,10,6,12,12,18,35.219280948873624,1.2,77.43519001557698,4.301955000865387,64.52932501298082,6,58.828060494315345
ray_2.0.0,python/ray/tests/test_runtime_env_working_dir_3.py,472,275,347,10,75,61,109,85,170,500.38068273606467,7.266666666666667,7917.734269775442,439.87412609863566,1089.5964591434094,52,36.190401119915904
ray_2.0.0,python/ray/tests/test_client_warnings.py,45,29,30,2,4,2,4,6,6,10.0,1.0,15.509775004326936,0.861654166907052,15.509775004326936,6,73.86349401321495
ray_2.0.0,python/ray/tests/test_list_actors.py,62,46,44,3,25,15,27,28,42,120.85129224653159,1.62,327.0924288967994,18.171801605377745,201.90890672641936,15,60.63002621294788
ray_2.0.0,python/ray/tests/test_autoscaler_fake_multinode.py,65,29,51,2,5,5,10,7,15,13.60964047443681,2.0,84.22064766172812,4.678924870096007,42.11032383086406,3,72.35318549732372
ray_2.0.0,python/ray/tests/test_cli_logger.py,24,17,17,1,8,4,8,9,12,24.0,0.5,19.019550008653876,1.0566416671474377,38.03910001730775,6,61.287221063069296
ray_2.0.0,python/ray/tests/test_failure.py,653,394,429,9,100,57,112,109,169,692.9149439904534,5.04,5764.868680471995,320.2704822484441,1143.8231508873005,50,38.920019680911906
ray_2.0.0,python/ray/tests/test_actor_pool.py,260,197,192,7,53,45,88,60,133,323.2312685462528,5.811320754716981,4565.469176575611,253.6371764764228,785.616449215933,39,35.699760700704125
ray_2.0.0,python/ray/tests/test_actor_in_container.py,79,52,62,2,8,4,8,10,12,26.0,1.0,39.863137138648355,2.2146187299249087,39.863137138648355,6,50.55292472384168
ray_2.0.0,python/ray/tests/conftest.py,1044,605,742,15,105,78,143,120,221,763.5991382890707,10.214285714285714,15591.318820929713,866.1843789405397,1526.4228216294825,71,28.182838264372656
ray_2.0.0,python/ray/tests/test_stress_failure.py,362,202,211,12,89,56,112,101,168,619.3598253646633,7.550561797752809,8445.903860188166,469.21688112156477,1118.5795291023016,45,51.18424363665921
ray_2.0.0,python/ray/tests/test_runtime_env_ray_minimal.py,102,49,72,1,7,4,8,8,12,19.651484454403228,0.5714285714285714,20.57142857142857,1.1428571428571428,36.0,6,69.03007574579424
ray_2.0.0,python/ray/tests/mock_s3_server.py,88,64,70,1,2,1,2,3,3,2.0,0.5,2.3774437510817346,0.1320802083934297,4.754887502163469,6,70.4292188954974
ray_2.0.0,python/ray/tests/test_basic_2.py,793,507,573,11,150,103,203,161,306,1122.3765513793924,7.443333333333333,16697.33613660654,927.62978536703,2243.260564703073,75,25.352241238181268
ray_2.0.0,python/ray/tests/test_placement_group_mini_integration.py,137,89,93,8,18,10,19,26,29,99.05865002596161,4.222222222222222,575.5427299323871,31.97459610735484,136.3127518260917,7,65.55661434163324
ray_2.0.0,python/ray/tests/test_k8s_cluster_launcher.py,111,70,71,3,13,7,14,16,21,52.860603837997665,1.6153846153846154,135.6923076923077,7.538461538461539,84.0,14,69.21608621580455
ray_2.0.0,python/ray/tests/test_runtime_env_working_dir_remote_uri.py,146,107,99,8,27,22,44,35,66,152.38196255841368,6.518518518518518,2206.7315379567676,122.59619655315376,338.53267911836775,23,53.55305049383215
ray_2.0.0,python/ray/tests/test_client_reconnect.py,584,325,368,10,65,44,84,75,128,424.67318879572315,6.461538461538462,5151.712196939362,286.2062331632979,797.2887923834727,64,43.663036586210914
ray_2.0.0,python/ray/tests/test_advanced_6.py,241,132,166,6,29,17,33,35,50,156.39122386302654,3.413793103448276,875.5155494440546,48.63975274689192,256.46415084724833,14,55.372633696527835
ray_2.0.0,python/ray/tests/test_top_level_api.py,65,26,47,3,8,4,8,11,12,28.75488750216347,1.5,62.26976913547136,3.4594316186372978,41.51317942364757,9,76.31616075330419
ray_2.0.0,python/ray/tests/test_placement_group_5.py,226,132,142,4,7,4,7,11,11,27.651484454403228,2.0,76.10749561002055,4.228194200556697,38.053747805010275,14,67.19891535873967
ray_2.0.0,python/ray/tests/test_advanced_2.py,508,354,359,8,106,65,130,114,195,737.1595681836991,4.90566037735849,6536.368372040612,363.1315762244784,1332.4135527621247,44,36.85984669752947
ray_2.0.0,python/ray/tests/test_tensorflow.py,260,148,166,8,45,30,59,53,89,271.13338933483533,5.2444444444444445,2673.5386939476766,148.52992744153758,509.7849204561248,36,53.32618562148211
ray_2.0.0,python/ray/tests/test_protobuf_compatibility.py,35,20,21,1,6,3,6,7,9,15.509775004326936,0.5,12.63309714925922,0.701838730514401,25.26619429851844,4,81.89032519587693
ray_2.0.0,python/ray/tests/test_client_library_integration.py,75,48,49,2,9,6,10,11,16,30.529325012980813,1.1111111111111112,61.50100655355196,3.4167225863084423,55.350905898196764,11,73.18539869655434
ray_2.0.0,python/ray/tests/test_scheduling.py,748,455,535,12,81,54,105,93,159,556.5474002423084,7.777777777777778,8086.759729736933,449.2644294298296,1039.726250966177,66,33.01754413061153
ray_2.0.0,python/ray/tests/client_test_utils.py,38,24,24,0,0,0,0,0,0,0,0,0,0.0,0,3,100.0
ray_2.0.0,python/ray/tests/test_environ.py,43,35,35,4,8,5,9,12,14,32.0,2.25,112.92631877271643,6.273684376262024,50.18947501009619,5,53.73752843119754
ray_2.0.0,python/ray/tests/test_error_ray_not_initialized.py,54,27,39,1,2,1,2,3,3,2.0,0.5,2.3774437510817346,0.1320802083934297,4.754887502163469,3,81.64177654719151
ray_2.0.0,python/ray/tests/test_actor.py,1210,810,834,9,220,143,281,229,424,1740.428461988406,5.747727272727273,19104.424693548186,1061.3569274193437,3323.8224061531046,117,14.210517920087028
ray_2.0.0,python/ray/tests/test_traceback.py,396,235,288,4,31,20,39,35,59,161.58008562199316,2.5161290322580645,761.4503369026044,42.30279649458913,302.627697999753,26,47.60609463663165
ray_2.0.0,python/ray/tests/test_global_gc.py,225,130,154,6,40,27,50,46,77,228.38689879982144,3.75,1594.9285148114625,88.60713971174792,425.31427061639,16,53.95776805407963
ray_2.0.0,python/ray/tests/test_runtime_env_conda_and_pip.py,218,115,142,3,16,11,18,19,29,68.75488750216347,1.6875,207.88295268914544,11.549052927174747,123.18989788986397,19,62.44113489134481
ray_2.0.0,python/ray/tests/test_autoscaler_gcp.py,72,35,42,3,7,4,7,10,11,24.406371956566698,1.5,54.81181356564148,3.0451007536467487,36.541209043760986,9,82.16764705791437
ray_2.0.0,python/ray/tests/test_response_cache.py,227,122,117,4,43,27,50,47,77,241.3293844521902,2.3255813953488373,994.6589339050654,55.258829661392525,427.7033415791781,35,60.582175788301555
ray_2.0.0,python/ray/tests/test_object_spilling.py,581,330,460,13,117,86,170,130,256,851.9383885270926,9.444444444444445,16978.52484572213,943.2513803178962,1797.7261601352843,52,33.8883425222737
ray_2.0.0,python/ray/tests/test_debug_tools.py,58,32,39,1,4,2,4,5,6,8.0,0.5,6.965784284662087,0.3869880158145604,13.931568569324174,6,78.10690251866792
ray_2.0.0,python/ray/tests/test_basic_3.py,141,90,109,8,43,32,66,51,98,257.3293844521902,6.1395348837209305,3412.9532197089898,189.608512206055,555.8976835132066,18,51.294007834531975
ray_2.0.0,python/ray/tests/test_state_api_summary.py,479,235,396,7,117,88,175,124,263,823.4841566456615,5.235042735042735,9574.650411533725,531.9250228629847,1828.9536296317483,55,34.72017315157516
ray_2.0.0,python/ray/tests/test_array.py,252,153,204,5,33,18,36,38,54,178.07464641326578,2.727272727272727,772.8765974344188,42.9375887463566,283.3880857259536,10,51.493982541380085
ray_2.0.0,python/ray/tests/test_actor_group.py,100,68,68,3,24,16,29,27,45,114.79398751947123,1.8125,387.82051189520797,21.54558399417822,213.9699375973561,17,53.74987572342836
ray_2.0.0,python/ray/tests/test_multinode_failures.py,186,110,132,7,32,20,38,39,58,179.65148445440323,4.15625,1274.1122723844808,70.78401513247115,306.5533286940104,24,57.76670096279038
ray_2.0.0,python/ray/tests/test_runtime_env_working_dir_2.py,423,282,315,14,82,58,109,96,167,574.6222332874894,9.304878048780488,10232.469595175493,568.4705330653052,1099.6887376204331,51,35.591642336837786
ray_2.0.0,python/ray/tests/test_dataclient_disconnect.py,91,42,48,2,14,9,16,16,25,55.30296890880645,1.1428571428571428,114.28571428571428,6.349206349206349,100.0,13,77.99461791557792
ray_2.0.0,python/ray/tests/test_reconstruction.py,719,479,550,7,51,67,120,58,187,308.9451768949495,8.235294117647058,9021.290732496458,501.1828184720255,1095.4424460888558,47,30.879421623107856
ray_2.0.0,python/ray/tests/test_list_actors_4.py,62,22,45,2,7,5,7,9,12,21.651484454403228,1.0,38.03910001730775,2.1132833342948754,38.03910001730775,7,67.59897854894437
ray_2.0.0,python/ray/tests/test_output.py,657,239,511,13,93,59,116,106,175,656.2474857688812,8.10752688172043,9545.689290103377,530.3160716724099,1177.3860795485598,67,27.767157064232375
ray_2.0.0,python/ray/tests/test_client.py,847,536,571,16,198,113,222,214,335,1574.6126107757627,8.969696969696969,23261.93534459205,1292.3297413662249,2593.391440444384,99,23.090296787935245
ray_2.0.0,python/ray/tests/test_joblib.py,201,112,159,11,35,24,39,46,63,217.5786533980841,6.128571428571429,2132.647271233613,118.48040395742295,347.98440323159184,17,49.73552507696639
ray_2.0.0,python/ray/tests/test_placement_group_4.py,451,268,312,4,50,26,52,54,78,290.1928094887362,2.08,933.6729483510012,51.8707193528334,448.8812251687506,35,45.3218724245848
ray_2.0.0,python/ray/tests/test_args.py,90,65,69,1,14,7,14,15,21,53.30296890880645,0.5,41.02235125388945,2.279019514104969,82.0447025077789,3,53.865878698848285
ray_2.0.0,python/ray/tests/test_object_spilling_2.py,419,227,324,7,58,46,91,65,137,359.41438217180234,5.491379310344827,4530.741523061898,251.70786239232768,825.0643903848983,27,44.00955084684031
ray_2.0.0,python/ray/tests/test_multi_node_2.py,373,242,276,8,66,39,76,74,115,422.93001187765793,4.606060606060606,3289.1286312483053,182.72936840268363,714.0871370473294,59,36.54738486845214
ray_2.0.0,python/ray/tests/test_failure_4.py,617,383,442,10,77,55,107,87,162,515.7618445823811,6.9480519480519485,7252.076789418303,402.8931549676835,1043.756846327494,61,37.273497899716176
ray_2.0.0,python/ray/tests/test_distributed_sort.py,29,13,23,1,2,1,2,3,3,2.0,0.5,2.3774437510817346,0.1320802083934297,4.754887502163469,3,70.55562609205698
ray_2.0.0,python/ray/tests/test_placement_group_3.py,692,395,483,6,52,32,64,58,96,311.9326403476637,3.6923076923076925,2076.4289558113733,115.35716421174295,562.3661755322469,50,38.68595969083028
ray_2.0.0,python/ray/tests/test_k8s_operator_unit_tests.py,251,138,173,3,23,12,24,26,36,108.79681249147477,1.565217391304348,264.8595597700372,14.71441998722429,169.21582985307933,18,59.21990884335923
ray_2.0.0,python/ray/tests/test_gcs_fault_tolerance.py,650,326,467,8,65,39,74,73,113,415.4539078468495,4.553846153846154,3185.18848992952,176.95491610719557,699.4501751534419,35,39.48965690901525
ray_2.0.0,python/ray/tests/test_numba.py,42,28,28,3,8,4,8,11,12,28.75488750216347,1.5,62.26976913547136,3.4594316186372978,41.51317942364757,7,67.31916654969957
ray_2.0.0,python/ray/tests/test_iter.py,568,366,394,12,236,127,251,248,378,1903.3233096580486,6.38135593220339,19186.734852632693,1065.9297140351496,3006.686205326239,99,25.42612496961228
ray_2.0.0,python/ray/tests/test_gcs_pubsub.py,211,122,153,3,35,19,36,38,55,184.27979309523727,1.542857142857143,445.3241347122128,24.740229706234047,288.6360132393972,21,42.80160582444115
ray_2.0.0,python/ray/tests/test_list_actors_3.py,58,28,39,3,10,6,10,13,16,37.974168451037094,1.5,88.81055323538621,4.933919624188123,59.207035490257475,7,64.60471198924311
ray_2.0.0,python/ray/tests/test_ray_debugger.py,350,187,264,7,32,21,40,39,61,179.65148445440323,4.375,1410.5417171588626,78.36342873104792,322.4095353505972,18,45.88673378347264
ray_2.0.0,python/ray/tests/test_list_actors_2.py,28,21,20,3,6,4,6,9,10,20.264662506490406,1.5,47.548875021634686,2.6416041678685938,31.699250014423125,5,73.0424132108816
ray_2.0.0,python/ray/tests/test_global_state.py,411,275,299,11,100,61,116,111,177,702.4393667824828,6.38,7672.6620612345205,426.2590034019178,1202.6116083439688,48,35.25493000679247
ray_2.0.0,python/ray/tests/test_runtime_env_strong_type.py,70,52,54,3,16,9,18,19,27,68.75488750216347,1.6875,193.54619733127336,10.752566518404075,114.6940428629768,11,54.80273593107021
ray_2.0.0,python/ray/tests/test_ray_init.py,454,252,328,9,82,55,101,91,156,549.8485893916638,5.5426829268292686,5627.020189992292,312.61223277734956,1015.2159638709966,59,38.74928856724346
ray_2.0.0,python/ray/tests/test_runtime_env_conda_and_pip_5.py,111,51,82,2,12,6,12,14,18,45.01955000865388,1.0,68.53238859703687,3.8073549220576037,68.53238859703687,10,62.867744944722936
ray_2.0.0,python/ray/tests/test_monitor.py,58,23,46,2,12,6,12,14,18,45.01955000865388,1.0,68.53238859703687,3.8073549220576037,68.53238859703687,7,73.2738416554869
ray_2.0.0,python/ray/tests/test_runtime_env_conda_and_pip_2.py,76,54,60,4,7,4,7,11,11,27.651484454403228,2.0,76.10749561002055,4.228194200556697,38.053747805010275,8,63.13577452849041
ray_2.0.0,python/ray/tests/test_reference_counting.py,605,385,394,9,86,60,115,95,175,581.1880939173612,6.017441860465116,6918.401727086877,384.3556515048265,1149.7247314579158,33,42.27002692815836
ray_2.0.0,python/ray/tests/test_reference_counting_2.py,755,500,537,12,108,85,161,120,246,772.5474002423086,8.944444444444445,15197.461607203944,844.3034226224413,1699.0950865196955,31,34.11251008528899
ray_2.0.0,python/ray/tests/test_placement_group_2.py,823,399,579,11,106,74,145,117,219,751.2133159887094,7.523584905660377,11320.060133840005,628.892229657778,1504.6098735887656,67,34.425472793983424
ray_2.0.0,python/ray/tests/test_client_builder.py,426,215,285,5,47,28,55,52,83,272.6753165032857,2.925531914893617,1384.1759209209622,76.89866227338679,473.1364966057107,49,49.642559741966615
ray_2.0.0,python/ray/tests/test_placement_group.py,521,290,381,7,54,30,59,61,89,330.41540957123055,3.824074074074074,2018.4825214518428,112.13791785843571,527.8356230430969,46,40.979769603657935
ray_2.0.0,python/ray/tests/pydantic_module.py,26,16,15,0,0,0,0,0,0,0,0,0,0.0,0,1,100.0
ray_2.0.0,python/ray/tests/test_actor_lifetime.py,90,63,68,5,16,10,19,21,29,75.60964047443682,2.96875,378.15107811735896,21.008393228742165,127.37720526058406,10,56.99221046686413
ray_2.0.0,python/ray/tests/test_runtime_env_validation.py,384,252,285,6,61,42,78,67,120,377.284752595663,3.8360655737704916,2792.3899093123646,155.1327727395758,727.9307028549326,74,31.408010902845994
ray_2.0.0,python/ray/tests/test_actor_advanced.py,1392,853,968,15,182,116,216,197,332,1425.0219834502905,8.901098901098901,22524.419508661635,1251.3566393700908,2530.521204059517,99,19.821323416299915
ray_2.0.0,python/ray/tests/test_object_assign_owner.py,164,110,120,3,10,5,10,13,15,37.974168451037094,1.5,83.25989365817458,4.625549647676365,55.506595772116384,10,60.341480523760424
ray_2.0.0,python/ray/tests/test_component_failures_3.py,125,66,77,6,17,11,20,23,31,84.99664330558272,3.5294117647058822,494.93089636859077,27.496160909366154,140.2304206377674,18,67.91178885826152
ray_2.0.0,python/ray/tests/test_advanced_3.py,355,239,249,11,98,61,118,109,179,686.2953125283008,6.622448979591836,8023.130012180207,445.7294451211226,1211.5049941350699,54,35.81729654455313
ray_2.0.0,python/ray/tests/test_client_compat.py,40,22,28,1,2,1,2,3,3,2.0,0.5,2.3774437510817346,0.1320802083934297,4.754887502163469,4,86.06664408455781
ray_2.0.0,python/ray/tests/test_runtime_context.py,309,207,232,8,86,53,104,94,157,576.6587689043804,4.837209302325581,4977.829152101975,276.54606400566524,1029.070449713389,40,37.708983850703135
ray_2.0.0,python/ray/tests/test_out_of_disk_space.py,221,142,173,6,68,58,116,74,174,429.45724820935004,5.117647058823529,5529.335591111238,307.18531061729095,1080.4448856194374,17,45.77669259420264
ray_2.0.0,python/ray/tests/test_microbenchmarks.py,112,89,88,5,17,13,26,22,39,81.0965087756926,3.823529411764706,664.9799501909147,36.943330566161926,173.9178331268546,10,59.24728154165566
ray_2.0.0,python/ray/tests/test_client_references.py,335,210,231,6,82,56,106,88,162,536.8290393830099,3.8780487804878048,4058.0985276307206,225.4499182017067,1046.4279222192424,59,38.04798225080403
ray_2.0.0,python/ray/tests/test_queue.py,282,195,195,8,52,34,63,60,97,320.4228653433368,4.846153846153846,2776.6929561356656,154.26071978531476,572.9683877740263,31,36.08787651719314
ray_2.0.0,python/ray/tests/test_multi_node_3.py,580,196,409,8,34,27,48,42,75,196.97373660251156,5.647058823529412,2283.8050261180633,126.87805700655908,404.423806708407,28,50.200048620355666
ray_2.0.0,python/ray/tests/test_get_locations.py,139,105,104,5,46,27,54,51,81,265.6934904530594,2.9347826086956523,1348.4341546621372,74.91300859234096,459.46645269969116,21,48.40331453935079
ray_2.0.0,python/ray/tests/test_coordinator_server.py,299,169,246,6,51,39,63,57,102,304.8034674448732,3.7058823529411766,2204.832425354273,122.4906902974596,594.9547814448038,59,40.678600740520295
ray_2.0.0,python/ray/tests/test_object_manager.py,737,386,493,14,140,100,201,154,301,1051.4025912811016,10.05,21982.392624929114,1221.2440347182842,2187.3027487491654,61,36.737791788879036
ray_2.0.0,python/ray/tests/test_get_or_create_actor.py,106,53,77,4,21,12,24,25,36,100.23866587835397,2.2857142857142856,382.1230236157487,21.229056867541594,167.17882283189007,14,54.520937666322816
ray_2.0.0,python/ray/tests/test_runtime_env_packaging.py,481,290,358,12,108,79,144,120,223,772.5474002423086,8.0,12321.892822565598,684.5496012536444,1540.2366028206998,67,31.931490551510915
ray_2.0.0,python/ray/tests/test_multinode_failures_2.py,134,72,93,7,19,12,21,26,33,100.36210720983135,3.8684210526315788,600.0482387553274,33.33601326418486,155.11451069865606,16,67.39443166466108
ray_2.0.0,python/ray/tests/test_state_api_log.py,733,391,547,11,156,111,218,167,329,1174.5764939475212,7.685897435897436,18670.87958946495,1037.2710883036082,2429.2387122239634,41,34.42359907915922
ray_2.0.0,python/ray/tests/test_storage.py,175,129,131,4,35,21,40,39,61,187.5249055930738,2.2857142857142856,736.9360808013649,40.940893377853605,322.4095353505972,33,48.47771159246754
ray_2.0.0,python/ray/tests/test_resource_demand_scheduler.py,2815,1366,2415,14,576,379,738,590,1117,5335.179769739579,8.96875,92212.2566516333,5122.903147312962,10281.505968126361,299,0.0
ray_2.0.0,python/ray/tests/test_namespace.py,275,125,177,1,15,8,16,16,24,58.60335893412778,0.5333333333333333,51.2,2.8444444444444446,96.0,18,58.164557291856696
ray_2.0.0,python/ray/tests/test_failure_2.py,424,246,293,10,54,33,64,64,97,343.983206065701,5.925925925925926,3448.8888888888887,191.60493827160494,582.0,24,47.96920251115753
ray_2.0.0,python/ray/tests/test_autoscaler_fake_scaledown.py,193,105,142,7,30,22,44,37,66,166.8582023226588,5.133333333333334,1764.9628002750883,98.05348890417157,343.8239221315107,14,54.503879084629276
ray_2.0.0,python/ray/tests/test_failure_3.py,361,216,252,8,29,20,36,37,56,164.8814488586996,4.9655172413793105,1448.5873082907535,80.47707268281964,291.7293884752212,18,50.247639381692956
ray_2.0.0,python/ray/tests/test_component_failures_2.py,149,85,110,6,30,20,37,36,57,162.7164928725825,3.7,1090.3371828041836,60.574287933565756,294.6857250822118,17,56.152133000127165
ray_2.0.0,python/ray/tests/test_metrics.py,163,96,129,4,42,23,51,46,74,234.47733175670794,2.4285714285714284,992.6629915313888,55.14794397396604,408.74358474821895,21,53.52498421554485
ray_2.0.0,python/ray/tests/test_usage_stats.py,1307,733,1006,12,225,161,317,237,478,1801.1203180324871,8.453333333333333,31875.992254201537,1770.888458566752,3770.8192729733682,150,12.042136654665844
ray_2.0.0,python/ray/tests/test_runtime_env_plugin.py,626,276,492,9,56,35,69,65,104,353.74120064820664,5.544642857142857,3472.755382469908,192.93085458166155,626.3262525549593,31,39.108085695326935
ray_2.0.0,python/ray/tests/test_asyncio.py,357,242,243,9,54,31,60,63,91,339.29325012980814,5.0,2719.662365192462,151.09235362180345,543.9324730384924,22,44.513970177056045
ray_2.0.0,python/ray/tests/test_ray_shutdown.py,164,97,113,6,27,15,31,33,46,143.89173756274062,3.4444444444444446,799.2562238005728,44.403123544476266,232.04212949048886,14,55.117561131133876
ray_2.0.0,python/ray/tests/test_runtime_env_conda_and_pip_3.py,233,118,172,4,15,11,15,19,26,66.60335893412778,2.0,220.89223069906643,12.271790594392579,110.44611534953322,23,56.772814655887416
ray_2.0.0,python/ray/tests/test_kill_raylet_signal_log.py,56,39,39,4,9,5,9,13,14,36.52932501298081,2.0,103.61231210795059,5.75623956155281,51.80615605397529,6,62.006102421515386
ray_2.0.0,python/ray/tests/test_mini.py,72,42,41,1,13,7,14,14,21,48.105716335834195,0.5384615384615384,43.05239796480521,2.3917998869336228,79.95445336320968,12,70.47807950704446
ray_2.0.0,python/ray/tests/test_tracing.py,234,144,151,3,24,12,24,27,36,114.79398751947123,1.5,256.76392511682735,14.264662506490408,171.1759500778849,22,53.92797520719346
ray_2.0.0,python/ray/tests/test_cancel.py,315,220,228,5,21,11,22,26,33,103.84830635279079,2.619047619047619,406.25228992505157,22.569571662502867,155.11451069865606,34,40.056587290083954
ray_2.0.0,python/ray/tests/test_client_terminate.py,148,91,99,1,7,4,8,8,12,19.651484454403228,0.5714285714285714,20.57142857142857,1.1428571428571428,36.0,8,65.24166705705049
ray_2.0.0,python/ray/tests/test_advanced_7.py,272,176,198,7,56,31,59,63,90,344.86336008962905,3.6875,1983.709774611535,110.20609858952973,537.9551931149925,12,49.257135567988925
ray_2.0.0,python/ray/tests/test_runtime_env.py,854,593,639,15,225,137,276,240,413,1816.704126957961,9.2,30043.021507074125,1669.056750393007,3265.5458159863183,148,12.088189407329867
ray_2.0.0,python/ray/tests/test_logging.py,720,389,531,11,115,78,146,126,224,825.2851036636135,6.982608695652174,10913.193864345889,606.288548019216,1562.9107028639814,84,30.800377851484775
ray_2.0.0,python/ray/tests/kuberay/utils.py,568,220,370,8,58,34,64,66,98,363.76289771739914,4.413793103448276,2614.51309769767,145.25072764987056,592.3506236971284,37,51.321724395963074
ray_2.0.0,python/ray/tests/kuberay/test_autoscaling_e2e.py,406,147,265,4,24,14,27,28,41,118.03910001730776,2.25,443.47849155981396,24.63769397554522,197.10155180436175,22,61.53527138691919
ray_2.0.0,python/ray/tests/kuberay/test_autoscaling_config.py,341,121,268,11,40,21,42,51,63,250.93087160050476,5.775,2063.7701500427797,114.65389722459888,357.36279654420423,17,51.69673737804639
ray_2.0.0,python/ray/tests/kuberay/setup/teardown_kuberay.py,5,4,4,1,2,1,2,3,3,2.0,0.5,2.3774437510817346,0.1320802083934297,4.754887502163469,2,81.85633424453339
ray_2.0.0,python/ray/tests/kuberay/setup/setup_kuberay.py,10,5,9,1,2,1,2,3,3,2.0,0.5,2.3774437510817346,0.1320802083934297,4.754887502163469,2,79.7423427057672
ray_2.0.0,python/ray/tests/kuberay/scripts/scale_up.py,21,9,10,1,2,1,2,3,3,2.0,0.5,2.3774437510817346,0.1320802083934297,4.754887502163469,2,100.0
ray_2.0.0,python/ray/tests/kuberay/scripts/non_terminated_nodes_count.py,26,16,17,1,2,1,2,3,3,2.0,0.5,2.3774437510817346,0.1320802083934297,4.754887502163469,2,91.08024702470524
ray_2.0.0,python/ray/tests/kuberay/scripts/scale_down.py,25,12,11,1,2,1,2,3,3,2.0,0.5,2.3774437510817346,0.1320802083934297,4.754887502163469,2,100.0
ray_2.0.0,python/ray/tests/kuberay/scripts/gpu_actor_placement.py,18,12,11,1,4,2,4,5,6,8.0,0.5,6.965784284662087,0.3869880158145604,13.931568569324174,2,68.17947009983793
ray_2.0.0,python/ray/tests/kuberay/scripts/gpu_actor_validation.py,14,10,9,1,2,1,2,3,3,2.0,0.5,2.3774437510817346,0.1320802083934297,4.754887502163469,2,73.1756852057256
ray_2.0.0,python/ray/tests/kuberay/scripts/scale_up_custom.py,32,13,13,1,6,3,6,7,9,15.509775004326936,0.5,12.63309714925922,0.701838730514401,25.26619429851844,4,93.69752071792936
ray_2.0.0,python/ray/tests/kuberay/scripts/check_cpu_and_memory.py,17,11,10,3,9,5,10,12,15,33.28421251514428,1.6666666666666667,89.62406251802892,4.9791145843349405,53.77443751081735,4,91.13348246715603
ray_2.0.0,python/ray/tests/perf_integration_tests/test_perf_integration.py,104,60,77,3,17,11,22,20,33,74.24175580341925,1.9411764705882353,276.85762913719634,15.380979396510908,142.62362713128297,12,56.14213609504895
ray_2.0.0,python/ray/tests/kubernetes_e2e/test_helm.py,101,78,85,2,5,3,6,7,9,13.60964047443681,1.2,30.319433158222125,1.6844129532345624,25.26619429851844,11,60.13082657164681
ray_2.0.0,python/ray/tests/kubernetes_e2e/test_k8s_operator_basic.py,410,244,305,6,43,25,49,49,74,248.83915945651714,3.4186046511627906,1420.39101591361,78.91061199520055,415.4885284645254,32,44.8116323581214
ray_2.0.0,python/ray/tests/kubernetes_e2e/test_k8s_operator_scaling.py,185,108,126,5,14,8,15,19,23,64.91260938324326,2.6785714285714284,261.7026771675066,14.539037620417032,97.70233280920246,13,63.27692898652302
ray_2.0.0,python/ray/tests/modin/test_modin.py,421,191,309,16,71,55,107,87,162,500.6320454848324,12.056338028169014,12583.885358539928,699.1047421411072,1043.756846327494,37,43.12734687315958
ray_2.0.0,python/ray/tests/modin/modin_test_utils.py,147,65,102,5,55,35,72,60,107,329.58442471829306,3.272727272727273,2068.4856885712743,114.91587158729301,632.0372937301115,60,58.89493549040111
ray_2.0.0,python/ray/tests/typing_files/check_typing_bad.py,33,19,19,1,8,4,8,9,12,24.0,0.5,19.019550008653876,1.0566416671474377,38.03910001730775,1,86.45560290346569
ray_2.0.0,python/ray/tests/typing_files/check_typing_good.py,32,16,16,1,6,3,6,7,9,15.509775004326936,0.5,12.63309714925922,0.701838730514401,25.26619429851844,1,88.93594005766512
ray_2.0.0,python/ray/tests/xgboost/simple_example.py,44,16,27,2,3,2,3,5,5,6.754887502163469,1.0,11.60964047443681,0.6449800263576005,11.60964047443681,2,90.23958593663343
ray_2.0.0,python/ray/tests/xgboost/simple_tune.py,97,33,54,4,8,4,8,12,12,32.0,2.0,86.03910001730776,4.779950000961542,43.01955000865388,2,83.01530268372537
ray_2.0.0,python/ray/tests/ludwig/test_ludwig.py,166,82,116,4,14,11,16,18,27,61.30296890880645,2.2857142857142856,257.34394294615413,14.296885719230785,112.58797503894243,13,65.08647728964833
ray_2.0.0,python/ray/tests/ludwig/ludwig_test_utils.py,632,275,453,8,55,36,71,63,107,341.9747842438563,5.163636363636364,3302.5014966421,183.47230536900554,639.5689518144911,33,44.75276917521881
ray_2.0.0,python/ray/tests/gcp/test_gcp_node_provider.py,86,46,70,1,8,4,8,9,12,24.0,0.5,19.019550008653876,1.0566416671474377,38.03910001730775,5,51.99135296399757
ray_2.0.0,python/ray/tests/horovod/test_horovod.py,97,67,70,4,11,6,11,15,17,46.053747805010275,2.0,132.83428025068963,7.379682236149424,66.41714012534482,8,61.70794315779824
ray_2.0.0,python/ray/tests/horovod/horovod_example.py,242,95,201,9,21,13,24,30,37,120.76799089133479,5.142857142857143,933.7111819072211,51.87284343929006,181.5549520375152,22,53.28612038410503
ray_2.0.0,python/ray/tests/aws/test_aws_batch_tag_update.py,70,45,47,4,10,5,10,14,15,41.219280948873624,2.0,114.22064766172811,6.345591536762672,57.110323830864054,9,71.39424909671443
ray_2.0.0,python/ray/tests/aws/conftest.py,40,30,30,0,0,0,0,0,0,0,0,0,0.0,0,1,100.0
ray_2.0.0,python/ray/tests/aws/test_autoscaler_aws.py,800,337,487,7,67,36,70,74,106,426.07946021507394,3.656716417910448,2406.858267244535,133.71434818025193,658.2020567566688,55,45.47113112288739
ray_2.0.0,python/ray/tests/aws/utils/helpers.py,102,50,62,1,2,1,2,3,3,2.0,0.5,2.3774437510817346,0.1320802083934297,4.754887502163469,4,85.25932160852412
ray_2.0.0,python/ray/tests/aws/utils/constants.py,228,58,177,3,18,15,26,21,41,79.81353752812508,2.1666666666666665,390.18419772351325,21.676899873528512,180.0850143339292,3,65.8736633279866
ray_2.0.0,python/ray/tests/aws/utils/stubs.py,237,82,181,1,2,1,2,3,3,2.0,0.5,2.3774437510817346,0.1320802083934297,4.754887502163469,2,66.92641495519938
ray_2.0.0,python/ray/tests/aws/utils/mocks.py,7,5,5,1,2,1,2,3,3,2.0,0.5,2.3774437510817346,0.1320802083934297,4.754887502163469,1,79.87684562974381
ray_2.0.0,python/ray/tests/ray_lightning/simple_example.py,83,42,67,3,4,4,7,7,11,12.75488750216347,2.625,81.06237337441333,4.503465187467407,30.880904142633646,6,65.76625328709066
ray_2.0.0,python/ray/tests/ray_lightning/simple_tune.py,82,48,63,3,4,4,7,7,11,12.75488750216347,2.625,81.06237337441333,4.503465187467407,30.880904142633646,6,62.63910719343516
ray_2.0.0,python/ray/tests/lightgbm/simple_example.py,47,16,30,2,3,2,3,5,5,6.754887502163469,1.0,11.60964047443681,0.6449800263576005,11.60964047443681,2,89.38918375182438
ray_2.0.0,python/ray/tests/lightgbm/simple_tune.py,92,31,49,3,6,3,6,9,9,20.264662506490406,1.5,42.793987519471216,2.377443751081734,28.529325012980813,2,85.36090483875047
ray_2.0.0,python/ray/widgets/render.py,38,19,16,2,10,5,10,12,15,35.219280948873624,1.0,53.77443751081735,2.987468750600964,53.77443751081735,6,87.69214347137377
ray_2.0.0,python/ray/widgets/__init__.py,3,2,2,0,0,0,0,0,0,0,0,0,0.0,0,1,100.0
ray_2.0.0,python/ray/core/__init__.py,0,0,0,0,0,0,0,0,0,0,0,0,0.0,0,1,100.0
ray_2.0.0,python/ray/core/src/__init__.py,0,0,0,0,0,0,0,0,0,0,0,0,0.0,0,1,100.0
ray_2.0.0,python/ray/core/src/plasma/__init__.py,0,0,0,0,0,0,0,0,0,0,0,0,0.0,0,1,100.0
ray_2.0.0,python/ray/core/src/ray/__init__.py,0,0,0,0,0,0,0,0,0,0,0,0,0.0,0,1,100.0
ray_2.0.0,python/ray/core/src/ray/raylet/__init__.py,0,0,0,0,0,0,0,0,0,0,0,0,0.0,0,1,100.0
ray_2.0.0,python/ray/core/generated/__init__.py,0,0,0,0,0,0,0,0,0,0,0,0,0.0,0,1,100.0
ray_2.0.0,python/ray/runtime_env/runtime_env.py,501,223,297,12,78,52,89,90,141,533.2809230799093,6.846153846153846,6266.635731218545,348.14642951214137,915.3512865824841,95,43.82070814309239
ray_2.0.0,python/ray/runtime_env/__init__.py,6,2,5,0,0,0,0,0,0,0,0,0,0.0,0,1,100.0
ray_2.0.0,python/ray/runtime_env/types/pip.py,8,8,6,0,0,0,0,0,0,0,0,0,0.0,0,1,100.0
ray_2.0.0,python/ray/dag/class_node.py,263,104,205,4,16,9,18,20,27,72.0,2.25,262.55713176440725,14.586507320244847,116.69205856195879,33,57.35468658608978
ray_2.0.0,python/ray/dag/vis_utils.py,115,66,67,5,11,6,11,16,17,49.663388279447084,2.5,170.0,9.444444444444445,68.0,11,73.39641481412704
ray_2.0.0,python/ray/dag/utils.py,58,35,42,5,10,6,12,15,18,44.82892142331043,3.0,210.97209216286,11.720671786825555,70.32403072095333,15,71.99632734101974
ray_2.0.0,python/ray/dag/dag_node.py,300,123,163,6,29,19,36,35,55,156.39122386302654,3.7241379310344827,1050.6186593328655,58.36770329627031,282.11056593197316,41,60.853986492596725
ray_2.0.0,python/ray/dag/format_utils.py,155,106,126,5,52,33,63,57,96,308.0325058177736,3.0288461538461537,1696.0249425802094,94.22360792112275,559.9574413598152,35,47.24735710866439
ray_2.0.0,python/ray/dag/function_node.py,90,30,71,1,2,1,2,3,3,2.0,0.5,2.3774437510817346,0.1320802083934297,4.754887502163469,9,80.56310177229564
ray_2.0.0,python/ray/dag/constants.py,6,3,3,0,0,0,0,0,0,0,0,0,0.0,0,1,100.0
ray_2.0.0,python/ray/dag/__init__.py,28,7,27,0,0,0,0,0,0,0,0,0,0.0,0,1,100.0
ray_2.0.0,python/ray/dag/py_obj_scanner.py,115,66,59,5,13,7,14,18,21,59.715356810271004,2.6923076923076925,235.76114431231534,13.097841350684185,87.56842503028855,16,73.78938092615458
ray_2.0.0,python/ray/dag/base.py,8,5,3,0,0,0,0,0,0,0,0,0,0.0,0,1,100.0
ray_2.0.0,python/ray/dag/conftest.py,16,9,9,1,2,1,2,3,3,2.0,0.5,2.3774437510817346,0.1320802083934297,4.754887502163469,2,100.0
ray_2.0.0,python/ray/dag/input_node.py,280,103,147,6,21,13,25,27,38,107.74844088268091,3.5714285714285716,645.3061610078994,35.85034227821663,180.68572508221183,39,64.28028236774487
ray_2.0.0,python/ray/dag/tests/test_input_node.py,355,222,246,4,59,38,75,63,113,355.07593991234864,2.542372881355932,1717.2016051410776,95.40008917450432,675.4326313554906,18,46.70390516170841
ray_2.0.0,python/ray/dag/tests/test_py_obj_scanner.py,66,54,44,2,17,9,18,19,27,71.48686830125578,1.0588235294117647,121.44075126668132,6.746708403704518,114.6940428629768,11,46.309160466606286
ray_2.0.0,python/ray/dag/tests/conftest.py,2,1,1,0,0,0,0,0,0,0,0,0,0.0,0,1,100.0
ray_2.0.0,python/ray/dag/tests/test_plot.py,66,53,53,2,16,13,26,18,39,66.0,1.625,264.2689969664065,14.68161094257814,162.62707505625016,16,44.75185998747841
ray_2.0.0,python/ray/dag/tests/test_class_dag.py,286,177,214,4,59,33,65,63,98,355.07593991234864,2.2033898305084745,1290.6872241591343,71.70484578661858,585.7734325029918,32,42.527016481109875
ray_2.0.0,python/ray/dag/tests/test_function_dag.py,215,162,157,4,69,40,79,73,119,429.48818751769375,2.289855072463768,1686.6823384936536,93.70457436075853,736.5891225067221,32,37.98878252506954
ray_2.0.0,python/ray/train/predictor.py,203,72,79,1,1,1,1,2,2,0.0,0.5,1.0,0.05555555555555555,2.0,14,82.34052156651373
ray_2.0.0,python/ray/train/train_loop_utils.py,258,71,79,2,16,9,17,18,26,66.0,1.0625,115.19417816484386,6.399676564713548,108.41805003750011,13,59.57379412380283
ray_2.0.0,python/ray/train/gbdt_trainer.py,307,146,223,11,33,20,34,44,54,204.51875374383923,5.666666666666667,1670.586075303013,92.81033751683407,294.80930740641406,37,52.14550795459768
ray_2.0.0,python/ray/train/data_parallel_trainer.py,401,89,177,9,17,10,18,26,28,98.0161933142366,4.764705882352941,627.0939576908235,34.83855320504575,131.6123121079506,21,68.02793059103537
ray_2.0.0,python/ray/train/constants.py,81,29,37,0,0,0,0,0,0,0,0,0,0.0,0,2,100.0
ray_2.0.0,python/ray/train/error.py,6,4,3,0,0,0,0,0,0,0,0,0,0.0,0,1,100.0
ray_2.0.0,python/ray/train/__init__.py,34,9,31,0,0,0,0,0,0,0,0,0,0.0,0,1,100.0
ray_2.0.0,python/ray/train/base_trainer.py,478,174,220,5,27,19,30,32,49,139.9916030328505,2.7777777777777777,680.5555555555555,37.80864197530864,245.0,36,58.37956955728673
ray_2.0.0,python/ray/train/trainer.py,918,306,513,11,54,33,60,65,93,348.81767292183764,6.111111111111111,3422.7123737378383,190.1506874298799,560.0802066116463,79,45.036300431301484
ray_2.0.0,python/ray/train/batch_predictor.py,328,98,166,5,17,12,24,22,36,81.0965087756926,3.5294117647058822,566.6101350739154,31.478340837439745,160.5395382709427,21,66.91951742297032
ray_2.0.0,python/ray/train/session.py,80,47,58,2,3,2,3,5,5,6.754887502163469,1.0,11.60964047443681,0.6449800263576005,11.60964047443681,17,73.05942139905213
ray_2.0.0,python/ray/train/backend.py,62,32,25,0,0,0,0,0,0,0,0,0,0.0,0,6,100.0
ray_2.0.0,python/ray/train/checkpoint.py,20,11,15,0,0,0,0,0,0,0,0,0,0.0,0,2,100.0
ray_2.0.0,python/ray/train/rl/rl_trainer.py,248,95,137,4,14,9,15,18,24,61.30296890880645,2.142857142857143,214.45328578846176,11.91407143269232,100.07820003461549,20,69.1848815925018
ray_2.0.0,python/ray/train/rl/__init__.py,5,4,4,0,0,0,0,0,0,0,0,0,0.0,0,1,100.0
ray_2.0.0,python/ray/train/rl/rl_predictor.py,83,42,53,2,4,2,4,6,6,10.0,1.0,15.509775004326936,0.861654166907052,15.509775004326936,9,81.13294080289992
ray_2.0.0,python/ray/train/rl/rl_checkpoint.py,74,35,46,2,6,5,6,8,11,17.509775004326936,1.0,33.0,1.8333333333333333,33.0,8,80.0925296122433
ray_2.0.0,python/ray/train/tests/test_batch_predictor.py,302,150,235,6,60,36,72,66,108,369.92321074083804,3.6,2350.0604336065667,130.5589129781426,652.794564890713,43,38.57261543625816
ray_2.0.0,python/ray/train/tests/test_rl_trainer.py,107,43,80,4,11,7,12,15,19,46.053747805010275,2.1818181818181817,161.9583737815895,8.997687432310528,74.23092131656186,10,65.64087782773733
ray_2.0.0,python/ray/train/tests/test_lightgbm_predictor.py,152,97,104,3,23,13,26,26,39,108.79681249147477,1.6956521739130435,310.84212223011315,17.269006790561843,183.31714900750262,18,44.29286199385098
ray_2.0.0,python/ray/train/tests/test_trainer.py,1310,873,907,13,209,124,244,222,368,1658.9437749407386,7.588516746411483,21766.48436154788,1209.2491311971044,2868.345038816839,118,10.161361499491388
ray_2.0.0,python/ray/train/tests/test_worker_group.py,129,94,87,3,34,21,39,37,60,177.72862410467502,1.7205882352941178,537.7994503928711,29.877747244048393,312.567201937737,20,49.36659303649466
ray_2.0.0,python/ray/train/tests/test_examples.py,204,127,151,5,49,31,55,54,86,286.73042283608197,2.806122448979592,1388.8070349608781,77.15594638671546,494.92032518605834,28,41.149599411050275
ray_2.0.0,python/ray/train/tests/test_huggingface_trainer.py,140,81,113,2,22,13,26,24,39,100.10749561002054,1.1818181818181819,211.32508980596606,11.740282766998114,178.81353752812512,16,51.557543244414944
ray_2.0.0,python/ray/train/tests/test_minimal.py,131,83,89,1,13,8,16,14,24,48.105716335834195,0.6153846153846154,56.23170346423538,3.1239835257908544,91.37651812938249,14,59.543188759639584
ray_2.0.0,python/ray/train/tests/test_checkpoints.py,40,21,31,2,4,2,4,6,6,10.0,1.0,15.509775004326936,0.861654166907052,15.509775004326936,4,62.282508808070276
ray_2.0.0,python/ray/train/tests/test_callbacks.py,359,235,278,11,78,50,98,89,148,528.3151208762656,6.910256410256411,6622.8488109621985,367.9360450534555,958.4085477830268,53,30.339617681281766
ray_2.0.0,python/ray/train/tests/test_torch_utils.py,101,63,77,3,33,17,34,36,51,171.21989344099242,1.5454545454545454,407.484088750044,22.638004930558,263.6661750735579,36,45.79544273328431
ray_2.0.0,python/ray/train/tests/test_base_trainer.py,367,219,269,5,47,30,55,52,85,272.6753165032857,2.925531914893617,1417.5295575696603,78.75164208720335,484.5373760419929,21,42.973703399989965
ray_2.0.0,python/ray/train/tests/test_data_parallel_trainer.py,201,123,144,4,30,15,30,34,45,155.20671786825557,2.0,457.8716557125306,25.4373142062517,228.9358278562653,12,49.17245709562689
ray_2.0.0,python/ray/train/tests/conftest.py,2,1,1,0,0,0,0,0,0,0,0,0,0.0,0,1,100.0
ray_2.0.0,python/ray/train/tests/test_tune.py,311,180,244,6,40,26,50,46,76,228.38689879982144,3.75,1574.2151574762488,87.45639763756938,419.790708660333,21,38.94701019428662
ray_2.0.0,python/ray/train/tests/test_session.py,317,205,228,6,56,33,59,62,92,340.72165063955276,3.1607142857142856,1731.3952271132123,96.1886237285118,547.7860605555926,28,37.013933923226844
ray_2.0.0,python/ray/train/tests/test_sklearn_trainer.py,202,111,160,3,20,11,22,23,33,91.19344939991072,1.65,246.30794850730436,13.683774917072464,149.27754454988144,15,46.3288808330327
ray_2.0.0,python/ray/train/tests/test_results_preprocessors.py,217,141,157,4,40,22,44,44,66,220.8771237954945,2.2,792.7094710261356,44.03941505700753,360.3224868300616,37,44.15677374470758
ray_2.0.0,python/ray/train/tests/test_rl_predictor.py,178,102,125,7,39,25,45,46,70,225.78217099003092,4.038461538461538,1561.468476039194,86.74824866884411,386.6493369239909,20,52.88694260087892
ray_2.0.0,python/ray/train/tests/test_batchpredictor_runtime.py,137,80,89,6,20,15,30,26,45,101.94833690207419,4.5,951.8390429235714,52.879946829087295,211.51978731634918,8,64.599435448786
ray_2.0.0,python/ray/train/tests/test_torch_trainer.py,184,101,134,5,17,9,17,22,26,81.0965087756926,2.5,289.86305521142435,16.103503067301354,115.94522208456974,7,59.034295745157024
ray_2.0.0,python/ray/train/tests/test_tensorflow_utils.py,45,31,28,1,2,1,2,3,3,2.0,0.5,2.3774437510817346,0.1320802083934297,4.754887502163469,2,62.45713888633624
ray_2.0.0,python/ray/train/tests/test_gpu.py,548,316,365,9,48,35,66,57,101,296.6075250475963,6.1875,3645.1917032270785,202.51065017928215,589.1218914306389,32,42.06069506635153
ray_2.0.0,python/ray/train/tests/test_tensorflow_predictor.py,244,149,170,3,48,26,52,51,78,272.833087536779,1.625,718.9799120948871,39.94332844971595,442.4491766737767,30,43.451040010394436
ray_2.0.0,python/ray/train/tests/test_sklearn_predictor.py,204,126,146,3,27,15,30,30,45,133.13685006057713,1.6666666666666667,368.01679467063894,20.445377481702163,220.81007680238335,22,41.832552750456294
ray_2.0.0,python/ray/train/tests/test_backend.py,420,269,306,6,42,23,45,48,68,241.98710676103488,3.2142857142857144,1220.7132323004816,67.81740179447121,379.7774500490387,32,30.58849888172831
ray_2.0.0,python/ray/train/tests/test_huggingface_predictor.py,152,96,109,2,13,8,16,15,24,50.105716335834195,1.2307692307692308,115.40353759335932,6.411307644075517,93.76537429460444,9,56.39789366087628
ray_2.0.0,python/ray/train/tests/test_predictor.py,151,96,103,3,31,16,32,34,48,158.33497312415662,1.5483870967741935,378.11336729808977,21.00629818322721,244.19821638001633,17,49.36385626355678
ray_2.0.0,python/ray/train/tests/test_horovod_trainer.py,111,63,89,3,10,7,12,13,19,37.974168451037094,1.8,126.55503836042534,7.030835464468074,70.30835464468075,4,61.06859999665124
ray_2.0.0,python/ray/train/tests/test_xgboost_trainer.py,218,108,171,1,14,7,14,15,21,53.30296890880645,0.5,41.02235125388945,2.279019514104969,82.0447025077789,12,54.00874805119748
ray_2.0.0,python/ray/train/tests/test_utils.py,24,16,16,1,20,10,20,21,30,86.43856189774725,0.5,65.88476134168141,3.6602645189823004,131.76952268336282,11,57.410865524827926
ray_2.0.0,python/ray/train/tests/test_xgboost_predictor.py,142,91,98,2,21,12,24,23,36,94.23866587835397,1.1428571428571428,186.11226333491712,10.339570185273173,162.84823041805248,17,45.56768732499604
ray_2.0.0,python/ray/train/tests/test_lightgbm_trainer.py,249,126,197,3,27,14,28,30,42,133.13685006057713,1.5555555555555556,320.5835189130899,17.810195495171662,206.0894050155578,14,48.62723540711585
ray_2.0.0,python/ray/train/tests/test_tensorflow_trainer.py,132,74,102,3,11,6,11,14,17,42.808635307173745,1.5,97.08755051246888,5.393752806248271,64.72503367497926,5,54.236332130694024
ray_2.0.0,python/ray/train/tests/test_torch_predictor.py,292,183,198,5,61,33,64,66,97,373.3846180657729,2.622950819672131,1537.8524054498882,85.43624474721601,586.30622957777,41,37.57930494297519
ray_2.0.0,python/ray/train/tests/_huggingface_data.py,7,2,6,0,0,0,0,0,0,0,0,0,0.0,0,1,100.0
ray_2.0.0,python/ray/train/tests/pytorch_pbt_failure.py,79,25,69,3,4,4,5,7,9,12.75488750216347,1.875,47.374114309722074,2.6318952394290043,25.26619429851844,5,73.00227217617312
ray_2.0.0,python/ray/train/tensorflow/train_loop_utils.py,25,8,9,0,0,0,0,0,0,0,0,0,0.0,0,1,100.0
ray_2.0.0,python/ray/train/tensorflow/tensorflow_predictor.py,243,58,100,4,7,4,7,11,11,27.651484454403228,2.0,76.10749561002055,4.228194200556697,38.053747805010275,15,74.23600517359709
ray_2.0.0,python/ray/train/tensorflow/tensorflow_trainer.py,199,16,37,1,1,1,1,2,2,0.0,0.5,1.0,0.05555555555555555,2.0,4,54.07481506081036
ray_2.0.0,python/ray/train/tensorflow/__init__.py,23,10,19,0,0,0,0,0,0,0,0,0,0.0,0,2,100.0
ray_2.0.0,python/ray/train/tensorflow/tensorflow_checkpoint.py,56,22,25,0,0,0,0,0,0,0,0,0,0.0,0,4,100.0
ray_2.0.0,python/ray/train/tensorflow/config.py,58,32,37,0,0,0,0,0,0,0,0,0,0.0,0,4,100.0
ray_2.0.0,python/ray/train/xgboost/__init__.py,5,4,4,0,0,0,0,0,0,0,0,0,0.0,0,1,100.0
ray_2.0.0,python/ray/train/xgboost/xgboost_checkpoint.py,72,29,31,0,0,0,0,0,0,0,0,0,0.0,0,5,100.0
ray_2.0.0,python/ray/train/xgboost/xgboost_trainer.py,92,36,35,1,1,1,1,2,2,0.0,0.5,1.0,0.05555555555555555,2.0,7,85.88635312195402
ray_2.0.0,python/ray/train/xgboost/xgboost_predictor.py,154,51,62,3,6,3,6,9,9,20.264662506490406,1.5,42.793987519471216,2.377443751081734,28.529325012980813,17,77.02088908026033
ray_2.0.0,python/ray/train/horovod/__init__.py,13,7,11,0,0,0,0,0,0,0,0,0,0.0,0,2,100.0
ray_2.0.0,python/ray/train/horovod/config.py,158,87,96,4,7,4,7,11,11,27.651484454403228,2.0,76.10749561002055,4.228194200556697,38.053747805010275,17,70.8931541375876
ray_2.0.0,python/ray/train/horovod/horovod_trainer.py,198,14,35,1,2,1,2,3,3,2.0,0.5,2.3774437510817346,0.1320802083934297,4.754887502163469,4,47.42412939183381
ray_2.0.0,python/ray/train/callbacks/logging.py,337,142,197,6,29,16,30,35,46,156.39122386302654,3.103448275862069,732.2493686259367,40.6805204792187,235.94701877946846,43,59.095150322554574
ray_2.0.0,python/ray/train/callbacks/print.py,74,14,15,0,0,0,0,0,0,0,0,0,0.0,0,3,100.0
ray_2.0.0,python/ray/train/callbacks/__init__.py,17,5,16,0,0,0,0,0,0,0,0,0,0.0,0,1,100.0
ray_2.0.0,python/ray/train/callbacks/callback.py,107,34,40,0,0,0,0,0,0,0,0,0,0.0,0,7,100.0
ray_2.0.0,python/ray/train/callbacks/profile.py,61,33,39,2,4,2,4,6,6,10.0,1.0,15.509775004326936,0.861654166907052,15.509775004326936,8,83.52719196466732
ray_2.0.0,python/ray/train/sklearn/sklearn_predictor.py,147,46,59,2,4,2,4,6,6,10.0,1.0,15.509775004326936,0.861654166907052,15.509775004326936,12,80.13331156276318
ray_2.0.0,python/ray/train/sklearn/__init__.py,9,4,8,0,0,0,0,0,0,0,0,0,0.0,0,1,100.0
ray_2.0.0,python/ray/train/sklearn/sklearn_checkpoint.py,72,28,31,0,0,0,0,0,0,0,0,0,0.0,0,5,100.0
ray_2.0.0,python/ray/train/sklearn/_sklearn_utils.py,26,10,18,0,0,0,0,0,0,0,0,0,0.0,0,6,100.0
ray_2.0.0,python/ray/train/sklearn/sklearn_trainer.py,431,172,270,9,50,35,61,59,96,310.722134501717,5.49,3100.388192735665,172.24378848531472,564.7337327387368,55,52.63011347683194
ray_2.0.0,python/ray/train/examples/mlflow_fashion_mnist_example.py,55,25,46,1,2,1,2,3,3,2.0,0.5,2.3774437510817346,0.1320802083934297,4.754887502163469,3,64.36053324294122
ray_2.0.0,python/ray/train/examples/tune_tensorflow_mnist_example.py,67,30,59,1,2,1,2,3,3,2.0,0.5,2.3774437510817346,0.1320802083934297,4.754887502163469,3,62.633276389103756
ray_2.0.0,python/ray/train/examples/torch_linear_example.py,140,85,105,4,11,6,12,15,18,46.053747805010275,2.1818181818181817,153.43424884571635,8.52412493587313,70.32403072095333,9,55.273405429052325
ray_2.0.0,python/ray/train/examples/tune_cifar_torch_pbt_example.py,197,90,162,6,24,14,28,30,42,125.5488750216347,3.5,721.3129175544523,40.07293986413624,206.0894050155578,9,55.586103860156776
ray_2.0.0,python/ray/train/examples/tensorflow_quick_start.py,91,36,47,3,6,3,6,9,9,20.264662506490406,1.5,42.793987519471216,2.377443751081734,28.529325012980813,2,83.62336099017381
ray_2.0.0,python/ray/train/examples/torch_fashion_mnist_example.py,155,82,116,6,23,14,28,29,42,119.55169999363824,3.652173913043478,745.1720413395685,41.39844674108714,204.03520179535806,8,56.95816512137909
ray_2.0.0,python/ray/train/examples/tensorflow_mnist_example.py,124,53,98,3,6,3,6,9,9,20.264662506490406,1.5,42.793987519471216,2.377443751081734,28.529325012980813,3,66.13643215643214
ray_2.0.0,python/ray/train/examples/__init__.py,0,0,0,0,0,0,0,0,0,0,0,0,0.0,0,1,100.0
ray_2.0.0,python/ray/train/examples/tune_linear_example.py,65,28,57,1,2,1,2,3,3,2.0,0.5,2.3774437510817346,0.1320802083934297,4.754887502163469,3,63.286893066348554
ray_2.0.0,python/ray/train/examples/torch_quick_start.py,95,50,54,1,2,1,2,3,3,2.0,0.5,2.3774437510817346,0.1320802083934297,4.754887502163469,6,83.34322027862028
ray_2.0.0,python/ray/train/examples/mlflow_simple_example.py,52,10,19,0,0,0,0,0,0,0,0,0,0.0,0,2,100.0
ray_2.0.0,python/ray/train/examples/horovod/__init__.py,0,0,0,0,0,0,0,0,0,0,0,0,0.0,0,1,100.0
ray_2.0.0,python/ray/train/examples/horovod/horovod_example.py,286,122,228,9,19,12,22,28,34,109.23994776840894,5.2105263157894735,851.6608772445206,47.31449318025115,163.45006734995852,23,50.715424529587146
ray_2.0.0,python/ray/train/examples/transformers/__init__.py,0,0,0,0,0,0,0,0,0,0,0,0,0.0,0,1,100.0
ray_2.0.0,python/ray/train/examples/transformers/transformers_example.py,632,231,493,16,79,69,130,95,199,561.9986791059912,13.164556962025317,17211.358439242696,956.1865799579276,1307.4012660578587,64,40.55451977678231
ray_2.0.0,python/ray/train/examples/torch_data_prefetch_benchmark/__init__.py,0,0,0,0,0,0,0,0,0,0,0,0,0.0,0,1,100.0
ray_2.0.0,python/ray/train/examples/torch_data_prefetch_benchmark/auto_pipeline_for_host_to_device_data_transfer.py,156,82,116,5,13,7,13,18,20,59.715356810271004,2.5,208.4962500721156,11.583125004006423,83.39850002884624,13,54.026793255241905
ray_2.0.0,python/ray/train/_internal/utils.py,185,93,99,4,8,5,10,12,15,32.0,2.5,134.43609377704337,7.468671876502409,53.77443751081735,18,71.23784023933187
ray_2.0.0,python/ray/train/_internal/worker_group.py,344,130,161,8,26,16,30,34,46,146.2114326716684,4.615384615384615,1080.1074955269953,60.00597197372196,234.02329069751565,37,61.32720733400968
ray_2.0.0,python/ray/train/_internal/backend_executor.py,572,223,358,10,31,19,34,41,53,186.7993665708668,5.483870967741935,1557.1465665035141,86.50814258352857,283.95025624475846,55,51.394323882860114
ray_2.0.0,python/ray/train/_internal/accelerator.py,5,3,2,0,0,0,0,0,0,0,0,0,0.0,0,1,100.0
ray_2.0.0,python/ray/train/_internal/dl_predictor.py,85,32,44,0,0,0,0,0,0,0,0,0,0.0,0,7,100.0
ray_2.0.0,python/ray/train/_internal/__init__.py,0,0,0,0,0,0,0,0,0,0,0,0,0.0,0,1,100.0
ray_2.0.0,python/ray/train/_internal/dataset_spec.py,225,112,130,9,32,20,35,41,55,188.52932501298082,4.921875,1450.3060700001297,80.57255944445166,294.6653602539946,43,60.81686553576986
ray_2.0.0,python/ray/train/_internal/session.py,336,184,205,9,25,16,29,34,45,144.62572975734892,5.22,1195.0450214097048,66.39139007831693,228.9358278562653,32,55.46346933509921
ray_2.0.0,python/ray/train/_internal/checkpoint.py,248,127,158,10,25,14,26,35,40,149.31568569324173,5.2,1066.8908675245532,59.27171486247518,205.17132067779866,35,58.269735866853416
ray_2.0.0,python/ray/train/_internal/results_preprocessors/index.py,58,28,34,3,8,5,8,11,13,28.75488750216347,1.5,67.4589165634273,3.747717586857072,44.97261104228487,12,80.83759498284233
ray_2.0.0,python/ray/train/_internal/results_preprocessors/__init__.py,23,5,22,0,0,0,0,0,0,0,0,0,0.0,0,1,100.0
ray_2.0.0,python/ray/train/_internal/results_preprocessors/preprocessor.py,65,22,31,0,0,0,0,0,0,0,0,0,0.0,0,5,100.0
ray_2.0.0,python/ray/train/_internal/results_preprocessors/keys.py,44,14,26,2,4,2,4,6,6,10.0,1.0,15.509775004326936,0.861654166907052,15.509775004326936,7,93.17028154620347
ray_2.0.0,python/ray/train/_internal/results_preprocessors/aggregate/__init__.py,11,2,10,0,0,0,0,0,0,0,0,0,0.0,0,1,100.0
ray_2.0.0,python/ray/train/_internal/results_preprocessors/aggregate/aggregate_preprocessor.py,164,44,59,3,6,3,6,9,9,20.264662506490406,1.5,42.793987519471216,2.377443751081734,28.529325012980813,14,76.14163513592945
ray_2.0.0,python/ray/train/_internal/results_preprocessors/aggregate/aggregate_utils.py,144,41,67,4,10,7,10,14,17,41.219280948873624,2.0,129.45006734995852,7.191670408331029,64.72503367497926,15,78.76992435749872
ray_2.0.0,python/ray/train/_internal/results_preprocessors/aggregate/aggregate_fn.py,129,48,73,4,9,5,10,13,15,36.52932501298081,2.2222222222222223,123.34799060470309,6.852666144705727,55.506595772116384,13,76.74686180775132
ray_2.0.0,python/ray/train/lightgbm/lightgbm_trainer.py,97,34,35,0,0,0,0,0,0,0,0,0,0.0,0,6,100.0
ray_2.0.0,python/ray/train/lightgbm/__init__.py,9,4,8,0,0,0,0,0,0,0,0,0,0.0,0,1,100.0
ray_2.0.0,python/ray/train/lightgbm/lightgbm_checkpoint.py,70,27,29,0,0,0,0,0,0,0,0,0,0.0,0,5,100.0
ray_2.0.0,python/ray/train/lightgbm/lightgbm_predictor.py,160,57,67,2,6,3,6,8,9,17.509775004326936,1.0,27.0,1.5,27.0,18,76.649127061463
ray_2.0.0,python/ray/train/torch/torch_checkpoint.py,68,23,24,0,0,0,0,0,0,0,0,0,0.0,0,4,100.0
ray_2.0.0,python/ray/train/torch/train_loop_utils.py,704,304,381,10,51,29,56,61,85,322.5129733894199,5.490196078431373,2767.677424196014,153.75985689977855,504.11267369284536,77,45.69398032847158
ray_2.0.0,python/ray/train/torch/torch_predictor.py,225,49,90,3,7,4,7,10,11,24.406371956566698,1.5,54.81181356564148,3.0451007536467487,36.541209043760986,15,75.81226478865726
ray_2.0.0,python/ray/train/torch/torch_trainer.py,208,16,37,1,1,1,1,2,2,0.0,0.5,1.0,0.05555555555555555,2.0,4,51.3200157861634
ray_2.0.0,python/ray/train/torch/__init__.py,38,10,34,0,0,0,0,0,0,0,0,0,0.0,0,2,100.0
ray_2.0.0,python/ray/train/torch/config.py,186,93,125,5,19,10,20,24,30,92.32026322986493,2.6315789473684212,361.97072374114396,20.109484652285776,137.5488750216347,21,63.83500395342413
ray_2.0.0,python/ray/train/huggingface/huggingface_trainer.py,486,143,270,9,36,21,40,45,61,214.64662506490404,5.0,1675.0151943805508,93.05639968780838,335.00303887611017,38,59.43154656357001
ray_2.0.0,python/ray/train/huggingface/huggingface_checkpoint.py,105,54,70,1,1,1,1,2,2,0.0,0.5,1.0,0.05555555555555555,2.0,11,83.07779290721841
ray_2.0.0,python/ray/train/huggingface/_huggingface_utils.py,163,92,97,2,3,2,3,5,5,6.754887502163469,1.0,11.60964047443681,0.6449800263576005,11.60964047443681,20,72.0935981605202
ray_2.0.0,python/ray/train/huggingface/__init__.py,11,4,10,0,0,0,0,0,0,0,0,0,0.0,0,1,100.0
ray_2.0.0,python/ray/train/huggingface/huggingface_predictor.py,178,59,83,6,16,9,17,22,26,79.50977500432694,3.1875,369.57539539456604,20.531966410809225,115.94522208456974,24,71.814361755911
ray_2.0.0,python/ray/_private/log_monitor.py,535,250,383,14,81,48,94,95,142,566.830819142461,8.123456790123457,7578.531217530994,421.0295120850552,932.9194963829946,63,44.06240996789623
ray_2.0.0,python/ray/_private/async_compat.py,160,91,97,5,11,9,17,16,26,49.663388279447084,3.8636363636363638,401.8181818181818,22.32323232323232,104.0,30,67.61864261644675
ray_2.0.0,python/ray/_private/signature.py,173,75,75,3,25,17,34,28,51,120.85129224653159,2.04,500.1572060908731,27.78651144949295,245.1751010249378,23,67.09042978899782
ray_2.0.0,python/ray/_private/services.py,2095,707,1307,20,301,212,409,321,621,2564.7580846024175,13.588039867109634,70259.85046527264,3903.32502584848,5170.71271150295,200,13.582735396780862
ray_2.0.0,python/ray/_private/utils.py,1516,702,907,19,249,155,298,268,453,2062.75110384038,11.369477911646586,41543.37196657926,2307.965109254403,3653.9384032773705,181,16.644476773747417
ray_2.0.0,python/ray/_private/metrics_agent.py,272,151,196,6,13,9,13,19,22,63.61549134016113,3.0,280.3632158872766,15.575734215959812,93.45440529575887,41,55.840254690651406
ray_2.0.0,python/ray/_private/client_mode_hook.py,198,95,92,6,28,16,28,34,44,150.11571282193984,3.0,671.545095045045,37.30806083583583,223.84836501501496,12,67.83131711080918
ray_2.0.0,python/ray/_private/conftest_utils.py,14,9,12,0,0,0,0,0,0,0,0,0,0.0,0,2,100.0
ray_2.0.0,python/ray/_private/ray_cluster_perf.py,50,29,38,3,11,9,18,14,27,42.808635307173745,2.4545454545454546,252.32379437999938,14.017988576666632,102.7985828955553,3,53.60783356802905
ray_2.0.0,python/ray/_private/memory_monitor.py,168,84,109,12,59,35,69,71,104,390.0954899210025,7.016949152542373,4487.856135210061,249.3253408450034,639.573700428487,23,62.43752826022585
ray_2.0.0,python/ray/_private/function_manager.py,684,281,440,12,54,31,56,66,87,353.78347512548123,6.222222222222222,3272.03201661271,181.77955647848387,525.8622883841855,63,47.421849706555264
ray_2.0.0,python/ray/_private/ray_logging.py,320,139,190,7,36,23,44,43,67,205.76878450632645,4.277777777777778,1555.227770528229,86.40154280712383,363.55973856504056,41,58.188085858341566
ray_2.0.0,python/ray/_private/gcs_utils.py,531,263,439,7,38,32,64,45,96,219.07272996525947,5.894736842105263,3107.8107627229824,172.65615348461014,527.2178972476488,54,36.83070848235982
ray_2.0.0,python/ray/_private/import_thread.py,214,105,143,6,18,10,20,24,30,90.56842503028855,3.3333333333333335,458.4962500721157,25.472013892895315,137.5488750216347,31,64.15408885362883
ray_2.0.0,python/ray/_private/storage.py,415,181,180,10,40,24,42,50,66,246.09640474436813,5.25,1955.5961697569421,108.64423165316344,372.49450852513183,44,54.338856590732455
ray_2.0.0,python/ray/_private/node.py,1459,641,953,16,163,115,213,179,328,1261.8426891396657,10.45398773006135,25661.315605535707,1425.6286447519838,2454.691574942676,200,14.85678499235714
ray_2.0.0,python/ray/_private/__init__.py,0,0,0,0,0,0,0,0,0,0,0,0,0.0,0,1,100.0
ray_2.0.0,python/ray/_private/ray_perf.py,310,192,209,7,52,45,88,59,133,316.07434979774,5.923076923076923,4634.16518988574,257.4536216603189,782.3915255651249,29,35.243296154763115
ray_2.0.0,python/ray/_private/inspect_util.py,49,18,16,5,15,7,15,20,22,70.2129994085646,2.5,237.70604521880495,13.205891401044719,95.08241808752197,8,81.36936115705342
ray_2.0.0,python/ray/_private/parameter.py,432,162,271,13,64,51,102,77,153,432.1057163358342,10.359375,9932.758748461722,551.8199304700956,958.81834072632,57,52.22801616611118
ray_2.0.0,python/ray/_private/external_storage.py,687,330,395,14,82,54,104,96,158,574.6222332874894,8.878048780487806,9236.935691255492,513.1630939586385,1040.4240751139428,86,41.115013221923476
ray_2.0.0,python/ray/_private/prometheus_exporter.py,342,170,176,7,22,12,24,29,36,117.75898006442377,3.8181818181818183,667.751569512081,37.09730941733783,174.88731582459263,43,59.084521884304024
ray_2.0.0,python/ray/_private/ray_microbenchmark_helpers.py,53,38,40,7,17,12,24,24,36,89.13835275565901,4.9411764705882355,815.58391777534,45.31021765418555,165.05865002596164,6,68.75919635204427
ray_2.0.0,python/ray/_private/ray_process_reaper.py,60,29,28,2,8,5,10,10,15,26.0,1.25,62.28615177913805,3.4603417655076694,49.82892142331044,5,84.05236147542392
ray_2.0.0,python/ray/_private/resource_spec.py,368,165,252,15,68,52,104,83,156,472.5508321391509,11.470588235294118,11407.570558916086,633.7539199397826,994.5061512901203,62,47.81288929755418
ray_2.0.0,python/ray/_private/ray_client_microbenchmark.py,117,75,74,5,25,15,28,30,43,127.70604521880493,2.8,590.7896277112657,32.8216459839592,210.99629561116632,5,42.15036348563308
ray_2.0.0,python/ray/_private/dict.py,247,118,153,11,48,35,66,59,101,306.1319478396258,7.5625,4493.236294140692,249.62423856337176,594.146947985546,52,56.542299428958295
ray_2.0.0,python/ray/_private/internal_api.py,216,79,154,10,47,41,80,57,121,294.2849569777226,8.51063829787234,6006.635674161139,333.70198189784105,705.7796917139339,18,57.57628567124989
ray_2.0.0,python/ray/_private/ray_constants.py,391,176,206,8,33,24,47,41,71,190.46500593882897,5.696969696969697,2167.048610837642,120.39158949098012,380.386192327884,10,60.84434143377526
ray_2.0.0,python/ray/_private/gcs_pubsub.py,613,309,371,9,30,21,42,39,63,175.7360428812364,6.3,2097.7761406664263,116.54311892591257,332.98033978832166,94,43.083238626006455
ray_2.0.0,python/ray/_private/serialization.py,433,244,325,7,43,33,61,50,94,252.98086890659343,4.965116279069767,2634.1058109904407,146.33921172169116,530.5224818388241,73,41.185849333107484
ray_2.0.0,python/ray/_private/tls_utils.py,99,44,79,4,8,4,8,12,12,32.0,2.0,86.03910001730776,4.779950000961542,43.01955000865388,5,70.86124982301952
ray_2.0.0,python/ray/_private/test_utils.py,1472,890,1029,17,301,184,356,318,540,2547.8063910059263,10.053156146179402,45128.18360216894,2507.1213112316077,4488.956795853553,160,11.07913842580919
ray_2.0.0,python/ray/_private/logging_utils.py,29,8,23,0,0,0,0,0,0,0,0,0,0.0,0,2,100.0
ray_2.0.0,python/ray/_private/profiling.py,56,18,16,3,5,3,5,8,8,16.36452797660028,1.5,36.0,2.0,24.0,5,80.14473804235622
ray_2.0.0,python/ray/_private/state.py,897,358,528,14,80,47,93,94,140,559.0572164997953,8.1375,7467.315349273747,414.8508527374304,917.6424392348692,84,40.93618653322171
ray_2.0.0,python/ray/_private/worker.py,2898,1150,1718,19,263,190,354,282,544,2194.9463169393034,12.787072243346008,56620.080957322156,3145.5600531845644,4427.915935704944,304,0.0
ray_2.0.0,python/ray/_private/ray_option_utils.py,301,99,221,12,67,47,87,79,134,449.4475257693246,7.791044776119403,6581.147101096895,365.619283394272,844.7066202557318,33,55.91002696182569
ray_2.0.0,python/ray/_private/compat.py,40,23,25,3,12,6,12,15,18,47.77443751081735,1.5,105.48604608143,5.860335893412778,70.32403072095333,7,84.67512289968346
ray_2.0.0,python/ray/_private/thirdparty/__init__.py,0,0,0,0,0,0,0,0,0,0,0,0,0.0,0,1,100.0
ray_2.0.0,python/ray/_private/thirdparty/pathspec/__init__.py,69,17,39,0,0,0,0,0,0,0,0,0,0.0,0,1,100.0
ray_2.0.0,python/ray/_private/thirdparty/pathspec/util.py,600,219,186,8,53,34,60,61,94,327.5797840918496,4.528301886792453,2524.479893121108,140.24888295117267,557.4893097309114,72,37.07109526992696
ray_2.0.0,python/ray/_private/thirdparty/pathspec/pathspec.py,206,72,58,3,8,7,10,11,17,28.75488750216347,1.875,110.26938284406387,6.126076824670215,58.81033751683406,26,52.994953681018224
ray_2.0.0,python/ray/_private/thirdparty/pathspec/pattern.py,146,49,38,4,12,11,22,16,33,51.01955000865388,3.6666666666666665,484.0,26.88888888888889,132.0,19,51.856796428874404
ray_2.0.0,python/ray/_private/thirdparty/pathspec/compat.py,38,20,19,1,2,1,2,3,3,2.0,0.5,2.3774437510817346,0.1320802083934297,4.754887502163469,3,95.64760078277287
ray_2.0.0,python/ray/_private/thirdparty/pathspec/patterns/__init__.py,8,2,1,0,0,0,0,0,0,0,0,0,0.0,0,1,100.0
ray_2.0.0,python/ray/_private/thirdparty/pathspec/patterns/gitwildmatch.py,330,149,137,13,70,62,119,83,181,477.1555275219819,11.05,12750.397614665419,708.3554230369677,1153.8821370737935,51,49.61200728911507
ray_2.0.0,python/ray/_private/thirdparty/tabulate/__init__.py,0,0,0,0,0,0,0,0,0,0,0,0,0.0,0,1,100.0
ray_2.0.0,python/ray/_private/thirdparty/tabulate/tabulate.py,2197,844,1276,18,420,306,577,438,883,3735.041767445733,12.364285714285714,95800.1792953556,5322.232183075311,7748.136973627837,322,0.0
ray_2.0.0,python/ray/_private/thirdparty/dacite/exceptions.py,79,49,55,0,0,0,0,0,0,0,0,0,0.0,0,18,100.0
ray_2.0.0,python/ray/_private/thirdparty/dacite/core.py,140,99,121,6,25,14,25,31,39,131.60617974869504,3.0,579.6409683152644,32.20227601751469,193.21365610508815,38,50.20139022380649
ray_2.0.0,python/ray/_private/thirdparty/dacite/__init__.py,3,3,3,0,0,0,0,0,0,0,0,0,0.0,0,1,100.0
ray_2.0.0,python/ray/_private/thirdparty/dacite/types.py,172,131,137,8,62,34,63,70,97,393.1601712439863,4.064516129032258,2416.519259132303,134.25106995179462,594.5404526436619,57,35.54819169692867
ray_2.0.0,python/ray/_private/thirdparty/dacite/config.py,12,16,10,0,0,0,0,0,0,0,0,0,0.0,0,1,100.0
ray_2.0.0,python/ray/_private/thirdparty/dacite/data.py,3,2,2,0,0,0,0,0,0,0,0,0,0.0,0,1,100.0
ray_2.0.0,python/ray/_private/thirdparty/dacite/dataclasses.py,33,23,23,3,8,5,10,11,15,28.75488750216347,1.875,97.296514274174,5.405361904120777,51.89147427955947,8,77.10573269329458
ray_2.0.0,python/ray/_private/runtime_env/working_dir.py,168,83,128,8,33,23,39,41,62,190.46500593882897,4.7272727272727275,1570.2497875353367,87.23609930751871,332.1682242863212,24,55.19007980405307
ray_2.0.0,python/ray/_private/runtime_env/utils.py,113,57,75,6,10,6,11,16,17,48.72905595320056,3.3,224.39999999999998,12.466666666666665,68.0,14,73.64175916330146
ray_2.0.0,python/ray/_private/runtime_env/pip.py,480,221,356,9,38,22,39,47,61,227.95057052383706,4.618421052631579,1564.8592355693406,86.9366241982967,338.8299199523359,43,48.603199708372095
ray_2.0.0,python/ray/_private/runtime_env/constants.py,28,9,9,0,0,0,0,0,0,0,0,0,0.0,0,1,100.0
ray_2.0.0,python/ray/_private/runtime_env/_clonevirtualenv.py,334,222,242,9,84,49,90,93,139,565.4839885263967,4.821428571428571,4382.404110372936,243.46689502071865,908.9430747440165,63,41.02759179544667
ray_2.0.0,python/ray/_private/runtime_env/__init__.py,3,1,1,0,0,0,0,0,0,0,0,0,0.0,0,1,100.0
ray_2.0.0,python/ray/_private/runtime_env/java_jars.py,92,48,75,1,3,3,3,4,6,4.754887502163469,0.5,6.0,0.3333333333333333,12.0,13,60.949921047406974
ray_2.0.0,python/ray/_private/runtime_env/plugin_schema_manager.py,90,62,76,3,7,4,7,10,11,24.406371956566698,1.5,54.81181356564148,3.0451007536467487,36.541209043760986,22,60.381164207542504
ray_2.0.0,python/ray/_private/runtime_env/container.py,49,22,39,3,9,6,10,12,16,33.28421251514428,1.6666666666666667,95.59900001923084,5.311055556623936,57.359400011538504,6,75.60599774508619
ray_2.0.0,python/ray/_private/runtime_env/validation.py,260,115,158,7,55,34,58,62,92,337.6262686982595,3.690909090909091,2021.8285507779144,112.3238083765508,547.7860605555926,45,56.69207348068723
ray_2.0.0,python/ray/_private/runtime_env/context.py,92,55,67,5,35,22,44,40,66,191.13454606751063,3.142857142857143,1103.9199419680644,61.32888566489247,351.24725426256595,18,64.2690403565359
ray_2.0.0,python/ray/_private/runtime_env/conda_utils.py,240,127,160,12,52,32,61,64,93,339.4424153519907,7.038461538461538,3927.4615384615386,218.1923076923077,558.0,31,56.41385458509753
ray_2.0.0,python/ray/_private/runtime_env/plugin.py,257,105,159,9,29,18,32,38,50,169.41077387168042,4.9655172413793105,1302.9337274756488,72.38520708198048,262.39637567217926,30,62.38292632870366
ray_2.0.0,python/ray/_private/runtime_env/uri_cache.py,110,62,65,11,28,15,30,39,45,172.65968562262316,5.892857142857143,1401.5754098232928,77.86530054573849,237.8430998488012,19,67.63662849726299
ray_2.0.0,python/ray/_private/runtime_env/conda.py,376,181,240,9,38,21,40,47,61,227.95057052383706,4.7368421052631575,1604.98383135317,89.16576840850945,338.8299199523359,36,54.98154813019293
ray_2.0.0,python/ray/_private/runtime_env/packaging.py,781,344,460,17,110,71,135,127,206,815.4364367889683,10.431818181818182,15018.365724387622,834.3536513548679,1439.6690454750662,72,41.04161668555301
ray_2.0.0,python/ray/_private/runtime_env/py_modules.py,224,111,179,8,19,14,23,27,37,104.71062275542812,4.842105263157895,851.8756345981288,47.32642414434049,175.93083758004835,31,50.98418703423057
ray_2.0.0,python/ray/_private/usage/usage_constants.py,51,13,37,0,0,0,0,0,0,0,0,0,0.0,0,1,100.0
ray_2.0.0,python/ray/_private/usage/usage_lib.py,912,474,559,13,109,71,133,122,204,785.8378077365192,7.931192660550459,11213.678673191887,622.9821485106604,1413.870416862829,100,33.42478600884447
ray_2.0.0,python/ray/_private/usage/__init__.py,0,0,0,0,0,0,0,0,0,0,0,0,0.0,0,1,100.0
ray_2.0.0,python/ray/_private/workers/setup_worker.py,33,15,23,2,4,2,4,6,6,10.0,1.0,15.509775004326936,0.861654166907052,15.509775004326936,3,85.50020638749073
ray_2.0.0,python/ray/_private/workers/__init__.py,0,0,0,0,0,0,0,0,0,0,0,0,0.0,0,1,100.0
ray_2.0.0,python/ray/_private/workers/default_worker.py,244,82,220,5,16,11,22,21,33,75.60964047443682,3.4375,498.2535076464657,27.68075042480365,144.94647495169912,15,54.16992187246553
ray_2.0.0,python/ray/scripts/__init__.py,0,0,0,0,0,0,0,0,0,0,0,0,0.0,0,1,100.0
ray_2.0.0,python/ray/scripts/scripts.py,2592,856,2223,16,143,109,196,159,305,1087.8616011593097,10.965034965034965,24456.735276469863,1358.707515359437,2230.4293013617284,142,8.430350062472804
ray_2.0.0,python/ray/cloudpickle/__init__.py,47,31,34,0,0,0,0,0,0,0,0,0,0.0,0,5,100.0
ray_2.0.0,python/ray/cloudpickle/py_pickle.py,30,6,26,0,0,0,0,0,0,0,0,0,0.0,0,2,100.0
ray_2.0.0,python/ray/cloudpickle/cloudpickle_fast.py,832,364,436,11,77,48,91,88,139,520.5963114385177,6.5,5836.096467438799,324.2275815243777,897.8609949905845,90,40.58048778717811
ray_2.0.0,python/ray/cloudpickle/cloudpickle.py,1003,452,512,16,168,102,199,184,301,1305.9093270268318,9.476190476190476,21459.70655265995,1192.2059195922195,2264.5921487731607,122,31.307319191500433
ray_2.0.0,python/ray/cloudpickle/compat.py,27,20,24,2,4,2,4,6,6,10.0,1.0,15.509775004326936,0.861654166907052,15.509775004326936,5,87.76790381544842
ray_2.0.0,python/ray/experimental/shuffle.py,358,177,234,11,42,25,49,53,74,264.53107956171823,6.416666666666667,2719.807562508426,151.100420139357,423.8661136376768,29,53.88958327949832
ray_2.0.0,python/ray/experimental/tf_utils.py,234,111,128,12,39,26,47,51,73,249.15023654428157,7.230769230769231,2994.167899739108,166.34266109661712,414.0870499639192,47,59.95497878748889
ray_2.0.0,python/ray/experimental/__init__.py,5,4,4,0,0,0,0,0,0,0,0,0,0.0,0,1,100.0
ray_2.0.0,python/ray/experimental/internal_kv.py,121,69,84,3,9,4,9,12,13,33.28421251514428,1.5,69.90676876406255,3.883709375781253,46.604512509375034,17,60.078623679023636
ray_2.0.0,python/ray/experimental/dynamic_resources.py,7,2,7,0,0,0,0,0,0,0,0,0,0.0,0,1,100.0
ray_2.0.0,python/ray/experimental/locations.py,40,8,11,1,1,1,1,2,2,0.0,0.5,1.0,0.05555555555555555,2.0,2,89.80189778743048
ray_2.0.0,python/ray/experimental/queue.py,13,4,10,0,0,0,0,0,0,0,0,0,0.0,0,1,100.0
ray_2.0.0,python/ray/experimental/job/__init__.py,0,0,0,0,0,0,0,0,0,0,0,0,0.0,0,1,100.0
ray_2.0.0,python/ray/experimental/job/example_job/demo_script.py,77,44,63,4,6,4,7,10,11,23.509775004326936,2.3333333333333335,85.26282110210897,4.736823394561609,36.541209043760986,8,62.682622168259506
ray_2.0.0,python/ray/experimental/job/example_job/__init__.py,0,0,0,0,0,0,0,0,0,0,0,0,0.0,0,1,100.0
ray_2.0.0,python/ray/experimental/packaging/__init__.py,0,0,0,0,0,0,0,0,0,0,0,0,0.0,0,1,100.0
ray_2.0.0,python/ray/experimental/packaging/load_package.py,232,107,137,8,25,18,30,33,48,140.0964047443681,4.8,1162.2284051001875,64.5682447277882,242.13091772920575,26,63.41746962186452
ray_2.0.0,python/ray/experimental/packaging/example_pkg/my_pkg/__init__.py,0,0,0,0,0,0,0,0,0,0,0,0,0.0,0,1,100.0
ray_2.0.0,python/ray/experimental/packaging/example_pkg/my_pkg/stubs.py,28,12,12,0,0,0,0,0,0,0,0,0,0.0,0,3,100.0
ray_2.0.0,python/ray/experimental/packaging/example_pkg/my_pkg/impl/__init__.py,3,2,2,0,0,0,0,0,0,0,0,0,0.0,0,1,100.0
ray_2.0.0,python/ray/experimental/state/common.py,941,513,494,15,85,68,133,100,201,603.4015885058325,11.735294117647058,15671.488898933623,870.6382721629791,1335.41509414472,88,36.32101874195648
ray_2.0.0,python/ray/experimental/state/custom_types.py,94,35,80,3,6,3,6,9,9,20.264662506490406,1.5,42.793987519471216,2.377443751081734,28.529325012980813,5,69.93365025448888
ray_2.0.0,python/ray/experimental/state/__init__.py,0,0,0,0,0,0,0,0,0,0,0,0,0.0,0,1,100.0
ray_2.0.0,python/ray/experimental/state/util.py,47,27,34,3,19,13,28,22,41,85.46551025759159,2.210526315789474,404.1653288049172,22.453629378050955,182.83669636412918,15,76.51358870880016
ray_2.0.0,python/ray/experimental/state/state_cli.py,671,201,391,10,71,48,93,81,141,469.85132643370605,6.549295774647887,5854.538949846908,325.25216388038376,893.9188504067322,44,51.509749011141
ray_2.0.0,python/ray/experimental/state/state_manager.py,368,183,275,4,29,22,31,33,53,148.8814488586996,2.1379310344827585,571.5820371107544,31.754557617264133,267.35288832599804,46,48.24126796204174
ray_2.0.0,python/ray/experimental/state/exception.py,23,12,9,1,2,1,2,3,3,2.0,0.5,2.3774437510817346,0.1320802083934297,4.754887502163469,2,71.44842835188814
ray_2.0.0,python/ray/experimental/state/api.py,1326,246,621,10,35,22,41,45,63,212.74418654194744,5.857142857142857,2026.4937925456497,112.58298847475832,345.9867450687695,55,50.146464851757266
ray_2.0.0,python/ray/experimental/raysort/sortlib.py,28,18,20,3,5,3,6,8,9,16.36452797660028,1.8,48.6,2.7,27.0,4,62.05709112214015
ray_2.0.0,python/ray/experimental/raysort/constants.py,44,21,27,5,8,5,10,13,15,35.60964047443681,3.125,173.4581117878637,9.636561765992427,55.506595772116384,2,84.11063814679925
ray_2.0.0,python/ray/experimental/raysort/tracing_utils.py,116,70,98,4,9,5,9,13,14,36.52932501298081,2.0,103.61231210795059,5.75623956155281,51.80615605397529,14,45.86393588133696
ray_2.0.0,python/ray/experimental/raysort/types.py,18,16,13,0,0,0,0,0,0,0,0,0,0.0,0,2,100.0
ray_2.0.0,python/ray/experimental/raysort/main.py,470,262,359,14,72,46,89,86,135,497.5375690126529,8.652777777777779,7506.680516586389,417.0378064770216,867.5457418847832,52,37.72668386639852
ray_2.0.0,python/ray/experimental/raysort/logging_utils.py,9,4,7,0,0,0,0,0,0,0,0,0,0.0,0,1,100.0
ray_2.0.0,python/ray/experimental/multiprocessing/__init__.py,5,3,3,0,0,0,0,0,0,0,0,0,0.0,0,1,100.0
ray_2.0.0,python/ray/experimental/multiprocessing/pool.py,5,3,3,0,0,0,0,0,0,0,0,0,0.0,0,1,100.0
ray_2.0.0,python/ray/experimental/array/__init__.py,0,0,0,0,0,0,0,0,0,0,0,0,0.0,0,1,100.0
ray_2.0.0,python/ray/experimental/array/remote/random.py,8,5,5,0,0,0,0,0,0,0,0,0,0.0,0,1,100.0
ray_2.0.0,python/ray/experimental/array/remote/linalg.py,126,63,84,0,0,0,0,0,0,0,0,0,0.0,0,1,100.0
ray_2.0.0,python/ray/experimental/array/remote/core.py,99,60,60,5,13,8,14,18,22,59.715356810271004,2.6923076923076925,246.98786547004468,13.721548081669148,91.73835003173087,7,57.327814521550444
ray_2.0.0,python/ray/experimental/array/remote/__init__.py,44,3,43,0,0,0,0,0,0,0,0,0,0.0,0,1,100.0
ray_2.0.0,python/ray/experimental/array/distributed/random.py,17,12,14,0,0,0,0,0,0,0,0,0,0.0,0,2,100.0
ray_2.0.0,python/ray/experimental/array/distributed/linalg.py,231,136,148,10,39,33,63,49,96,239.34996748450132,8.076923076923077,4353.559632975484,241.8644240541936,539.01214503506,20,58.39297313312602
ray_2.0.0,python/ray/experimental/array/distributed/core.py,316,190,258,14,74,47,90,88,137,512.8025179653488,8.513513513513514,7533.9667973592595,418.5537109644033,884.9421317533098,58,37.44470620047575
ray_2.0.0,python/ray/experimental/array/distributed/__init__.py,40,3,39,0,0,0,0,0,0,0,0,0,0.0,0,1,100.0
ray_2.0.0,python/ray/serve/gradio_integrations.py,31,19,18,0,0,0,0,0,0,0,0,0,0.0,0,4,100.0
ray_2.0.0,python/ray/serve/drivers.py,145,87,100,5,9,5,9,14,14,40.13896548741762,2.5,133.25742227201613,7.403190126223119,53.30296890880645,19,64.59897217158249
ray_2.0.0,python/ray/serve/controller.py,780,328,491,9,49,29,56,58,85,303.650107374626,5.142857142857143,2560.7745492986246,142.26525273881248,497.9283845858436,87,41.557100824603985
ray_2.0.0,python/ray/serve/deployment_graph.py,55,31,34,2,4,2,4,6,6,10.0,1.0,15.509775004326936,0.861654166907052,15.509775004326936,7,85.20887688767522
ray_2.0.0,python/ray/serve/exceptions.py,6,4,4,0,0,0,0,0,0,0,0,0,0.0,0,1,100.0
ray_2.0.0,python/ray/serve/air_integrations.py,288,147,194,8,34,22,39,42,61,196.97373660251156,4.588235294117647,1509.2144880930202,83.84524933850112,328.9313627895044,38,52.52466797114989
ray_2.0.0,python/ray/serve/__init__.py,41,11,35,1,2,1,2,3,3,2.0,0.5,2.3774437510817346,0.1320802083934297,4.754887502163469,2,86.17083351202876
ray_2.0.0,python/ray/serve/config.py,524,258,324,11,57,36,69,68,105,370.5284786124006,6.657894736842105,4255.617115205665,236.42317306698138,639.1835983312857,68,46.2546920550726
ray_2.0.0,python/ray/serve/schema.py,362,128,308,11,47,34,67,58,101,299.11942383385923,7.840425531914893,4638.835439726713,257.7130799848174,591.6560805078848,34,43.72873346131919
ray_2.0.0,python/ray/serve/context.py,128,65,71,3,5,3,5,8,8,16.36452797660028,1.5,36.0,2.0,24.0,7,77.84094584839188
ray_2.0.0,python/ray/serve/batching.py,310,148,160,11,55,33,59,66,92,356.02853204886657,5.9,3280.8971279877683,182.27206266598714,556.0842589809777,45,56.614184874165396
ray_2.0.0,python/ray/serve/http_adapters.py,98,58,66,0,0,0,0,0,0,0,0,0,0.0,0,5,100.0
ray_2.0.0,python/ray/serve/scripts.py,481,148,388,5,12,7,12,17,19,54.62919048309069,2.5,194.15448495939114,10.78636027552173,77.66179398375645,18,54.04653820496695
ray_2.0.0,python/ray/serve/application.py,78,37,41,4,6,4,7,10,11,23.509775004326936,2.3333333333333335,85.26282110210897,4.736823394561609,36.541209043760986,12,81.66020523840292
ray_2.0.0,python/ray/serve/dag.py,5,2,4,0,0,0,0,0,0,0,0,0,0.0,0,1,100.0
ray_2.0.0,python/ray/serve/deployment.py,540,219,379,9,89,71,131,98,202,604.8696003689903,6.623595505617978,8850.258803678595,491.6810446488108,1336.1713885112722,80,39.700203000323924
ray_2.0.0,python/ray/serve/handle.py,396,173,244,7,20,11,21,27,32,106.09004635215048,3.675,559.174770254424,31.065265014134663,152.156400069231,39,57.91868894906817
ray_2.0.0,python/ray/serve/api.py,541,152,275,6,16,10,19,22,29,79.50977500432694,3.5625,460.7150291004658,25.595279394470325,129.32351694048162,16,64.46516178914412
ray_2.0.0,python/ray/serve/tests/test_http_adapters.py,102,60,78,2,6,3,6,8,9,17.509775004326936,1.0,27.0,1.5,27.0,7,50.2475242039646
ray_2.0.0,python/ray/serve/tests/test_http_prefix_matching.py,103,67,74,3,62,49,98,65,147,373.9150587461498,2.370967741935484,2098.989452769869,116.61052515388161,885.2880685151828,18,37.10949209431171
ray_2.0.0,python/ray/serve/tests/test_deployment_graph_build.py,237,133,173,1,30,20,40,31,60,147.20671786825557,0.6666666666666666,198.167852415475,11.009325134193055,297.25177862321254,27,53.44483531469593
ray_2.0.0,python/ray/serve/tests/test_runtime_env_2.py,90,21,61,1,2,1,2,3,3,2.0,0.5,2.3774437510817346,0.1320802083934297,4.754887502163469,2,66.14680509776308
ray_2.0.0,python/ray/serve/tests/test_autoscaling_policy.py,887,373,640,11,132,101,197,143,298,967.9137715603262,8.208333333333334,17513.641945704672,972.9801080947041,2133.64165835996,84,29.61214968798702
ray_2.0.0,python/ray/serve/tests/test_common.py,191,81,148,3,20,13,23,23,36,91.19344939991072,1.725,280.91319747114056,15.606288748396699,162.84823041805248,22,48.42380923971847
ray_2.0.0,python/ray/serve/tests/test_deployment_graph.py,519,358,374,6,86,51,99,92,150,568.1685439087073,3.453488372093023,3379.356803980697,187.74204466559428,978.534293408552,65,24.325524685184376
ray_2.0.0,python/ray/serve/tests/test_get_deployment.py,173,121,121,3,37,22,44,40,66,197.50466203043462,1.7837837837837838,626.5491562521447,34.808286458452486,351.24725426256595,21,33.91721816535783
ray_2.0.0,python/ray/serve/tests/test_cross_language.py,72,34,57,1,6,3,6,7,9,15.509775004326936,0.5,12.63309714925922,0.701838730514401,25.26619429851844,5,72.93824997260367
ray_2.0.0,python/ray/serve/tests/test_regression.py,270,179,181,4,27,16,31,31,47,136.38196255841368,2.2962962962962963,534.6862240173094,29.704790223183856,232.84722658818316,14,50.587264536038894
ray_2.0.0,python/ray/serve/tests/test_deployment_graph_autoscaling.py,227,120,187,3,31,25,50,34,75,158.33497312415662,2.4193548387096775,923.128338130102,51.28490767389455,381.5597130937755,9,45.07673416187498
ray_2.0.0,python/ray/serve/tests/test_deployment_graph_handle_serde.py,60,39,37,2,12,7,12,14,19,45.01955000865388,1.0,72.33974351909447,4.018874639949693,72.33974351909447,10,50.9281626850101
ray_2.0.0,python/ray/serve/tests/test_advanced.py,102,60,65,2,5,3,6,7,9,13.60964047443681,1.2,30.319433158222125,1.6844129532345624,25.26619429851844,3,73.00096900141423
ray_2.0.0,python/ray/serve/tests/test_healthcheck.py,208,140,137,7,26,15,28,33,43,141.86291712607164,3.769230769230769,817.5798776529431,45.42110431405239,216.9089471324135,28,47.09635715265674
ray_2.0.0,python/ray/serve/tests/test_ray_client.py,206,85,150,5,20,11,22,25,33,98.04820237218406,2.75,421.4299492220563,23.412774956780904,153.24725426256592,13,52.63458199704135
ray_2.0.0,python/ray/serve/tests/test_deployment_graph_config.py,87,68,68,4,32,23,46,36,69,168.0,2.875,1025.5838721611187,56.97688178672882,356.72482509951953,23,39.06067766446498
ray_2.0.0,python/ray/serve/tests/test_cli.py,518,284,380,7,83,46,93,90,139,548.779757256198,3.9216867469879517,3538.8029809263608,196.60016560702005,902.3675803898248,38,34.36494488863453
ray_2.0.0,python/ray/serve/tests/test_controller.py,141,65,106,4,22,12,24,26,36,106.10749561002054,2.1818181818181817,369.1981742249003,20.511009679161127,169.21582985307933,9,59.39916846483737
ray_2.0.0,python/ray/serve/tests/test_gradio.py,70,42,44,2,12,6,12,14,18,45.01955000865388,1.0,68.53238859703687,3.8073549220576037,68.53238859703687,6,74.49178170732671
ray_2.0.0,python/ray/serve/tests/test_myst_doc.py,27,16,18,1,2,1,2,3,3,2.0,0.5,2.3774437510817346,0.1320802083934297,4.754887502163469,2,82.44254914109565
ray_2.0.0,python/ray/serve/tests/__init__.py,0,0,0,0,0,0,0,0,0,0,0,0,0.0,0,1,100.0
ray_2.0.0,python/ray/serve/tests/test_air_integrations.py,268,180,210,5,32,18,35,37,53,171.60964047443682,2.734375,754.9637494720081,41.94243052622267,276.1010283783344,49,31.287207693034407
ray_2.0.0,python/ray/serve/tests/test_deploy.py,857,609,595,13,147,97,190,160,287,1106.4575510267798,8.401360544217686,17654.563289743885,980.809071652438,2101.393363232673,70,24.584149764430215
ray_2.0.0,python/ray/serve/tests/test_handle.py,249,174,171,2,30,16,32,32,48,149.20671786825557,1.0666666666666667,256.0,14.222222222222221,240.0,21,40.745997379447466
ray_2.0.0,python/ray/serve/tests/test_failure.py,204,138,140,7,40,24,48,47,72,232.52860824989773,4.2,1679.7076687473177,93.31709270818432,399.9303973207899,31,48.74947748138056
ray_2.0.0,python/ray/serve/tests/conftest.py,113,60,83,1,4,2,4,5,6,8.0,0.5,6.965784284662087,0.3869880158145604,13.931568569324174,3,72.82114890791787
ray_2.0.0,python/ray/serve/tests/test_deployment_state.py,2098,968,1571,13,192,174,327,205,501,1504.4185164742962,11.0703125,42592.13651406725,2366.2298063370695,3847.4195298522286,245,0.0
ray_2.0.0,python/ray/serve/tests/test_controller_recovery.py,205,115,144,10,51,29,60,61,89,322.5129733894199,5.882352941176471,3104.9154296652764,172.49530164807092,527.8356230430969,25,55.476443991344546
ray_2.0.0,python/ray/serve/tests/test_standalone2.py,858,412,622,10,123,69,138,133,207,887.1485651056,5.609756097560975,8192.731628151503,455.15175711952793,1460.4434641487462,49,29.978862723866296
ray_2.0.0,python/ray/serve/tests/test_api.py,466,314,333,11,82,52,102,93,154,559.3730121836933,6.841463414634147,6889.562028376431,382.75344602091286,1007.0304569106369,50,27.009776446029612
ray_2.0.0,python/ray/serve/tests/test_config.py,257,145,181,5,42,34,59,47,93,238.08697223114476,3.511904761904762,1814.168394592571,100.78713303292062,516.5767632060202,35,49.174511649198635
ray_2.0.0,python/ray/serve/tests/test_gcs_failure.py,107,62,73,3,11,7,14,14,21,42.808635307173745,1.9090909090909092,152.64032005703666,8.480017780946481,79.95445336320968,8,69.53962519136184
ray_2.0.0,python/ray/serve/tests/test_long_poll.py,228,143,174,5,41,32,54,46,86,231.26927266377825,3.292682926829268,1564.1110807273637,86.89506004040909,475.0263282209031,26,45.88136675530164
ray_2.0.0,python/ray/serve/tests/test_batching.py,296,220,220,6,38,29,58,44,87,214.93102051518318,4.578947368421052,2174.8651537613528,120.82584187563072,474.9705508214449,20,38.72556908568792
ray_2.0.0,python/ray/serve/tests/test_http_routes.py,314,230,227,8,91,61,120,99,181,616.2093122580814,5.274725274725275,6329.214320357323,351.6230177976291,1199.9135482344093,47,30.264364819968403
ray_2.0.0,python/ray/serve/tests/test_application.py,280,153,180,6,21,12,24,27,36,107.74844088268091,3.4285714285714284,586.8889716956053,32.60494287197807,171.1759500778849,33,54.423368065597664
ray_2.0.0,python/ray/serve/tests/test_deployment_node.py,84,45,52,2,10,7,14,12,21,35.219280948873624,1.4,105.397897521202,5.855438751177889,75.28421251514429,14,67.83587333024248
ray_2.0.0,python/ray/serve/tests/test_autoscaling_metrics.py,116,86,87,4,36,23,41,40,64,194.11730005192322,2.2777777777777777,775.8188511658021,43.10104728698901,340.6033980727912,24,50.77664612549495
ray_2.0.0,python/ray/serve/tests/test_json_serde.py,268,112,170,2,19,10,20,21,30,82.71062275542812,1.0526315789473684,138.70476071932927,7.705820039962737,131.76952268336282,15,65.6887038424052
ray_2.0.0,python/ray/serve/tests/test_fastapi.py,661,433,492,7,110,79,150,117,229,765.6010529421158,4.7727272727272725,7508.996349199225,417.1664638444014,1573.3135207845996,72,23.338611895824386
ray_2.0.0,python/ray/serve/tests/test_controller_crashes.py,19,16,15,3,5,3,5,8,8,16.36452797660028,1.5,36.0,2.0,24.0,3,63.66560396602703
ray_2.0.0,python/ray/serve/tests/test_deployment_graph_driver.py,180,114,135,3,39,24,48,42,72,210.88557403779114,1.8461538461538463,716.7634235816691,39.82019019898162,388.24685444007076,25,38.82612122062807
ray_2.0.0,python/ray/serve/tests/test_util.py,301,164,222,2,43,22,44,45,66,235.3293844521902,1.0232558139534884,370.8916602730552,20.605092237391958,362.4623043577585,37,43.32636051715684
ray_2.0.0,python/ray/serve/tests/test_router.py,143,73,87,4,13,8,15,17,23,56.105716335834195,2.3076923076923075,216.94995080482573,12.05277504471254,94.01164534875782,11,69.95962566541212
ray_2.0.0,python/ray/serve/tests/test_deployment_version.py,128,101,87,3,63,37,74,66,111,381.3235226826582,1.7619047619047619,1182.1107927716746,65.6728218206486,670.9277472487884,38,43.9422918139717
ray_2.0.0,python/ray/serve/tests/test_pipeline_dag_plot.py,324,243,248,5,71,51,102,76,153,448.2416859592692,3.591549295774648,3433.280168126782,190.73778711815456,955.9329095568687,67,18.079782695858444
ray_2.0.0,python/ray/serve/tests/test_deployment_graph_ingress_deployment.py,158,104,119,4,17,12,20,21,32,77.48686830125578,2.3529411764705883,330.7156647739302,18.373092487440566,140.55415752892034,13,52.33166654225704
ray_2.0.0,python/ray/serve/tests/test_logs.py,86,40,52,4,16,9,18,20,27,72.0,2.25,262.55713176440725,14.586507320244847,116.69205856195879,7,72.69870539510822
ray_2.0.0,python/ray/serve/tests/test_standalone.py,770,449,535,11,105,65,129,116,194,743.0495271599532,6.757142857142857,8990.029315355661,499.44607307531453,1330.448313054749,54,31.03474982836372
ray_2.0.0,python/ray/serve/tests/test_constructor_failure.py,108,68,68,2,13,7,13,15,20,50.105716335834195,1.0,78.13781191217038,4.340989550676132,78.13781191217038,6,70.64961608691286
ray_2.0.0,python/ray/serve/tests/test_metrics.py,161,98,126,5,17,18,36,22,54,81.0965087756926,5.294117647058823,1274.8728039163097,70.82626688423943,240.80930740641406,10,57.16974835136736
ray_2.0.0,python/ray/serve/tests/test_deploy_2.py,299,201,207,4,49,28,55,53,83,283.1207823616452,2.2448979591836733,1067.2635459216738,59.292419217870766,475.4173977287456,36,43.72841187020267
ray_2.0.0,python/ray/serve/tests/test_http_state.py,70,31,47,3,17,9,18,20,27,74.24175580341925,1.588235294117647,185.3344459513463,10.296358108408128,116.69205856195879,13,70.96892568211656
ray_2.0.0,python/ray/serve/tests/test_schema.py,633,216,477,3,27,15,28,30,43,133.13685006057713,1.5555555555555556,328.21645983959206,18.234247768866226,210.99629561116632,42,46.624243261945566
ray_2.0.0,python/ray/serve/tests/test_persistence.py,32,12,22,1,4,2,4,5,6,8.0,0.5,6.965784284662087,0.3869880158145604,13.931568569324174,3,68.04496717586133
ray_2.0.0,python/ray/serve/tests/test_runtime_env.py,151,47,106,1,4,2,4,5,6,8.0,0.5,6.965784284662087,0.3869880158145604,13.931568569324174,3,60.956198102129136
ray_2.0.0,python/ray/serve/tests/test_logging.py,174,102,125,5,30,24,49,35,73,158.81635834269238,4.083333333333333,1528.953779301012,84.941876627834,374.43766023698254,4,46.853362587107256
ray_2.0.0,python/ray/serve/tests/test_cluster.py,248,168,163,7,39,21,42,46,63,225.78217099003092,3.769230769230769,1311.633519872923,72.86852888182905,347.98440323159184,11,54.01955374737885
ray_2.0.0,python/ray/serve/tests/test_config_files/pid.py,28,19,19,0,0,0,0,0,0,0,0,0,0.0,0,6,100.0
ray_2.0.0,python/ray/serve/tests/test_config_files/world.py,20,15,13,0,0,0,0,0,0,0,0,0,0.0,0,3,100.0
ray_2.0.0,python/ray/serve/tests/test_config_files/pizza.py,89,56,64,4,8,6,10,12,16,32.0,2.5,143.39850002884626,7.966583334935903,57.359400011538504,11,55.56077688084421
ray_2.0.0,python/ray/serve/tests/test_config_files/fail.py,1,1,1,1,2,1,2,3,3,2.0,0.5,2.3774437510817346,0.1320802083934297,4.754887502163469,1,95.12415216859318
ray_2.0.0,python/ray/serve/tests/test_config_files/test_dag/basic_dag.py,28,15,21,0,0,0,0,0,0,0,0,0,0.0,0,3,100.0
ray_2.0.0,python/ray/serve/tests/test_config_files/test_dag/conditional_dag.py,117,61,91,5,14,10,18,19,28,64.91260938324326,3.2142857142857144,382.31347620992267,21.239637567217926,118.94197037642039,13,51.076244788873645
ray_2.0.0,python/ray/serve/tests/test_config_files/test_dag/dir/subdir/a/add_and_sub.py,80,43,54,2,5,3,6,7,9,13.60964047443681,1.2,30.319433158222125,1.6844129532345624,25.26619429851844,7,70.84403887333819
ray_2.0.0,python/ray/serve/tests/test_config_files/test_dag/dir2/library.py,2,2,2,1,2,1,2,3,3,2.0,0.5,2.3774437510817346,0.1320802083934297,4.754887502163469,1,88.5574946685516
ray_2.0.0,python/ray/serve/tests/resources/test_modules.py,96,60,64,4,20,10,20,24,30,94.43856189774725,2.0,275.0977500432694,15.28320833573719,137.5488750216347,15,60.224053636757915
ray_2.0.0,python/ray/serve/tests/resources/__init__.py,0,0,0,0,0,0,0,0,0,0,0,0,0.0,0,1,100.0
ray_2.0.0,python/ray/serve/tests/resources/test_dags.py,62,40,44,0,0,0,0,0,0,0,0,0,0.0,0,1,100.0
ray_2.0.0,python/ray/serve/tests/storage_tests/test_kv_store.py,46,32,32,2,16,9,18,18,27,66.0,1.125,126.66147191881024,7.036748439933902,112.58797503894243,10,65.93548910668103
ray_2.0.0,python/ray/serve/benchmarks/scalability.py,120,50,67,2,8,4,8,10,12,26.0,1.0,39.863137138648355,2.2146187299249087,39.863137138648355,8,79.69674066897898
ray_2.0.0,python/ray/serve/benchmarks/microbenchmark.py,191,106,150,9,36,22,44,45,66,214.64662506490404,5.5,1993.5426739676718,110.75237077598177,362.4623043577585,21,46.849040681874
ray_2.0.0,python/ray/serve/benchmarks/__init__.py,3,2,2,0,0,0,0,0,0,0,0,0,0.0,0,1,100.0
ray_2.0.0,python/ray/serve/benchmarks/noop_latency.py,67,44,50,4,8,4,8,12,12,32.0,2.0,86.03910001730776,4.779950000961542,43.01955000865388,6,60.35002255066097
ray_2.0.0,python/ray/serve/benchmarks/handle.py,97,48,51,4,9,5,10,13,15,36.52932501298081,2.2222222222222223,123.34799060470309,6.852666144705727,55.506595772116384,13,78.4809311068898
ray_2.0.0,python/ray/serve/benchmarks/baselines/uvicorn_app.py,17,6,17,1,2,1,2,3,3,2.0,0.5,2.3774437510817346,0.1320802083934297,4.754887502163469,2,78.01508585192973
ray_2.0.0,python/ray/serve/benchmarks/baselines/fastapi_app.py,8,5,5,0,0,0,0,0,0,0,0,0,0.0,0,1,100.0
ray_2.0.0,python/ray/serve/_private/common.py,284,166,208,4,11,7,14,15,21,46.053747805010275,2.5454545454545454,208.84106092889172,11.602281162716206,82.0447025077789,35,50.598691132702264
ray_2.0.0,python/ray/serve/_private/http_proxy.py,420,209,293,11,45,26,51,56,77,285.1871371398456,6.233333333333333,2787.3367840902483,154.85204356056934,447.1663289984356,47,49.084432724520994
ray_2.0.0,python/ray/serve/_private/utils.py,446,233,259,11,51,32,55,62,87,327.3474402455566,5.931372549019608,3072.5404195805218,170.69668997669567,518.0150790036582,49,49.470149363136805
ray_2.0.0,python/ray/serve/_private/http_util.py,287,144,163,9,25,15,29,34,44,144.62572975734892,5.22,1168.4884653783781,64.91602585435434,223.84836501501496,36,60.546999980648444
ray_2.0.0,python/ray/serve/_private/deployment_method_executor_node.py,87,28,60,1,2,1,2,3,3,2.0,0.5,2.3774437510817346,0.1320802083934297,4.754887502163469,8,87.77205376989933
ray_2.0.0,python/ray/serve/_private/deployment_node.py,70,24,58,0,0,0,0,0,0,0,0,0,0.0,0,6,100.0
ray_2.0.0,python/ray/serve/_private/deployment_executor_node.py,84,30,58,1,2,1,2,3,3,2.0,0.5,2.3774437510817346,0.1320802083934297,4.754887502163469,9,87.72811842018199
ray_2.0.0,python/ray/serve/_private/deployment_function_node.py,95,35,80,5,11,6,12,16,18,49.663388279447084,2.727272727272727,196.36363636363635,10.909090909090908,72.0,10,65.03579612855394
ray_2.0.0,python/ray/serve/_private/constants.py,120,38,54,2,4,2,4,6,6,10.0,1.0,15.509775004326936,0.861654166907052,15.509775004326936,2,86.09409160783699
ray_2.0.0,python/ray/serve/_private/__init__.py,0,0,0,0,0,0,0,0,0,0,0,0,0.0,0,1,100.0
ray_2.0.0,python/ray/serve/_private/autoscaling_metrics.py,171,77,81,5,14,7,14,19,21,64.91260938324326,2.5,223.01619445578822,12.389788580877124,89.20647778231529,12,72.40840993249374
ray_2.0.0,python/ray/serve/_private/autoscaling_policy.py,178,61,77,8,25,20,39,33,59,140.0964047443681,6.24,1857.1441389830081,103.17467438794489,297.6192530421487,14,69.04376681368086
ray_2.0.0,python/ray/serve/_private/deployment_graph_build.py,429,126,252,8,27,19,33,35,52,152.38196255841368,4.888888888888889,1303.9777269744536,72.44320705413631,266.72271688113824,21,63.29558376855101
ray_2.0.0,python/ray/serve/_private/client.py,497,238,381,13,67,40,76,80,116,454.5336920965049,7.373134328358209,5407.041306707842,300.3911837059912,733.343659006934,76,36.80189142850582
ray_2.0.0,python/ray/serve/_private/router.py,314,162,223,8,25,14,28,33,42,140.0964047443681,4.48,949.1531974984866,52.73073319436037,211.86455301305503,36,54.97491081508846
ray_2.0.0,python/ray/serve/_private/long_poll.py,354,180,228,9,41,24,46,50,70,248.18895720232226,5.048780487804878,1994.621370483799,110.81229836021106,395.06993328423073,51,52.890044403726606
ray_2.0.0,python/ray/serve/_private/endpoint_state.py,102,59,66,6,14,8,16,20,24,68.81274391313339,3.4285714285714284,355.63294037930297,19.757385576627943,103.72627427729671,19,66.588258279151
ray_2.0.0,python/ray/serve/_private/version.py,43,32,32,6,9,7,12,15,19,44.039100017307746,4.0,296.92368526624745,16.4957602925693,74.23092131656186,10,67.20220340093745
ray_2.0.0,python/ray/serve/_private/deployment_state.py,1870,827,1202,17,210,144,282,227,426,1689.4784270111415,11.414285714285715,38056.48021161655,2114.248900645364,3334.1096555859303,251,5.083741111064063
ray_2.0.0,python/ray/serve/_private/deployment_function_executor_node.py,81,27,54,1,2,1,2,3,3,2.0,0.5,2.3774437510817346,0.1320802083934297,4.754887502163469,8,88.91176733047163
ray_2.0.0,python/ray/serve/_private/replica.py,529,239,382,10,42,24,44,52,68,259.6966127055816,5.238095238095238,2030.4423376997797,112.80235209443221,387.6299008335943,33,48.45168339334261
ray_2.0.0,python/ray/serve/_private/deployment_method_node.py,57,21,48,1,4,2,4,5,6,8.0,0.5,6.965784284662087,0.3869880158145604,13.931568569324174,6,62.339835149806454
ray_2.0.0,python/ray/serve/_private/http_state.py,182,91,140,6,17,11,20,23,31,84.99664330558272,3.5294117647058822,494.93089636859077,27.496160909366154,140.2304206377674,31,54.733682994713945
ray_2.0.0,python/ray/serve/_private/logging_utils.py,84,43,56,2,8,4,8,10,12,26.0,1.0,39.863137138648355,2.2146187299249087,39.863137138648355,10,75.75463813799604
ray_2.0.0,python/ray/serve/_private/json_serde.py,166,65,100,3,12,8,16,15,24,47.77443751081735,2.0,187.53074858920888,10.418374921622716,93.76537429460444,17,73.386652099438
ray_2.0.0,python/ray/serve/_private/api.py,239,76,162,6,10,7,11,16,18,48.72905595320056,3.3,237.6,13.2,72.0,22,69.71064847974672
ray_2.0.0,python/ray/serve/_private/storage/__init__.py,0,0,0,0,0,0,0,0,0,0,0,0,0.0,0,1,100.0
ray_2.0.0,python/ray/serve/_private/storage/kv_store.py,108,52,66,4,11,9,13,15,22,46.053747805010275,2.3636363636363638,203.15831097164298,11.286572831757944,85.95159310338741,17,72.55417479566651
ray_2.0.0,python/ray/serve/_private/storage/kv_store_base.py,56,23,18,0,0,0,0,0,0,0,0,0,0.0,0,5,100.0
ray_2.0.0,python/ray/serve/examples/doc/snippet_logger.py,18,10,10,0,0,0,0,0,0,0,0,0,0.0,0,1,100.0
ray_2.0.0,python/ray/serve/examples/doc/e2e_deployment_full.py,26,15,15,0,0,0,0,0,0,0,0,0,0.0,0,1,100.0
ray_2.0.0,python/ray/serve/examples/doc/e2e_router_client.py,27,4,21,1,2,1,2,3,3,2.0,0.5,2.3774437510817346,0.1320802083934297,4.754887502163469,1,100.0
ray_2.0.0,python/ray/serve/examples/doc/snippet_metrics.py,19,12,12,0,0,0,0,0,0,0,0,0,0.0,0,2,100.0
ray_2.0.0,python/ray/serve/examples/doc/snippet_model_ensemble.py,70,41,44,2,4,2,4,6,6,10.0,1.0,15.509775004326936,0.861654166907052,15.509775004326936,6,80.83281337741617
ray_2.0.0,python/ray/serve/examples/doc/gradio-original.py,25,15,16,0,0,0,0,0,0,0,0,0,0.0,0,1,100.0
ray_2.0.0,python/ray/serve/examples/doc/snippet_reconfigure.py,28,18,16,1,2,1,2,3,3,2.0,0.5,2.3774437510817346,0.1320802083934297,4.754887502163469,4,95.25541294236133
ray_2.0.0,python/ray/serve/examples/doc/tutorial_sklearn.py,96,49,59,0,0,0,0,0,0,0,0,0,0.0,0,3,100.0
ray_2.0.0,python/ray/serve/examples/doc/e2e_local.py,47,10,32,1,2,1,2,3,3,2.0,0.5,2.3774437510817346,0.1320802083934297,4.754887502163469,2,96.02966255306022
ray_2.0.0,python/ray/serve/examples/doc/conda_env.py,22,12,16,1,3,2,4,4,6,4.754887502163469,0.6666666666666666,8.0,0.4444444444444444,12.0,3,68.49882906113262
ray_2.0.0,python/ray/serve/examples/doc/quickstart_function.py,18,10,10,1,2,1,2,3,3,2.0,0.5,2.3774437510817346,0.1320802083934297,4.754887502163469,2,90.9931278514019
ray_2.0.0,python/ray/serve/examples/doc/snippet_custom_metric.py,34,20,23,0,0,0,0,0,0,0,0,0,0.0,0,5,100.0
ray_2.0.0,python/ray/serve/examples/doc/e2e_fastapi_deployment.py,40,28,28,0,0,0,0,0,0,0,0,0,0.0,0,5,100.0
ray_2.0.0,python/ray/serve/examples/doc/snippet_model_composition.py,94,40,38,2,4,2,4,6,6,10.0,1.0,15.509775004326936,0.861654166907052,15.509775004326936,7,81.02691040377715
ray_2.0.0,python/ray/serve/examples/doc/delayed_import.py,14,8,8,0,0,0,0,0,0,0,0,0,0.0,0,2,100.0
ray_2.0.0,python/ray/serve/examples/doc/e2e_deployment.py,40,15,15,0,0,0,0,0,0,0,0,0,0.0,0,1,100.0
ray_2.0.0,python/ray/serve/examples/doc/e2e_fastapi_client.py,29,4,23,1,2,1,2,3,3,2.0,0.5,2.3774437510817346,0.1320802083934297,4.754887502163469,1,100.0
ray_2.0.0,python/ray/serve/examples/doc/e2e_summarizer_client.py,27,4,21,1,2,1,2,3,3,2.0,0.5,2.3774437510817346,0.1320802083934297,4.754887502163469,1,100.0
ray_2.0.0,python/ray/serve/examples/doc/gradio-integration.py,49,12,32,0,0,0,0,0,0,0,0,0,0.0,0,1,100.0
ray_2.0.0,python/ray/serve/examples/doc/deployment_logger.py,25,18,17,1,2,1,2,3,3,2.0,0.5,2.3774437510817346,0.1320802083934297,4.754887502163469,4,67.33817411133128
ray_2.0.0,python/ray/serve/examples/doc/quickstart_class.py,24,17,14,2,6,3,6,8,9,17.509775004326936,1.0,27.0,1.5,27.0,5,83.09364973319943
ray_2.0.0,python/ray/serve/examples/doc/gradio-integration-parallel.py,52,26,28,0,0,0,0,0,0,0,0,0,0.0,0,5,100.0
ray_2.0.0,python/ray/serve/examples/doc/tutorial_batch.py,76,32,32,1,2,1,2,3,3,2.0,0.5,2.3774437510817346,0.1320802083934297,4.754887502163469,5,88.66433574442517
ray_2.0.0,python/ray/serve/examples/doc/tutorial_tensorflow.py,89,39,46,3,5,4,7,8,11,16.36452797660028,2.1,69.3,3.8499999999999996,33.0,4,83.19874591556842
ray_2.0.0,python/ray/serve/examples/doc/e2e_class_deployment.py,24,15,15,0,0,0,0,0,0,0,0,0,0.0,0,3,100.0
ray_2.0.0,python/ray/serve/examples/doc/tutorial_pytorch.py,69,32,45,0,0,0,0,0,0,0,0,0,0.0,0,4,100.0
ray_2.0.0,python/ray/serve/examples/doc/aiohttp/aiohttp_deploy_serve.py,20,10,9,0,0,0,0,0,0,0,0,0,0.0,0,1,100.0
ray_2.0.0,python/ray/serve/examples/doc/aiohttp/aiohttp_app.py,26,12,12,1,2,1,2,3,3,2.0,0.5,2.3774437510817346,0.1320802083934297,4.754887502163469,2,100.0
ray_2.0.0,python/ray/data/dataset_pipeline.py,1196,461,753,16,91,65,124,107,189,656.2093122580814,10.901098901098901,13889.496289520639,771.6386827511466,1274.1372604298167,85,36.83365960981948
ray_2.0.0,python/ray/data/grouped_dataset.py,635,122,189,8,20,11,21,28,32,110.43856189774725,4.2,646.108501524542,35.894916751363446,153.83535750584332,17,46.36056943679055
ray_2.0.0,python/ray/data/random_access_dataset.py,284,187,213,12,72,39,78,84,117,487.2541501125003,6.5,4861.357400023247,270.0754111124026,747.9011384651149,60,41.91624545534512
ray_2.0.0,python/ray/data/row.py,45,20,17,0,0,0,0,0,0,0,0,0,0.0,0,6,100.0
ray_2.0.0,python/ray/data/read_api.py,1179,279,600,15,45,27,52,60,79,305.73674826896314,8.666666666666666,4044.2510944599653,224.68061635888697,466.64435705307295,40,51.570260015487314
ray_2.0.0,python/ray/data/__init__.py,76,14,72,0,0,0,0,0,0,0,0,0,0.0,0,2,100.0
ray_2.0.0,python/ray/data/preprocessor.py,284,129,149,7,30,21,40,37,61,166.8582023226588,4.666666666666667,1482.957724749041,82.38654026383561,317.77665530336594,42,59.882276148672084
ray_2.0.0,python/ray/data/block.py,422,216,242,9,26,17,34,35,51,150.74075768464922,5.884615384615385,1539.3767454315991,85.52093030175551,261.5934338641933,54,52.423716123983226
ray_2.0.0,python/ray/data/aggregate.py,314,130,209,11,55,39,78,66,117,356.02853204886657,7.8,5516.114073326524,306.45078185147355,707.194111964939,20,55.56995692452801
ray_2.0.0,python/ray/data/context.py,205,76,124,3,12,9,18,15,27,47.77443751081735,2.25,237.3436036832175,13.18575576017875,105.48604608143,8,71.58665184212481
ray_2.0.0,python/ray/data/dataset.py,3726,965,1655,19,265,172,329,284,501,2213.9204883598272,11.794339622641509,48156.56356840738,2675.3646426892988,4083.023306871846,258,1.6601196535940341
ray_2.0.0,python/ray/data/tests/test_pipeline_nohang.py,25,15,16,2,7,4,8,9,12,21.651484454403228,1.1428571428571428,43.47325716263743,2.415180953479857,38.03910001730775,4,85.59596034950034
ray_2.0.0,python/ray/data/tests/test_random_access.py,69,54,49,6,35,21,40,41,61,195.03468059740075,3.4285714285714284,1120.4937335372676,62.24965186318153,326.8106722817031,16,56.79564570973804
ray_2.0.0,python/ray/data/tests/test_metadata_provider.py,226,117,196,3,47,25,50,50,75,265.8205635310124,1.5957446808510638,675.4615120741026,37.52563955967237,423.2892142331043,34,41.42105461517297
ray_2.0.0,python/ray/data/tests/test_object_gc.py,174,101,106,5,18,10,20,23,30,86.66829050039843,2.7777777777777777,376.96349633808444,20.942416463226913,135.7068586817104,11,65.7062989108855
ray_2.0.0,python/ray/data/tests/test_raydp_dataset.py,62,1,0,0,0,0,0,0,0,0,0,0,0.0,0,1,100.0
ray_2.0.0,python/ray/data/tests/test_split.py,772,439,586,15,218,139,273,233,412,1752.0675417354976,9.392201834862385,30431.153697458765,1690.6196498588204,3240.044691597563,118,22.366974636305265
ray_2.0.0,python/ray/data/tests/util.py,17,14,14,1,2,1,2,3,3,2.0,0.5,2.3774437510817346,0.1320802083934297,4.754887502163469,2,69.98805349036675
ray_2.0.0,python/ray/data/tests/test_size_estimation.py,264,232,210,6,79,67,116,85,183,513.5084541103181,4.405063291139241,5166.78040983536,287.04335610196443,1172.9185413131995,61,34.08112429512159
ray_2.0.0,python/ray/data/tests/mock_http_server.py,84,67,68,8,22,13,25,30,38,122.10749561002054,4.545454545454546,847.5538301505625,47.08632389725347,186.46184263312372,13,54.84670069359253
ray_2.0.0,python/ray/data/tests/conftest.py,264,146,201,7,32,21,41,39,62,179.65148445440323,4.484375,1469.5069856630446,81.63927698128026,327.6949375694594,3,45.796929523643385
ray_2.0.0,python/ray/data/tests/test_huggingface.py,28,16,18,1,2,1,2,3,3,2.0,0.5,2.3774437510817346,0.1320802083934297,4.754887502163469,7,81.77003452121261
ray_2.0.0,python/ray/data/tests/test_mars.py,56,38,39,4,12,9,18,16,27,51.01955000865388,3.0,324.0,18.0,108.0,5,70.38559366454727
ray_2.0.0,python/ray/data/tests/test_context_propagation.py,112,66,87,2,18,9,18,20,27,77.05865002596161,1.0,116.69205856195879,6.4828921423310435,116.69205856195879,8,51.20138315672829
ray_2.0.0,python/ray/data/tests/mock_server.py,78,50,56,2,3,2,3,5,5,6.754887502163469,1.0,11.60964047443681,0.6449800263576005,11.60964047443681,7,79.69900924429994
ray_2.0.0,python/ray/data/tests/test_dataset.py,4862,3097,3859,19,1303,919,1819,1322,2738,13563.661265999708,13.262087490406754,376497.0130746992,20916.500726372178,28388.970691608058,801,0.0
ray_2.0.0,python/ray/data/tests/test_stats.py,336,119,275,4,30,19,38,34,57,155.20671786825557,2.533333333333333,734.6296342765492,40.81275745980829,289.9853819512694,22,44.64342988873949
ray_2.0.0,python/ray/data/tests/test_auto_parallelism.py,143,57,116,3,25,25,45,28,70,120.85129224653159,2.7,908.5900802688872,50.47722668160484,336.51484454403226,9,64.53858142159027
ray_2.0.0,python/ray/data/tests/test_dataset_pipeline.py,771,515,595,13,238,160,313,251,473,1927.072344003125,8.548319327731093,32231.780821523433,1790.6544900846352,3770.540101018715,135,11.35374195857702
ray_2.0.0,python/ray/data/tests/test_dataset_formats.py,3156,1775,2614,14,541,349,695,555,1044,4965.304236959114,8.992606284658041,85586.7984468813,4754.822135937849,9517.463095531917,408,0.0
ray_2.0.0,python/ray/data/tests/test_partitioning.py,471,227,417,5,101,62,125,106,187,684.0890002323681,3.094059405940594,3892.7015006290785,216.26119447939325,1258.1211250033182,66,29.568921446021246
ray_2.0.0,python/ray/data/tests/test_batcher.py,133,64,79,10,36,24,46,46,70,219.33658100079685,6.388888888888889,2470.2596525699423,137.2366473649968,386.6493369239909,2,68.80824765842715
ray_2.0.0,python/ray/data/tests/test_preprocessors.py,1581,935,1147,8,137,109,178,145,287,996.4303953655922,5.197080291970803,10709.279876569428,594.959993142746,2060.633908834286,103,14.633321387907563
ray_2.0.0,python/ray/data/tests/test_optimize.py,633,385,510,6,117,81,162,123,243,819.3424471955852,4.153846153846154,7007.667333773962,389.3148518763312,1687.0310247974353,72,26.42414259970455
ray_2.0.0,python/ray/data/tests/test_sort.py,470,281,365,16,135,100,194,151,294,1019.3701056018623,11.496296296296297,24465.164605164166,1359.1758113980093,2128.0909933615735,55,32.48690590784154
ray_2.0.0,python/ray/data/datasource/partitioning.py,528,174,209,7,41,25,45,48,70,239.31111664374467,3.841463414634146,1501.810038303677,83.43389101687094,390.947375050481,61,49.46945570499984
ray_2.0.0,python/ray/data/datasource/binary_datasource.py,48,29,28,1,2,1,2,3,3,2.0,0.5,2.3774437510817346,0.1320802083934297,4.754887502163469,7,89.39294542391484
ray_2.0.0,python/ray/data/datasource/json_datasource.py,48,19,29,0,0,0,0,0,0,0,0,0,0.0,0,4,100.0
ray_2.0.0,python/ray/data/datasource/datasource.py,446,199,261,7,47,37,72,54,109,280.71716048325214,5.361702127659575,3363.3031895622594,186.8501771979033,627.2827377358182,42,52.75341967684136
ray_2.0.0,python/ray/data/datasource/parquet_datasource.py,457,209,320,14,53,37,72,67,109,356.88275300065607,9.50943396226415,6287.6731276790215,349.31517375994565,661.2037217598971,50,47.775858768689176
ray_2.0.0,python/ray/data/datasource/__init__.py,75,14,74,0,0,0,0,0,0,0,0,0,0.0,0,1,100.0
ray_2.0.0,python/ray/data/datasource/file_based_datasource.py,715,329,462,12,71,46,83,83,129,479.6515954934863,7.014084507042254,5768.243424628017,320.45796803488986,822.3800866437534,82,40.02172541509604
ray_2.0.0,python/ray/data/datasource/image_folder_datasource.py,170,47,135,7,20,12,24,27,36,106.09004635215048,4.2,718.9389903271166,39.941055018173145,171.1759500778849,13,60.26911943113767
ray_2.0.0,python/ray/data/datasource/parquet_base_datasource.py,49,22,35,0,0,0,0,0,0,0,0,0,0.0,0,5,100.0
ray_2.0.0,python/ray/data/datasource/csv_datasource.py,61,30,42,1,2,1,2,3,3,2.0,0.5,2.3774437510817346,0.1320802083934297,4.754887502163469,7,86.03457672326782
ray_2.0.0,python/ray/data/datasource/tensorflow_datasource.py,73,20,31,1,2,1,2,3,3,2.0,0.5,2.3774437510817346,0.1320802083934297,4.754887502163469,4,91.98233351788379
ray_2.0.0,python/ray/data/datasource/file_meta_provider.py,357,96,192,7,16,10,20,23,30,83.65148445440323,4.375,593.717506732483,32.98430592958239,135.7068586817104,29,67.16029887102627
ray_2.0.0,python/ray/data/datasource/numpy_datasource.py,48,21,27,0,0,0,0,0,0,0,0,0,0.0,0,4,100.0
ray_2.0.0,python/ray/data/datasource/torch_datasource.py,73,23,37,1,2,1,2,3,3,2.0,0.5,2.3774437510817346,0.1320802083934297,4.754887502163469,5,94.06341542397048
ray_2.0.0,python/ray/data/extensions/tensor_extension.py,9,2,9,0,0,0,0,0,0,0,0,0,0.0,0,1,100.0
ray_2.0.0,python/ray/data/extensions/__init__.py,16,2,15,0,0,0,0,0,0,0,0,0,0.0,0,1,100.0
ray_2.0.0,python/ray/data/preprocessors/utils.py,15,11,9,1,2,1,2,3,3,2.0,0.5,2.3774437510817346,0.1320802083934297,4.754887502163469,1,72.40724958418757
ray_2.0.0,python/ray/data/preprocessors/transformer.py,86,38,66,9,25,26,44,34,70,144.62572975734892,7.92,2820.4893991891886,156.69385551051047,356.1223988875238,5,59.50095111296194
ray_2.0.0,python/ray/data/preprocessors/tokenizer.py,72,19,24,1,2,1,2,3,3,2.0,0.5,2.3774437510817346,0.1320802083934297,4.754887502163469,5,85.79224559556481
ray_2.0.0,python/ray/data/preprocessors/normalizer.py,104,23,28,1,2,1,2,3,3,2.0,0.5,2.3774437510817346,0.1320802083934297,4.754887502163469,5,75.52751527802683
ray_2.0.0,python/ray/data/preprocessors/encoder.py,591,173,316,8,17,11,19,25,30,93.48686830125578,4.470588235294118,622.8230654521395,34.60128141400775,139.31568569324173,53,58.217405019357365
ray_2.0.0,python/ray/data/preprocessors/batch_mapper.py,54,14,13,0,0,0,0,0,0,0,0,0,0.0,0,5,100.0
ray_2.0.0,python/ray/data/preprocessors/__init__.py,44,12,43,0,0,0,0,0,0,0,0,0,0.0,0,1,100.0
ray_2.0.0,python/ray/data/preprocessors/scaler.py,370,108,114,4,25,15,30,29,45,124.09640474436812,2.4,524.6619474737778,29.147885970765433,218.60914478074076,24,52.991112225881956
ray_2.0.0,python/ray/data/preprocessors/chain.py,97,52,53,5,12,12,21,17,33,54.62919048309069,4.375,590.1274477055177,32.78485820586209,134.8862737612612,22,73.93097502416308
ray_2.0.0,python/ray/data/preprocessors/concatenator.py,173,44,143,5,15,8,16,20,24,70.2129994085646,2.6666666666666665,276.6033980727912,15.366855448488401,103.72627427729671,17,57.6794346071598
ray_2.0.0,python/ray/data/preprocessors/hasher.py,105,26,76,1,2,1,2,3,3,2.0,0.5,2.3774437510817346,0.1320802083934297,4.754887502163469,4,78.6733873671205
ray_2.0.0,python/ray/data/preprocessors/imputer.py,156,55,126,4,14,9,18,18,27,61.30296890880645,2.5714285714285716,289.5119358144234,16.083996434134633,112.58797503894243,22,52.259001721380976
ray_2.0.0,python/ray/data/preprocessors/vectorizer.py,264,65,203,1,2,2,4,3,6,2.0,1.0,9.509775004326938,0.5283208335737188,9.509775004326938,20,63.89212852022874
ray_2.0.0,python/ray/data/examples/repeat.py,12,7,7,1,2,1,2,3,3,2.0,0.5,2.3774437510817346,0.1320802083934297,4.754887502163469,1,76.68921391438496
ray_2.0.0,python/ray/data/examples/demo_map.py,14,8,8,0,0,0,0,0,0,0,0,0,0.0,0,1,100.0
ray_2.0.0,python/ray/data/examples/demo_shuffle.py,6,4,4,0,0,0,0,0,0,0,0,0,0.0,0,1,100.0
ray_2.0.0,python/ray/data/examples/per_epoch_shuffle.py,32,22,25,2,4,2,4,6,6,10.0,1.0,15.509775004326936,0.861654166907052,15.509775004326936,2,62.110798718429756
ray_2.0.0,python/ray/data/examples/demo_infer.py,29,15,19,0,0,0,0,0,0,0,0,0,0.0,0,3,100.0
ray_2.0.0,python/ray/data/_internal/shuffle.py,132,55,85,5,10,8,14,15,22,44.82892142331043,3.5,300.83057586185595,16.712809770103107,85.95159310338741,17,72.84654694412461
ray_2.0.0,python/ray/data/_internal/delegating_block_builder.py,72,54,53,4,15,8,16,19,24,66.60335893412778,2.1333333333333333,217.49388868831156,12.082993816017309,101.95026032264605,20,65.45268274505304
ray_2.0.0,python/ray/data/_internal/arrow_serialization.py,29,14,23,1,2,1,2,3,3,2.0,0.5,2.3774437510817346,0.1320802083934297,4.754887502163469,3,69.85355056639015
ray_2.0.0,python/ray/data/_internal/batcher.py,293,139,132,13,56,41,80,69,121,373.31759197106004,9.285714285714286,6863.363550365759,381.29797502031994,739.1314592701585,45,55.236008812021865
ray_2.0.0,python/ray/data/_internal/torch_iterable_dataset.py,10,7,7,0,0,0,0,0,0,0,0,0,0.0,0,3,100.0
ray_2.0.0,python/ray/data/_internal/sort.py,158,75,103,7,19,11,22,26,33,100.36210720983135,4.052631578947368,628.6219644103429,34.92344246724127,155.11451069865606,18,67.13058737602839
ray_2.0.0,python/ray/data/_internal/push_based_shuffle.py,681,340,491,16,101,82,154,117,236,736.4793597579313,12.198019801980198,19777.943395527862,1098.7746330848813,1621.4060738216835,85,34.23406341648382
ray_2.0.0,python/ray/data/_internal/compute.py,455,223,369,13,69,48,93,82,141,469.59390385352793,8.76086956521739,7853.3734251829,436.29852362127224,896.4148326511499,65,37.598664901093485
ray_2.0.0,python/ray/data/_internal/split.py,305,153,195,10,51,32,63,61,95,322.5129733894199,6.176470588235294,3479.9473495405764,193.3304083078098,563.4200470684742,23,56.99860786073687
ray_2.0.0,python/ray/data/_internal/simple_block.py,448,266,338,13,86,58,108,99,166,600.7644852402146,8.162790697674419,8982.932391292059,499.0517995162255,1100.4731989332151,95,33.2659498411078
ray_2.0.0,python/ray/data/_internal/remote_fn.py,26,12,15,1,2,1,2,3,3,2.0,0.5,2.3774437510817346,0.1320802083934297,4.754887502163469,2,98.66180656161315
ray_2.0.0,python/ray/data/_internal/stage_impl.py,196,120,153,5,11,7,13,16,20,49.663388279447084,2.9545454545454546,236.36363636363637,13.131313131313131,80.0,10,50.67264159327229
ray_2.0.0,python/ray/data/_internal/stats.py,451,281,339,17,135,102,204,152,306,1024.8569739031182,12.844444444444445,28487.254298838674,1582.6252388243709,2217.8658191137374,90,30.535226469449363
ray_2.0.0,python/ray/data/_internal/progress_bar.py,105,73,71,6,14,8,14,20,22,68.81274391313339,3.0,285.2472542625659,15.847069681253661,95.08241808752197,25,63.43069706506966
ray_2.0.0,python/ray/data/_internal/__init__.py,0,0,0,0,0,0,0,0,0,0,0,0,0.0,0,1,100.0
ray_2.0.0,python/ray/data/_internal/util.py,183,79,106,11,28,17,32,39,49,172.65968562262316,6.285714285714286,1627.9038834095727,90.43910463386516,258.9847087242502,20,67.72520794468952
ray_2.0.0,python/ray/data/_internal/equalize.py,158,77,99,5,14,11,22,19,33,64.91260938324326,3.9285714285714284,550.713459778579,30.595192209921056,140.1816079436383,20,69.02552860559544
ray_2.0.0,python/ray/data/_internal/output_buffer.py,80,43,40,4,15,10,15,19,25,66.60335893412778,2.0,212.39637567217926,11.799798648454404,106.19818783608963,17,77.06344292087631
ray_2.0.0,python/ray/data/_internal/block_batching.py,236,107,135,7,22,14,28,29,42,117.75898006442377,4.454545454545454,908.8840807247767,50.49356004026537,204.03520179535806,21,65.45077251875233
ray_2.0.0,python/ray/data/_internal/plan.py,926,450,623,13,167,115,208,180,323,1281.184333179001,8.095808383233534,19590.792094340024,1088.3773385744457,2419.868550114485,155,23.61638221000165
ray_2.0.0,python/ray/data/_internal/shuffle_and_partition.py,105,56,83,6,16,10,20,22,30,79.50977500432694,3.75,501.68605709669595,27.87144761648311,133.78294855911892,16,61.37618073022998
ray_2.0.0,python/ray/data/_internal/table_block.py,196,135,148,10,38,22,40,48,62,232.64052645972987,5.2631578947368425,1822.4614476037461,101.24785820020811,346.2676750447117,42,45.751825425847564
ray_2.0.0,python/ray/data/_internal/null_aggregate.py,277,96,102,6,22,16,26,28,42,113.61727061434748,3.5454545454545454,715.8588511209414,39.76993617338563,201.90890672641936,8,62.67918221354548
ray_2.0.0,python/ray/data/_internal/pandas_block.py,547,335,401,14,87,57,105,101,162,613.8390530476458,8.448275862068966,9112.56599139375,506.25366618854173,1078.6302602057908,105,30.964284178062925
ray_2.0.0,python/ray/data/_internal/arrow_block.py,605,355,442,13,85,57,106,98,163,592.903945907539,8.105882352941176,8739.743746624079,485.5413192568933,1078.197704590779,112,28.93522221934667
ray_2.0.0,python/ray/data/_internal/block_list.py,238,126,145,10,25,16,30,35,46,149.31568569324173,6.0,1415.682112676811,78.64900625982283,235.94701877946846,34,60.54214408598844
ray_2.0.0,python/ray/data/_internal/fast_repartition.py,82,49,65,6,17,11,22,23,33,84.99664330558272,3.8823529411764706,579.5481141348338,32.19711745193521,149.27754454988144,10,64.94814936725389
ray_2.0.0,python/ray/data/_internal/pipeline_executor.py,190,114,136,14,44,30,55,58,85,293.5179601288475,8.75,4356.873365126132,242.0485202847851,497.9283845858436,46,51.32107177235238
ray_2.0.0,python/ray/data/_internal/lazy_block_list.py,586,280,417,13,66,45,80,79,125,447.0357282134921,7.878787878787879,6208.268918659269,344.9038288144038,787.9725935221379,78,40.83372312905197
ray_2.0.0,python/ray/data/_internal/block_builder.py,31,22,16,0,0,0,0,0,0,0,0,0,0.0,0,7,100.0
ray_2.0.0,python/ray/data/_internal/size_estimator.py,78,50,53,7,19,15,29,26,44,100.36210720983135,5.342105263157895,1104.8507253272694,61.38059585151497,206.81934759820808,17,66.48007783709699
ray_2.0.0,python/ray/data/_internal/arrow_ops/transform_polars.py,40,25,30,0,0,0,0,0,0,0,0,0,0.0,0,5,100.0
ray_2.0.0,python/ray/data/_internal/arrow_ops/__init__.py,0,0,0,0,0,0,0,0,0,0,0,0,0.0,0,1,100.0
ray_2.0.0,python/ray/data/_internal/arrow_ops/transform_pyarrow.py,75,38,42,2,3,2,3,5,5,6.754887502163469,1.0,11.60964047443681,0.6449800263576005,11.60964047443681,10,84.7407978310393
ray_2.0.0,python/ray/job_submission/__init__.py,4,3,3,0,0,0,0,0,0,0,0,0,0.0,0,1,100.0
ray_2.0.0,python/ray/tune/config_parser.py,4,3,3,0,0,0,0,0,0,0,0,0,0.0,0,1,100.0
ray_2.0.0,python/ray/tune/trial_runner.py,4,3,3,0,0,0,0,0,0,0,0,0,0.0,0,1,100.0
ray_2.0.0,python/ray/tune/trial.py,4,3,3,0,0,0,0,0,0,0,0,0,0.0,0,1,100.0
ray_2.0.0,python/ray/tune/tuner.py,252,62,102,1,3,4,4,4,8,4.754887502163469,0.6666666666666666,10.666666666666666,0.5925925925925926,16.0,12,73.99266106186599
ray_2.0.0,python/ray/tune/sample.py,7,4,4,0,0,0,0,0,0,0,0,0,0.0,0,1,100.0
ray_2.0.0,python/ray/tune/error.py,48,23,17,0,0,0,0,0,0,0,0,0,0.0,0,3,100.0
ray_2.0.0,python/ray/tune/result.py,150,36,74,1,3,1,3,4,4,4.754887502163469,0.5,4.0,0.2222222222222222,8.0,3,88.56257044547998
ray_2.0.0,python/ray/tune/__init__.py,94,23,91,0,0,0,0,0,0,0,0,0,0.0,0,1,100.0
ray_2.0.0,python/ray/tune/registry.py,242,130,153,8,36,21,36,44,57,210.11730005192322,4.0,1244.7504090493037,69.1528005027391,311.1876022623259,34,56.31924045737838
ray_2.0.0,python/ray/tune/syncer.py,571,271,361,9,47,29,49,56,78,289.59500104182973,4.691489361702128,2125.1212192440157,118.06228995800087,452.97368392049316,86,42.31176981105682
ray_2.0.0,python/ray/tune/session.py,4,3,3,0,0,0,0,0,0,0,0,0,0.0,0,1,100.0
ray_2.0.0,python/ray/tune/result_grid.py,217,65,119,5,21,14,23,26,37,103.84830635279079,2.738095238095238,476.1993095402464,26.455517196680358,173.91626957122043,32,69.55741399152325
ray_2.0.0,python/ray/tune/tune.py,888,269,542,12,87,65,108,99,173,603.5556341474933,7.448275862068965,8542.268902728787,474.5704945960437,1146.8786952737723,98,41.20172910549567
ray_2.0.0,python/ray/tune/ray_trial_executor.py,4,3,3,0,0,0,0,0,0,0,0,0,0.0,0,1,100.0
ray_2.0.0,python/ray/tune/function_runner.py,11,3,10,0,0,0,0,0,0,0,0,0,0.0,0,1,100.0
ray_2.0.0,python/ray/tune/sync_client.py,44,21,32,0,0,0,0,0,0,0,0,0,0.0,0,5,100.0
ray_2.0.0,python/ray/tune/checkpoint_manager.py,4,3,3,0,0,0,0,0,0,0,0,0,0.0,0,1,100.0
ray_2.0.0,python/ray/tune/callback.py,345,112,154,5,11,6,11,16,17,49.663388279447084,2.5,170.0,9.444444444444445,68.0,52,63.626158774419736
ray_2.0.0,python/ray/tune/tune_config.py,61,26,17,0,0,0,0,0,0,0,0,0,0.0,0,1,100.0
ray_2.0.0,python/ray/tune/cluster_info.py,4,3,3,0,0,0,0,0,0,0,0,0,0.0,0,1,100.0
ray_2.0.0,python/ray/tune/resources.py,278,103,226,12,67,44,87,79,131,449.4475257693246,7.791044776119403,6433.807986893234,357.4337770496241,825.7952780112005,37,48.96876505542761
ray_2.0.0,python/ray/tune/sklearn.py,19,12,15,0,0,0,0,0,0,0,0,0,0.0,0,2,100.0
ray_2.0.0,python/ray/tune/_structure_refactor.py,29,13,23,1,3,2,4,4,6,4.754887502163469,0.6666666666666666,8.0,0.4444444444444444,12.0,3,67.74052972527807
ray_2.0.0,python/ray/tune/progress_reporter.py,1244,484,801,20,211,144,272,231,416,1715.5904907149634,12.890995260663507,42106.21362721847,2339.234090401026,3266.32760122908,177,20.39708190530534
ray_2.0.0,python/ray/tune/insufficient_resources_manager.py,4,3,3,0,0,0,0,0,0,0,0,0,0.0,0,1,100.0
ray_2.0.0,python/ray/tune/web_server.py,258,183,173,5,11,8,12,16,20,49.663388279447084,2.727272727272727,218.18181818181816,12.12121212121212,80.0,20,54.324036476669065
ray_2.0.0,python/ray/tune/automl/__init__.py,12,4,11,0,0,0,0,0,0,0,0,0,0.0,0,1,100.0
ray_2.0.0,python/ray/tune/automl/search_space.py,175,83,63,2,9,5,10,11,15,30.529325012980813,1.1111111111111112,57.65719364395497,3.203177424664165,51.89147427955947,23,68.44332642756959
ray_2.0.0,python/ray/tune/automl/genetic_searcher.py,276,104,130,5,27,15,30,32,45,139.9916030328505,2.7777777777777777,625.0,34.72222222222222,225.0,21,64.78645849297035
ray_2.0.0,python/ray/tune/automl/search_policy.py,260,146,163,11,44,28,50,55,78,278.26873902505133,6.25,2818.412860343272,156.57849224129288,450.9460576549235,39,54.52515106912279
ray_2.0.0,python/ray/tune/automl/board/manage.py,8,6,6,1,2,1,2,3,3,2.0,0.5,2.3774437510817346,0.1320802083934297,4.754887502163469,2,99.90348152172656
ray_2.0.0,python/ray/tune/automl/board/__init__.py,0,0,0,0,0,0,0,0,0,0,0,0,0.0,0,1,100.0
ray_2.0.0,python/ray/tune/automl/board/settings.py,143,36,89,2,8,6,11,10,17,26.0,1.375,77.6500692179921,4.313892734332894,56.472777613085164,2,78.58573538010185
ray_2.0.0,python/ray/tune/automl/board/run.py,121,53,89,2,7,4,8,9,12,21.651484454403228,1.1428571428571428,43.47325716263743,2.415180953479857,38.03910001730775,4,72.19865177724681
ray_2.0.0,python/ray/tune/automl/board/models/__init__.py,1,1,1,0,0,0,0,0,0,0,0,0,0.0,0,1,100.0
ray_2.0.0,python/ray/tune/automl/board/models/apps.py,7,4,3,0,0,0,0,0,0,0,0,0,0.0,0,1,100.0
ray_2.0.0,python/ray/tune/automl/board/models/models.py,96,56,76,2,4,4,8,6,12,10.0,2.0,62.039100017307746,3.446616667628208,31.019550008653873,8,50.344614517016666
ray_2.0.0,python/ray/tune/automl/board/backend/collector.py,375,174,207,5,28,24,33,33,57,146.2155782920497,2.9464285714285716,847.1879766529689,47.06599870294272,287.53046480343187,37,57.51680430670798
ray_2.0.0,python/ray/tune/automl/board/backend/__init__.py,0,0,0,0,0,0,0,0,0,0,0,0,0.0,0,1,100.0
ray_2.0.0,python/ray/tune/automl/board/common/utils.py,108,62,57,5,9,6,9,14,15,40.13896548741762,2.5,142.77580957716015,7.931989420953341,57.110323830864054,16,75.25979774174426
ray_2.0.0,python/ray/tune/automl/board/common/__init__.py,0,0,0,0,0,0,0,0,0,0,0,0,0.0,0,1,100.0
ray_2.0.0,python/ray/tune/automl/board/common/exception.py,10,6,4,0,0,0,0,0,0,0,0,0,0.0,0,1,100.0
ray_2.0.0,python/ray/tune/automl/board/frontend/wsgi.py,15,5,4,0,0,0,0,0,0,0,0,0,0.0,0,1,100.0
ray_2.0.0,python/ray/tune/automl/board/frontend/__init__.py,0,0,0,0,0,0,0,0,0,0,0,0,0.0,0,1,100.0
ray_2.0.0,python/ray/tune/automl/board/frontend/view.py,172,97,136,8,33,20,39,41,59,190.46500593882897,4.7272727272727275,1494.2699591062076,83.01499772812264,316.09556827246695,22,47.51163106380423
ray_2.0.0,python/ray/tune/automl/board/frontend/urls.py,34,6,12,0,0,0,0,0,0,0,0,0,0.0,0,1,100.0
ray_2.0.0,python/ray/tune/automl/board/frontend/query.py,103,37,53,4,16,10,20,20,30,72.0,2.5,324.14460711655215,18.00803372869734,129.65784284662087,7,79.18044371817808
ray_2.0.0,python/ray/tune/logger/noop.py,8,6,6,0,0,0,0,0,0,0,0,0,0.0,0,2,100.0
ray_2.0.0,python/ray/tune/logger/tensorboardx.py,287,162,220,9,63,35,68,72,103,405.09796019347556,4.857142857142857,3086.725336435854,171.484740913103,635.5022751485582,75,39.55269747533702
ray_2.0.0,python/ray/tune/logger/__init__.py,29,8,26,0,0,0,0,0,0,0,0,0,0.0,0,1,100.0
ray_2.0.0,python/ray/tune/logger/logger.py,226,111,115,4,14,7,14,18,21,61.30296890880645,2.0,175.1368500605771,9.729825003365395,87.56842503028855,39,65.38431483680174
ray_2.0.0,python/ray/tune/logger/unified.py,72,41,51,2,4,2,4,6,6,10.0,1.0,15.509775004326936,0.861654166907052,15.509775004326936,18,75.45290538160087
ray_2.0.0,python/ray/tune/logger/csv.py,123,80,82,6,29,17,29,35,46,156.39122386302654,3.0,707.8410563384055,39.32450312991141,235.94701877946846,29,58.79634593280524
ray_2.0.0,python/ray/tune/logger/json.py,121,75,81,3,7,4,7,10,11,24.406371956566698,1.5,54.81181356564148,3.0451007536467487,36.541209043760986,17,67.44740690521186
ray_2.0.0,python/ray/tune/tests/test_trainable_util.py,258,173,207,2,28,16,32,30,48,136.6059378176129,1.1428571428571428,269.1779983876673,14.954333243759294,235.53074858920888,44,28.652105563591963
ray_2.0.0,python/ray/tune/tests/test_integration_pytorch_lightning.py,168,94,129,3,12,6,12,15,18,47.77443751081735,1.5,105.48604608143,5.860335893412778,70.32403072095333,26,47.98829742168059
ray_2.0.0,python/ray/tune/tests/test_legacy_import.py,97,21,80,1,2,1,2,3,3,2.0,0.5,2.3774437510817346,0.1320802083934297,4.754887502163469,2,84.87144267595721
ray_2.0.0,python/ray/tune/tests/test_dependency.py,19,12,11,2,5,3,6,7,9,13.60964047443681,1.2,30.319433158222125,1.6844129532345624,25.26619429851844,4,83.202467683331
ray_2.0.0,python/ray/tune/tests/_test_cluster_interrupt_searcher.py,57,24,54,2,3,2,3,5,5,6.754887502163469,1.0,11.60964047443681,0.6449800263576005,11.60964047443681,2,73.52065391870647
ray_2.0.0,python/ray/tune/tests/ext_pytorch.py,473,134,169,9,45,31,61,54,92,275.6627143478162,6.1,3229.642866214139,179.42460367856327,529.4496501990392,14,49.426828039543096
ray_2.0.0,python/ray/tune/tests/test_syncer_callback.py,403,215,269,4,12,9,13,16,22,51.01955000865388,2.1666666666666665,190.66666666666666,10.592592592592592,88.0,34,45.483375223366174
ray_2.0.0,python/ray/tune/tests/test_util_file_transfer.py,227,114,163,4,10,9,17,14,26,41.219280948873624,3.4,336.57017510989215,18.698343061660676,98.9912279734977,15,52.09598485240437
ray_2.0.0,python/ray/tune/tests/test_commands.py,167,103,138,7,55,31,62,62,93,337.6262686982595,3.9454545454545453,2184.757013453046,121.37538963628033,553.7402568659794,20,41.41173863589283
ray_2.0.0,python/ray/tune/tests/test_trial_runner.py,292,195,233,4,24,17,25,28,42,118.03910001730776,2.0833333333333335,420.6435556800404,23.36908642666891,201.90890672641936,35,39.47412018924
ray_2.0.0,python/ray/tune/tests/test_function_api.py,599,453,471,10,75,53,100,85,153,500.38068273606467,6.666666666666667,6537.578754860457,363.19881971446983,980.6368132290685,72,20.92458214988577
ray_2.0.0,python/ray/tune/tests/test_cluster_searcher.py,130,75,94,8,21,12,23,29,35,116.23866587835397,4.380952380952381,744.8904192528946,41.38280106960526,170.02933482946506,17,62.16120657886135
ray_2.0.0,python/ray/tune/tests/test_result_grid.py,289,228,216,8,63,36,71,71,107,400.56863518049477,4.507936507936508,2966.325642341401,164.79586901896673,658.022941787001,52,33.83841096165896
ray_2.0.0,python/ray/tune/tests/test_searchers.py,777,369,583,6,21,15,26,27,41,107.74844088268091,3.7142857142857144,724.1014396151797,40.227857756398876,194.95038758870223,57,33.945766914673605
ray_2.0.0,python/ray/tune/tests/test_resource_updater.py,43,28,28,1,17,11,22,18,33,69.48686830125578,0.6470588235294118,89.04016326609174,4.946675737005097,137.6075250475963,12,74.29718929543465
ray_2.0.0,python/ray/tune/tests/test_trial_runner_2.py,410,266,316,3,16,13,16,19,29,68.75488750216347,1.5,184.78484683479596,10.265824824155331,123.18989788986397,28,45.61240607599857
ray_2.0.0,python/ray/tune/tests/test_trainable.py,194,116,114,4,22,16,32,26,48,106.10749561002054,2.909090909090909,656.3523097331562,36.46401720739757,225.62110647077245,21,59.78810995467318
ray_2.0.0,python/ray/tune/tests/test_progress_reporter.py,745,379,619,11,82,67,133,93,200,559.3730121836933,8.920731707317072,11666.816269086647,648.1564593937026,1307.8317622216064,63,26.33418915553477
ray_2.0.0,python/ray/tune/tests/__init__.py,0,0,0,0,0,0,0,0,0,0,0,0,0.0,0,1,100.0
ray_2.0.0,python/ray/tune/tests/test_tune_server.py,162,119,139,2,10,6,12,12,18,35.219280948873624,1.2,77.43519001557698,4.301955000865387,64.52932501298082,29,38.15156526199347
ray_2.0.0,python/ray/tune/tests/test_trial_runner_pg.py,304,160,198,8,38,21,39,46,60,223.42124551085624,4.105263157894737,1360.5405239129907,75.58558466183281,331.4137173634208,22,55.170165395320666
ray_2.0.0,python/ray/tune/tests/test_logger.py,271,187,216,6,21,12,24,27,36,107.74844088268091,3.4285714285714284,586.8889716956053,32.60494287197807,171.1759500778849,40,41.425246205487774
ray_2.0.0,python/ray/tune/tests/test_integration_wandb.py,429,246,308,2,18,9,18,20,27,77.05865002596161,1.0,116.69205856195879,6.4828921423310435,116.69205856195879,26,48.45084902213318
ray_2.0.0,python/ray/tune/tests/conftest.py,2,1,1,0,0,0,0,0,0,0,0,0,0.0,0,1,100.0
ray_2.0.0,python/ray/tune/tests/test_sample.py,2023,1029,1600,14,231,192,304,245,496,1867.0569974759155,9.212121212121213,36264.182272562546,2014.6767929201415,3936.5724177452757,157,0.8354832821169361
ray_2.0.0,python/ray/tune/tests/test_api.py,1909,1101,1491,16,153,98,183,169,281,1174.3803399319759,9.568627450980392,19899.368536049085,1105.520474224949,2079.647121595294,147,4.3742327715203215
ray_2.0.0,python/ray/tune/tests/test_function_api_legacy.py,31,20,23,3,6,3,6,9,9,20.264662506490406,1.5,42.793987519471216,2.377443751081734,28.529325012980813,6,60.622390723236144
ray_2.0.0,python/ray/tune/tests/test_automl_searcher.py,89,61,72,6,13,9,15,19,24,63.61549134016113,3.4615384615384617,352.90474727069784,19.60581929281655,101.95026032264605,11,45.51258546084419
ray_2.0.0,python/ray/tune/tests/test_trial_relative_logdir.py,257,148,159,3,23,13,26,26,39,108.79681249147477,1.6956521739130435,310.84212223011315,17.269006790561843,183.31714900750262,29,59.158904647018616
ray_2.0.0,python/ray/tune/tests/test_experiment.py,84,56,59,3,5,3,6,8,9,16.36452797660028,1.8,48.6,2.7,27.0,12,66.81591028786782
ray_2.0.0,python/ray/tune/tests/test_trial_scheduler.py,2331,1404,1907,15,159,157,249,174,406,1221.3517488243403,11.745283018867925,35492.308007987325,1971.7948893326293,3021.8350593145838,238,0.0
ray_2.0.0,python/ray/tune/tests/test_multinode_sync.py,351,155,246,9,34,20,40,43,60,201.50306161549238,5.294117647058823,1723.6370397289015,95.7576133182723,325.57588528212585,17,56.47290431145445
ray_2.0.0,python/ray/tune/tests/test_var.py,367,170,338,10,39,26,47,49,73,239.34996748450132,6.0256410256410255,2469.752496815292,137.208472045294,409.8738186204102,27,32.708208592138924
ray_2.0.0,python/ray/tune/tests/test_ray_trial_executor.py,568,342,424,7,39,25,44,46,69,225.78217099003092,3.948717948717949,1504.9581883349185,83.6087882408288,381.1257749679339,58,35.24612212380185
ray_2.0.0,python/ray/tune/tests/test_client.py,100,62,62,1,2,1,2,3,3,2.0,0.5,2.3774437510817346,0.1320802083934297,4.754887502163469,11,54.67995507050517
ray_2.0.0,python/ray/tune/tests/test_stopper.py,63,44,41,3,11,9,11,14,20,42.808635307173745,1.5,114.22064766172812,6.345591536762673,76.14709844115208,14,68.45067331313533
ray_2.0.0,python/ray/tune/tests/test_checkpoint_manager.py,286,127,228,4,11,7,12,15,19,46.053747805010275,2.1818181818181817,161.9583737815895,8.997687432310528,74.23092131656186,32,55.23062069646237
ray_2.0.0,python/ray/tune/tests/test_tuner.py,325,149,267,2,18,9,18,20,27,77.05865002596161,1.0,116.69205856195879,6.4828921423310435,116.69205856195879,20,48.7895366497692
ray_2.0.0,python/ray/tune/tests/test_integration_mlflow.py,235,132,176,2,7,4,8,9,12,21.651484454403228,1.1428571428571428,43.47325716263743,2.415180953479857,38.03910001730775,13,60.48403455879159
ray_2.0.0,python/ray/tune/tests/test_integration_comet.py,364,220,250,2,6,4,6,8,10,17.509775004326936,1.0,30.0,1.6666666666666667,30.0,41,53.51085141109173
ray_2.0.0,python/ray/tune/tests/test_trial_scheduler_pbt.py,533,273,422,13,51,36,68,64,104,337.3994087763805,8.666666666666666,5408.0,300.44444444444446,624.0,26,37.11191860253281
ray_2.0.0,python/ray/tune/tests/test_trial_runner_3.py,1131,810,898,14,135,112,199,149,311,1008.6730745106687,10.318518518518518,23166.739584742067,1287.041088041226,2245.1614098637324,135,10.610806525451796
ray_2.0.0,python/ray/tune/tests/test_remote.py,128,90,105,2,4,3,4,6,7,10.0,1.0,18.094737505048094,1.0052631947248942,18.094737505048094,14,52.55426738067931
ray_2.0.0,python/ray/tune/tests/test_soft_imports.py,25,16,15,3,6,3,6,9,9,20.264662506490406,1.5,42.793987519471216,2.377443751081734,28.529325012980813,6,82.8084514846172
ray_2.0.0,python/ray/tune/tests/tune_test_util.py,51,33,32,2,4,2,4,6,6,10.0,1.0,15.509775004326936,0.861654166907052,15.509775004326936,7,74.92826767186922
ray_2.0.0,python/ray/tune/tests/test_actor_reuse.py,200,119,158,5,10,7,12,15,19,44.82892142331043,3.0,222.69276394968557,12.371820219426976,74.23092131656186,23,50.88484994913344
ray_2.0.0,python/ray/tune/tests/test_utils.py,45,14,36,1,2,1,2,3,3,2.0,0.5,2.3774437510817346,0.1320802083934297,4.754887502163469,3,86.31907411363308
ray_2.0.0,python/ray/tune/tests/test_trial_scheduler_resource_changing.py,645,375,502,4,76,61,122,80,183,482.84249102171253,3.210526315789474,3714.2991222751384,206.3499512375077,1156.9128413643873,56,14.868739378264662
ray_2.0.0,python/ray/tune/tests/test_experiment_analysis_mem.py,249,143,209,5,16,12,18,21,30,75.60964047443682,2.8125,370.60178254695796,20.588987919275443,131.76952268336282,23,35.047037624286396
ray_2.0.0,python/ray/tune/tests/test_tuner_restore.py,354,165,250,8,88,58,116,96,174,592.4299824400822,5.2727272727272725,6041.403777934354,335.63354321857526,1145.7834751254811,45,44.38695185162104
ray_2.0.0,python/ray/tune/tests/test_syncer.py,479,257,327,4,12,8,12,16,20,51.01955000865388,2.0,160.0,8.88888888888889,80.0,31,42.0905229853104
ray_2.0.0,python/ray/tune/tests/test_trial_runner_callbacks.py,325,195,250,8,24,13,24,32,37,134.03910001730776,4.0,740.0,41.111111111111114,185.0,28,47.59523932908292
ray_2.0.0,python/ray/tune/tests/tutorial.py,214,95,127,8,26,17,31,34,48,146.2114326716684,4.769230769230769,1164.6376473508471,64.7020915194915,244.19821638001633,16,66.05769368504141
ray_2.0.0,python/ray/tune/tests/test_run_experiment.py,244,160,201,2,4,2,4,6,6,10.0,1.0,15.509775004326936,0.861654166907052,15.509775004326936,22,44.88199258979587
ray_2.0.0,python/ray/tune/tests/test_convergence.py,177,105,121,3,16,8,16,19,24,68.75488750216347,1.5,152.92539048396907,8.49585502688717,101.95026032264605,33,51.38525174838736
ray_2.0.0,python/ray/tune/tests/test_warnings.py,143,93,102,2,8,4,8,10,12,26.0,1.0,39.863137138648355,2.2146187299249087,39.863137138648355,2,53.948707615122366
ray_2.0.0,python/ray/tune/tests/test_tune_restore.py,593,301,449,7,49,42,70,56,112,294.7722668160484,5.0,3252.1187563522585,180.67326424179214,650.4237512704517,58,35.92424075219856
ray_2.0.0,python/ray/tune/tests/test_tune_save_restore.py,185,118,146,4,16,8,16,20,24,72.0,2.0,207.45254855459342,11.525141586366301,103.72627427729671,16,50.460983852480084
ray_2.0.0,python/ray/tune/tests/test_experiment_analysis.py,430,256,348,6,87,49,97,93,146,576.0458591431664,3.3448275862068964,3193.364382169377,177.4091323427432,954.7171864217727,58,27.27019106033336
ray_2.0.0,python/ray/tune/tests/example.py,62,22,28,5,16,9,17,21,26,75.60964047443682,2.65625,303.34442201065815,16.85246788948101,114.20025299224778,2,84.8047292658873
ray_2.0.0,python/ray/tune/tests/test_tune_restore_warm_start.py,485,244,387,7,98,87,146,105,233,667.8930491776937,5.214285714285714,8157.328714998791,453.1849286110439,1564.4192056162065,46,29.375621323695505
ray_2.0.0,python/ray/tune/tests/test_cluster.py,592,341,432,8,79,54,96,87,150,521.9986791059912,4.860759493670886,4697.6398146947695,260.979989705265,966.4415243773093,66,34.95906116987501
ray_2.0.0,python/ray/tune/cli/__init__.py,0,0,0,0,0,0,0,0,0,0,0,0,0.0,0,1,100.0
ray_2.0.0,python/ray/tune/cli/commands.py,309,175,213,8,40,26,46,48,72,236.8771237954945,4.6,1849.7395802388469,102.76331001326928,402.1173000519233,49,49.50929671721762
ray_2.0.0,python/ray/tune/cli/scripts.py,100,50,83,1,2,1,2,3,3,2.0,0.5,2.3774437510817346,0.1320802083934297,4.754887502163469,6,57.390366970969815
ray_2.0.0,python/ray/tune/utils/trainable.py,4,3,3,0,0,0,0,0,0,0,0,0,0.0,0,1,100.0
ray_2.0.0,python/ray/tune/utils/resource_updater.py,133,65,101,11,27,16,29,38,45,166.43571036342394,5.907407407407407,1395.0740639904197,77.50411466613443,236.15673810496133,20,60.935060074195235
ray_2.0.0,python/ray/tune/utils/mock.py,122,71,84,9,28,20,33,37,53,163.13526283059372,5.303571428571429,1464.3215255065234,81.35119586147351,276.1010283783344,24,60.57781836694511
ray_2.0.0,python/ray/tune/utils/node.py,40,19,16,2,4,2,4,6,6,10.0,1.0,15.509775004326936,0.861654166907052,15.509775004326936,7,86.5056966861334
ray_2.0.0,python/ray/tune/utils/__init__.py,31,2,30,0,0,0,0,0,0,0,0,0,0.0,0,1,100.0
ray_2.0.0,python/ray/tune/utils/util.py,679,340,442,10,78,53,94,88,147,523.480654020129,6.0256410256410255,5721.565776046807,317.8647653359337,949.5364479396828,91,37.21909432516656
ray_2.0.0,python/ray/tune/utils/mock_trainable.py,35,23,20,3,6,3,6,9,9,20.264662506490406,1.5,42.793987519471216,2.377443751081734,28.529325012980813,5,85.93874492788449
ray_2.0.0,python/ray/tune/utils/callback.py,136,63,94,8,27,20,36,35,56,152.38196255841368,5.333333333333333,1531.9458610608965,85.10810339227203,287.2398489489181,24,64.95123543296049
ray_2.0.0,python/ray/tune/utils/file_transfer.py,449,177,241,10,28,19,34,38,53,167.82521876648653,6.071428571428571,1688.7081034330965,93.81711685739425,278.14015821251,37,58.03426360760803
ray_2.0.0,python/ray/tune/utils/release_test_util.py,208,114,167,11,36,23,47,47,70,224.1710478569335,7.180555555555555,2791.952368641857,155.1084649245476,388.8212196174346,23,40.477402281791356
ray_2.0.0,python/ray/tune/utils/log.py,51,36,33,1,2,1,2,3,3,2.0,0.5,2.3774437510817346,0.1320802083934297,4.754887502163469,4,60.771516611289684
ray_2.0.0,python/ray/tune/utils/placement_groups.py,4,3,3,0,0,0,0,0,0,0,0,0,0.0,0,1,100.0
ray_2.0.0,python/ray/tune/utils/serialization.py,43,32,34,1,2,1,2,3,3,2.0,0.5,2.3774437510817346,0.1320802083934297,4.754887502163469,10,61.08033835259576
ray_2.0.0,python/ray/tune/trainable/trainable.py,1126,448,551,13,69,45,81,82,126,469.59390385352793,7.630434782608695,6112.371629483466,339.5762016379703,801.0515525818787,116,35.33993571134329
ray_2.0.0,python/ray/tune/trainable/function_trainable.py,701,360,469,10,49,35,57,59,92,308.3400633105188,5.816326530612245,3147.8143011075,174.87857228375,541.2031605412894,89,37.78663782560318
ray_2.0.0,python/ray/tune/trainable/__init__.py,19,5,17,0,0,0,0,0,0,0,0,0,0.0,0,1,100.0
ray_2.0.0,python/ray/tune/trainable/util.py,462,203,242,10,48,31,52,58,83,301.29748098348915,5.416666666666667,2633.650622392771,146.31392346626504,486.21242259558846,44,54.113265329929625
ray_2.0.0,python/ray/tune/trainable/session.py,388,168,217,10,34,24,43,44,67,206.1930175513852,6.323529411764706,2313.0327196020667,128.50181775567037,365.78191844869895,37,56.557484138797776
ray_2.0.0,python/ray/tune/integration/xgboost.py,211,71,82,6,11,8,13,17,21,53.563522809337215,3.5454545454545454,304.33018790763896,16.9072326615355,85.83671966625714,22,68.93637176057649
ray_2.0.0,python/ray/tune/integration/__init__.py,0,0,0,0,0,0,0,0,0,0,0,0,0.0,0,1,100.0
ray_2.0.0,python/ray/tune/integration/lightgbm.py,212,78,89,8,19,12,22,27,34,104.71062275542812,4.631578947368421,748.7696529722684,41.598314054014914,161.66617507355795,22,67.30462564849228
ray_2.0.0,python/ray/tune/integration/mxnet.py,127,40,45,3,6,4,6,9,10,20.264662506490406,1.5,47.548875021634686,2.6416041678685938,31.699250014423125,11,77.33630133640287
ray_2.0.0,python/ray/tune/integration/keras.py,202,58,75,6,13,8,14,19,22,63.61549134016113,3.230769230769231,301.9296171093748,16.77386761718749,93.45440529575887,17,68.9863059838228
ray_2.0.0,python/ray/tune/integration/pytorch_lightning.py,326,131,198,4,50,26,50,54,76,290.1928094887362,2.0,874.7429003288473,48.59682779604707,437.37145016442366,64,53.404755385439074
ray_2.0.0,python/ray/tune/integration/horovod.py,7,1,7,0,0,0,0,0,0,0,0,0,0.0,0,1,100.0
ray_2.0.0,python/ray/tune/integration/torch.py,7,1,7,0,0,0,0,0,0,0,0,0,0.0,0,1,100.0
ray_2.0.0,python/ray/tune/integration/docker.py,21,9,17,0,0,0,0,0,0,0,0,0,0.0,0,3,100.0
ray_2.0.0,python/ray/tune/integration/mlflow.py,209,46,88,3,9,5,9,12,14,33.28421251514428,1.5,75.28421251514428,4.182456250841349,50.18947501009619,9,77.34265111106832
ray_2.0.0,python/ray/tune/integration/wandb.py,205,59,107,3,5,3,5,8,8,16.36452797660028,1.5,36.0,2.0,24.0,12,79.22606588457158
ray_2.0.0,python/ray/tune/integration/tensorflow.py,7,1,7,0,0,0,0,0,0,0,0,0,0.0,0,1,100.0
ray_2.0.0,python/ray/tune/integration/kubernetes.py,30,11,23,0,0,0,0,0,0,0,0,0,0.0,0,3,100.0
ray_2.0.0,python/ray/tune/integration/comet.py,28,11,22,0,0,0,0,0,0,0,0,0,0.0,0,2,100.0
ray_2.0.0,python/ray/tune/suggest/hebo.py,4,3,3,0,0,0,0,0,0,0,0,0,0.0,0,1,100.0
ray_2.0.0,python/ray/tune/suggest/sigopt.py,4,3,3,0,0,0,0,0,0,0,0,0,0.0,0,1,100.0
ray_2.0.0,python/ray/tune/suggest/dragonfly.py,4,3,3,0,0,0,0,0,0,0,0,0,0.0,0,1,100.0
ray_2.0.0,python/ray/tune/suggest/nevergrad.py,4,3,3,0,0,0,0,0,0,0,0,0,0.0,0,1,100.0
ray_2.0.0,python/ray/tune/suggest/search_generator.py,4,3,3,0,0,0,0,0,0,0,0,0,0.0,0,1,100.0
ray_2.0.0,python/ray/tune/suggest/bohb.py,4,3,3,0,0,0,0,0,0,0,0,0,0.0,0,1,100.0
ray_2.0.0,python/ray/tune/suggest/hyperopt.py,4,3,3,0,0,0,0,0,0,0,0,0,0.0,0,1,100.0
ray_2.0.0,python/ray/tune/suggest/zoopt.py,4,3,3,0,0,0,0,0,0,0,0,0,0.0,0,1,100.0
ray_2.0.0,python/ray/tune/suggest/__init__.py,4,3,3,0,0,0,0,0,0,0,0,0,0.0,0,1,100.0
ray_2.0.0,python/ray/tune/suggest/util.py,4,3,3,0,0,0,0,0,0,0,0,0,0.0,0,1,100.0
ray_2.0.0,python/ray/tune/suggest/basic_variant.py,4,3,3,0,0,0,0,0,0,0,0,0,0.0,0,1,100.0
ray_2.0.0,python/ray/tune/suggest/bayesopt.py,4,3,3,0,0,0,0,0,0,0,0,0,0.0,0,1,100.0
ray_2.0.0,python/ray/tune/suggest/skopt.py,4,3,3,0,0,0,0,0,0,0,0,0,0.0,0,1,100.0
ray_2.0.0,python/ray/tune/suggest/flaml.py,4,3,3,0,0,0,0,0,0,0,0,0,0.0,0,1,100.0
ray_2.0.0,python/ray/tune/suggest/ax.py,4,3,3,0,0,0,0,0,0,0,0,0,0.0,0,1,100.0
ray_2.0.0,python/ray/tune/suggest/variant_generator.py,4,3,3,0,0,0,0,0,0,0,0,0,0.0,0,1,100.0
ray_2.0.0,python/ray/tune/suggest/optuna.py,4,3,3,0,0,0,0,0,0,0,0,0,0.0,0,1,100.0
ray_2.0.0,python/ray/tune/suggest/suggestion.py,10,5,9,0,0,0,0,0,0,0,0,0,0.0,0,1,100.0
ray_2.0.0,python/ray/tune/suggest/search.py,4,3,3,0,0,0,0,0,0,0,0,0,0.0,0,1,100.0
ray_2.0.0,python/ray/tune/examples/optuna_example.py,82,36,57,7,17,10,18,24,28,89.13835275565901,3.7058823529411766,475.7572853689484,26.43096029827491,128.3789500201924,5,72.92377941708187
ray_2.0.0,python/ray/tune/examples/tune_basic_example.py,67,28,46,7,17,10,18,24,28,89.13835275565901,3.7058823529411766,475.7572853689484,26.43096029827491,128.3789500201924,6,75.0985106559476
ray_2.0.0,python/ray/tune/examples/dragonfly_example.py,103,38,65,5,24,14,28,29,42,121.64874049174458,2.9166666666666665,595.1026719031277,33.06125955017376,204.03520179535806,5,77.28589156291345
ray_2.0.0,python/ray/tune/examples/cifar10_pytorch.py,253,145,181,9,43,30,59,52,89,261.858709465171,6.174418604651163,3132.5241934840687,174.02912186022604,507.33913491455723,14,54.39873837747376
ray_2.0.0,python/ray/tune/examples/sigopt_example.py,88,36,67,7,18,10,18,25,28,94.71013448036484,3.5,455.097906597923,25.283217033217944,130.02797331369229,6,68.5932784746006
ray_2.0.0,python/ray/tune/examples/tune_cifar10_gluon.py,224,87,196,5,13,7,14,18,21,59.715356810271004,2.6923076923076925,235.76114431231534,13.097841350684185,87.56842503028855,7,52.65076756944057
ray_2.0.0,python/ray/tune/examples/utils.py,21,15,15,1,1,1,1,2,2,0.0,0.5,1.0,0.05555555555555555,2.0,1,92.17453787947596
ray_2.0.0,python/ray/tune/examples/hyperopt_conditional_search_space_example.py,118,49,73,7,19,11,20,26,31,100.36210720983135,3.6842105263157894,536.8396941245353,29.82442745136307,145.71363126237387,7,73.24741439259815
ray_2.0.0,python/ray/tune/examples/async_hyperband_example.py,74,32,56,7,16,9,17,23,26,83.65148445440323,3.71875,437.37189662626247,24.298438701459027,117.61261085748234,5,71.55234143102275
ray_2.0.0,python/ray/tune/examples/pb2_example.py,66,23,59,1,2,1,2,3,3,2.0,0.5,2.3774437510817346,0.1320802083934297,4.754887502163469,4,81.60324537756024
ray_2.0.0,python/ray/tune/examples/mlflow_ptl.py,103,40,83,1,2,1,2,3,3,2.0,0.5,2.3774437510817346,0.1320802083934297,4.754887502163469,3,72.7545001306324
ray_2.0.0,python/ray/tune/examples/pbt_tune_cifar10_with_keras.py,230,89,183,5,15,11,19,20,30,70.2129994085646,3.1666666666666665,410.5831690142994,22.810176056349967,129.65784284662087,10,61.9223146411062
ray_2.0.0,python/ray/tune/examples/mnist_ptl_mini.py,137,83,113,4,6,4,7,10,11,23.509775004326936,2.3333333333333335,85.26282110210897,4.736823394561609,36.541209043760986,13,53.40482283691578
ray_2.0.0,python/ray/tune/examples/sigopt_multi_objective_example.py,85,39,65,6,14,7,14,20,21,68.81274391313339,3.0,272.28146997790384,15.12674833210577,90.76048999263462,6,66.67036147576641
ray_2.0.0,python/ray/tune/examples/tune_mnist_keras.py,96,36,81,2,5,3,6,7,9,13.60964047443681,1.2,30.319433158222125,1.6844129532345624,25.26619429851844,5,62.23034096829814
ray_2.0.0,python/ray/tune/examples/mlflow_example.py,148,61,113,8,18,12,20,26,32,99.05865002596161,4.444444444444445,668.5069821356221,37.13927678531234,150.41407098051496,12,61.8091921295194
ray_2.0.0,python/ray/tune/examples/pbt_convnet_function_example.py,144,64,103,8,15,9,17,23,26,82.60335893412778,4.533333333333333,533.1771692205866,29.620953845588147,117.61261085748234,12,67.62850936619812
ray_2.0.0,python/ray/tune/examples/genetic_example.py,67,28,51,4,11,8,12,15,20,46.053747805010275,2.1818181818181817,170.48249871746262,9.471249928747923,78.13781191217038,4,72.30729593054522
ray_2.0.0,python/ray/tune/examples/pbt_memnn_example.py,313,151,221,11,28,19,36,39,55,172.65968562262316,7.071428571428571,2055.643934407496,114.20244080041645,290.6971220374237,32,55.59949374878668
ray_2.0.0,python/ray/tune/examples/__init__.py,0,0,0,0,0,0,0,0,0,0,0,0,0.0,0,1,100.0
ray_2.0.0,python/ray/tune/examples/mnist_pytorch_lightning.py,310,135,223,5,10,6,11,15,17,44.82892142331043,2.75,182.64713534469826,10.147063074705459,66.41714012534482,19,57.51603248537473
ray_2.0.0,python/ray/tune/examples/zoopt_example.py,97,33,61,6,15,9,16,21,25,74.11313393845472,3.2,351.3853938223009,19.521410767905607,109.80793556946902,5,78.67934644772453
ray_2.0.0,python/ray/tune/examples/mxnet_example.py,107,43,84,3,5,3,5,8,8,16.36452797660028,1.5,36.0,2.0,24.0,5,65.1903058654415
ray_2.0.0,python/ray/tune/examples/custom_func_checkpointing.py,74,36,59,6,16,9,17,22,26,79.50977500432694,3.1875,369.57539539456604,20.531966410809225,115.94522208456974,6,63.96024129576857
ray_2.0.0,python/ray/tune/examples/cfo_example.py,79,36,57,7,17,10,18,24,28,89.13835275565901,3.7058823529411766,475.7572853689484,26.43096029827491,128.3789500201924,5,71.10074198598667
ray_2.0.0,python/ray/tune/examples/optuna_multiobjective_example.py,89,35,65,7,19,11,20,26,31,100.36210720983135,3.6842105263157894,536.8396941245353,29.82442745136307,145.71363126237387,5,71.72945429341209
ray_2.0.0,python/ray/tune/examples/logging_example.py,78,31,57,6,14,8,15,20,23,68.81274391313339,3.2142857142857144,319.51396987203003,17.75077610400167,99.40434618240934,6,70.88410208620945
ray_2.0.0,python/ray/tune/examples/lightgbm_example.py,119,33,90,3,4,3,4,7,7,12.75488750216347,1.5,29.47722668160484,1.6376237045336022,19.651484454403228,4,78.0000845565839
ray_2.0.0,python/ray/tune/examples/optuna_define_by_run_example.py,102,46,59,7,21,12,22,28,34,111.8901503327572,3.6666666666666665,599.3169136165145,33.29538408980636,163.45006734995852,6,74.74346012325799
ray_2.0.0,python/ray/tune/examples/pb2_ppo_example.py,157,58,135,7,18,11,21,25,32,94.71013448036484,4.083333333333333,606.7972087972306,33.71095604429059,148.60339807279118,8,62.780185527832934
ray_2.0.0,python/ray/tune/examples/pbt_function.py,145,59,104,9,33,24,48,42,72,194.9943309518098,6.545454545454546,2541.2521381531906,141.1806743418439,388.24685444007076,10,68.98463468152141
ray_2.0.0,python/ray/tune/examples/nevergrad_example.py,88,33,57,6,15,9,16,21,25,74.11313393845472,3.2,351.3853938223009,19.521410767905607,109.80793556946902,5,76.93473658841137
ray_2.0.0,python/ray/tune/examples/pbt_ppo_example.py,76,18,55,3,9,5,10,12,15,33.28421251514428,1.6666666666666667,89.62406251802892,4.9791145843349405,53.77443751081735,4,85.2582897671468
ray_2.0.0,python/ray/tune/examples/xgboost_example.py,125,48,86,3,6,4,6,9,10,20.264662506490406,1.5,47.548875021634686,2.6416041678685938,31.699250014423125,4,76.46155005495355
ray_2.0.0,python/ray/tune/examples/pbt_convnet_example.py,141,67,99,7,13,8,15,20,23,67.75720079023742,4.038461538461538,401.44062881357615,22.302257156309786,99.40434618240934,17,67.75115253079653
ray_2.0.0,python/ray/tune/examples/bayesopt_example.py,76,33,54,6,15,9,16,21,25,74.11313393845472,3.2,351.3853938223009,19.521410767905607,109.80793556946902,5,71.76007488224349
ray_2.0.0,python/ray/tune/examples/ax_example.py,108,40,90,6,23,13,24,29,37,119.55169999363824,3.130434782608696,562.6809291747762,31.260051620820903,179.74529681972018,8,65.1258843577107
ray_2.0.0,python/ray/tune/examples/hyperband_example.py,53,19,43,1,2,1,2,3,3,2.0,0.5,2.3774437510817346,0.1320802083934297,4.754887502163469,6,83.83010849737553
ray_2.0.0,python/ray/tune/examples/mnist_pytorch.py,164,88,133,7,21,12,23,28,35,111.8901503327572,3.8333333333333335,644.9867853760619,35.832599187559,168.25742227201613,17,54.71880575436865
ray_2.0.0,python/ray/tune/examples/tf_mnist_example.py,152,80,109,6,13,8,15,19,23,63.61549134016113,3.4615384615384617,338.2003828010854,18.788910155615856,97.70233280920246,12,63.26553379222894
ray_2.0.0,python/ray/tune/examples/bohb_example.py,113,48,71,5,9,5,9,14,14,40.13896548741762,2.5,133.25742227201613,7.403190126223119,53.30296890880645,7,77.02293346066999
ray_2.0.0,python/ray/tune/examples/xgboost_dynamic_resources_example.py,292,120,191,8,14,8,14,22,22,77.30296890880645,4.0,392.42998244008214,21.801665691115673,98.10749561002054,13,65.41942130515098
ray_2.0.0,python/ray/tune/examples/hyperband_function_example.py,78,37,58,5,12,6,12,17,18,54.62919048309069,2.5,183.93582785626532,10.218657103125851,73.57433114250613,8,71.9898361936715
ray_2.0.0,python/ray/tune/examples/hebo_example.py,117,34,65,6,18,12,19,24,31,90.56842503028855,3.1666666666666665,450.0904854874602,25.005026971525567,142.13383752235586,5,80.07433606224319
ray_2.0.0,python/ray/tune/examples/pbt_example.py,149,58,106,7,27,21,42,34,63,148.0334470128169,5.444444444444445,1744.9997545488668,96.94443080827038,320.51015899877143,13,69.00000233559722
ray_2.0.0,python/ray/tune/examples/skopt_example.py,98,35,65,6,18,12,19,24,31,90.56842503028855,3.1666666666666665,450.0904854874602,25.005026971525567,142.13383752235586,5,76.5021941464074
ray_2.0.0,python/ray/tune/examples/sigopt_prior_beliefs_example.py,110,47,87,7,20,14,28,27,42,106.09004635215048,4.9,978.555847945242,54.36421377473567,199.7052750908657,6,60.54517870931278
ray_2.0.0,python/ray/tune/examples/blendsearch_example.py,113,49,87,7,19,12,20,26,32,100.36210720983135,3.6842105263157894,554.1571036124235,30.78650575624575,150.41407098051496,5,64.3993113493294
ray_2.0.0,python/ray/tune/examples/mnist_pytorch_trainable.py,92,41,69,2,4,2,4,6,6,10.0,1.0,15.509775004326936,0.861654166907052,15.509775004326936,11,74.8981863741843
ray_2.0.0,python/ray/tune/examples/wandb_example.py,117,64,94,3,14,7,14,17,21,58.05785641096992,1.5,128.75507949938572,7.153059972188095,85.83671966625714,8,52.18604550443387
ray_2.0.0,python/ray/tune/examples/pbt_transformers/utils.py,46,33,35,2,6,4,7,8,11,17.509775004326936,1.1666666666666667,38.5,2.138888888888889,33.0,3,65.87201498483458
ray_2.0.0,python/ray/tune/examples/pbt_transformers/__init__.py,0,0,0,0,0,0,0,0,0,0,0,0,0.0,0,1,100.0
ray_2.0.0,python/ray/tune/examples/pbt_transformers/pbt_transformers.py,185,55,151,4,7,7,9,11,16,27.651484454403228,2.5714285714285716,142.3309008810774,7.907272271170967,55.350905898196764,10,66.25239388076773
ray_2.0.0,python/ray/tune/examples/pbt_dcgan_mnist/common.py,285,152,213,8,32,33,60,40,93,184.0,7.5,3712.0448461839355,206.2247136768853,494.93931282452473,17,49.31553169367228
ray_2.0.0,python/ray/tune/examples/pbt_dcgan_mnist/pbt_dcgan_mnist_func.py,168,82,136,5,11,8,13,16,21,49.663388279447084,2.9545454545454546,248.1818181818182,13.787878787878789,84.0,15,60.79916809520627
ray_2.0.0,python/ray/tune/examples/pbt_dcgan_mnist/pbt_dcgan_mnist_trainable.py,176,83,141,4,9,7,11,13,18,36.52932501298081,2.4444444444444446,162.81934759820808,9.04551931101156,66.60791492653966,18,61.238859001735975
ray_2.0.0,python/ray/tune/stopper/noop.py,11,8,8,0,0,0,0,0,0,0,0,0,0.0,0,3,100.0
ray_2.0.0,python/ray/tune/stopper/timeout.py,64,34,39,2,5,3,6,7,9,13.60964047443681,1.2,30.319433158222125,1.6844129532345624,25.26619429851844,9,80.0926385123565
ray_2.0.0,python/ray/tune/stopper/__init__.py,18,8,17,0,0,0,0,0,0,0,0,0,0.0,0,1,100.0
ray_2.0.0,python/ray/tune/stopper/trial_plateau.py,93,42,51,7,20,12,24,27,36,106.09004635215048,4.2,718.9389903271166,39.941055018173145,171.1759500778849,14,76.18679072226183
ray_2.0.0,python/ray/tune/stopper/experiment_plateau.py,91,41,50,10,31,18,32,41,50,186.7993665708668,5.161290322580645,1382.5940657078925,76.81078142821625,267.8776002309042,16,74.87219925316752
ray_2.0.0,python/ray/tune/stopper/maximum_iteration.py,25,16,14,2,4,2,4,6,6,10.0,1.0,15.509775004326936,0.861654166907052,15.509775004326936,4,91.01710570526984
ray_2.0.0,python/ray/tune/stopper/stopper.py,83,20,16,0,0,0,0,0,0,0,0,0,0.0,0,8,100.0
ray_2.0.0,python/ray/tune/stopper/function_stopper.py,38,18,20,2,5,3,5,7,8,13.60964047443681,1.0,22.458839376460833,1.2477132986922685,22.458839376460833,8,90.33384580775332
ray_2.0.0,python/ray/tune/analysis/__init__.py,3,2,2,0,0,0,0,0,0,0,0,0,0.0,0,1,100.0
ray_2.0.0,python/ray/tune/analysis/experiment_analysis.py,888,372,509,12,122,88,144,134,232,888.569505191326,7.081967213114754,11609.700377449832,644.9833543027685,1639.332692186203,147,30.726440130151282
ray_2.0.0,python/ray/tune/search/searcher.py,585,184,245,12,51,36,62,63,98,332.3132424492002,7.294117647058823,4272.700331198293,237.37224062212738,585.7734325029918,60,49.63932287374585
ray_2.0.0,python/ray/tune/search/search_generator.py,228,120,163,8,22,14,25,30,39,122.10749561002054,4.545454545454546,869.8578783124193,48.32543768402329,191.36873322873222,31,57.19943222912203
ray_2.0.0,python/ray/tune/search/sample.py,716,342,457,13,94,81,132,107,213,664.2370683935321,9.127659574468085,13106.702740773992,728.1501522652218,1435.9324681034443,82,35.93110677693039
ray_2.0.0,python/ray/tune/search/__init__.py,190,67,114,2,4,2,4,6,6,10.0,1.0,15.509775004326936,0.861654166907052,15.509775004326936,4,72.27006020744155
ray_2.0.0,python/ray/tune/search/util.py,31,13,24,0,0,0,0,0,0,0,0,0,0.0,0,3,100.0
ray_2.0.0,python/ray/tune/search/basic_variant.py,423,172,238,10,33,21,40,43,61,199.6842868877026,6.0606060606060606,2006.073636586836,111.44853536593534,331.00215003682797,46,56.51568574628956
ray_2.0.0,python/ray/tune/search/search_algorithm.py,127,50,44,1,2,1,2,3,3,2.0,0.5,2.3774437510817346,0.1320802083934297,4.754887502163469,17,80.1515801298167
ray_2.0.0,python/ray/tune/search/variant_generator.py,479,259,319,14,77,54,94,91,148,535.8455325423139,8.545454545454545,8230.58536676766,457.25474259820334,963.1536067494071,79,40.08237168097074
ray_2.0.0,python/ray/tune/search/_mock.py,55,42,44,3,11,6,11,14,17,42.808635307173745,1.5,97.08755051246888,5.393752806248271,64.72503367497926,13,50.16080838891822
ray_2.0.0,python/ray/tune/search/repeater.py,193,87,104,9,31,17,33,40,50,182.10941063497398,4.790322580645161,1274.6876162754409,70.81597868196894,266.09640474436816,29,65.66239060277807
ray_2.0.0,python/ray/tune/search/concurrency_limiter.py,177,81,112,9,23,15,26,32,41,132.57125000229212,5.086956521739131,1042.8260869565217,57.934782608695656,205.0,26,65.47190761294725
ray_2.0.0,python/ray/tune/search/hebo/__init__.py,3,2,2,0,0,0,0,0,0,0,0,0,0.0,0,1,100.0
ray_2.0.0,python/ray/tune/search/hebo/hebo_search.py,471,177,325,13,69,46,79,82,125,469.59390385352793,7.442028985507246,5914.135786904685,328.56309927248253,794.6940005772606,65,47.67648071227859
ray_2.0.0,python/ray/tune/search/bohb/bohb_search.py,384,178,248,14,47,39,74,61,113,314.3686449376554,11.02127659574468,7386.1655173809795,410.34252874338773,670.1733191446062,45,51.13778949072401
ray_2.0.0,python/ray/tune/search/bohb/__init__.py,3,2,2,0,0,0,0,0,0,0,0,0,0.0,0,1,100.0
ray_2.0.0,python/ray/tune/search/ax/__init__.py,3,2,2,0,0,0,0,0,0,0,0,0,0.0,0,1,100.0
ray_2.0.0,python/ray/tune/search/ax/ax_search.py,409,149,258,10,30,20,34,40,54,180.4259988171292,5.666666666666667,1628.509997035533,90.47277761308516,287.3841171239176,46,56.621670403213045
ray_2.0.0,python/ray/tune/search/nevergrad/__init__.py,3,2,2,0,0,0,0,0,0,0,0,0,0.0,0,1,100.0
ray_2.0.0,python/ray/tune/search/nevergrad/nevergrad_search.py,359,146,228,11,45,35,61,56,96,285.1871371398456,7.455555555555556,4156.517496214029,230.91763867855718,557.50607251753,55,53.20043496772621
ray_2.0.0,python/ray/tune/search/optuna/__init__.py,3,2,2,0,0,0,0,0,0,0,0,0,0.0,0,1,100.0
ray_2.0.0,python/ray/tune/search/optuna/optuna_search.py,713,239,406,11,60,40,68,71,108,392.4671835415214,6.233333333333333,4140.009760850552,230.00054226947512,664.1726889065056,80,46.70422655765533
ray_2.0.0,python/ray/tune/search/flaml/__init__.py,3,2,2,0,0,0,0,0,0,0,0,0,0.0,0,1,100.0
ray_2.0.0,python/ray/tune/search/flaml/flaml_search.py,13,7,11,0,0,0,0,0,0,0,0,0,0.0,0,3,100.0
ray_2.0.0,python/ray/tune/search/dragonfly/__init__.py,3,2,2,0,0,0,0,0,0,0,0,0,0.0,0,1,100.0
ray_2.0.0,python/ray/tune/search/dragonfly/dragonfly_search.py,469,194,293,9,48,33,56,57,89,296.6075250475963,5.25,2725.417859118476,151.41210328435977,519.1272112606621,71,49.45539008501876
ray_2.0.0,python/ray/tune/search/sigopt/sigopt_search.py,338,124,176,10,33,22,43,43,65,199.6842868877026,6.515151515151516,2297.9409074836917,127.66338374909398,352.7072090556364,42,60.04770877614819
ray_2.0.0,python/ray/tune/search/sigopt/__init__.py,3,2,2,0,0,0,0,0,0,0,0,0,0.0,0,1,100.0
ray_2.0.0,python/ray/tune/search/skopt/__init__.py,3,2,2,0,0,0,0,0,0,0,0,0,0.0,0,1,100.0
ray_2.0.0,python/ray/tune/search/skopt/skopt_search.py,409,158,242,10,39,27,44,49,71,239.34996748450132,5.641025641025641,2248.763276027681,124.93129311264894,398.6443989321798,63,53.51608680070488
ray_2.0.0,python/ray/tune/search/bayesopt/__init__.py,3,2,2,0,0,0,0,0,0,0,0,0,0.0,0,1,100.0
ray_2.0.0,python/ray/tune/search/bayesopt/bayesopt_search.py,441,167,236,14,55,35,66,69,101,371.27775315266274,8.4,5182.4721491306,287.91511939614446,616.9609701345952,59,53.24274446861863
ray_2.0.0,python/ray/tune/search/hyperopt/__init__.py,3,2,2,0,0,0,0,0,0,0,0,0,0.0,0,1,100.0
ray_2.0.0,python/ray/tune/search/hyperopt/hyperopt_search.py,531,233,365,14,75,48,90,89,138,520.4643706959974,8.4,7506.670193176248,417.037232954236,893.6512134733629,62,44.49177104090047
ray_2.0.0,python/ray/tune/search/zoopt/zoopt_search.py,379,146,210,11,49,31,54,60,85,313.1745301666555,6.061224489795919,3043.254144615042,169.06967470083566,502.0857006267241,49,56.3399289527764
ray_2.0.0,python/ray/tune/search/zoopt/__init__.py,3,2,2,0,0,0,0,0,0,0,0,0,0.0,0,1,100.0
ray_2.0.0,python/ray/tune/experiment/config_parser.py,254,77,206,5,12,7,14,17,21,54.62919048309069,2.9166666666666665,250.3570990265833,13.908727723699073,85.83671966625714,17,64.07479493723531
ray_2.0.0,python/ray/tune/experiment/trial.py,874,462,592,17,138,82,146,155,228,1050.4632433366432,8.992753623188406,14918.585856692285,828.8103253717936,1658.9563644025263,149,23.955436537235073
ray_2.0.0,python/ray/tune/experiment/__init__.py,4,3,3,0,0,0,0,0,0,0,0,0,0.0,0,1,100.0
ray_2.0.0,python/ray/tune/experiment/experiment.py,462,210,311,10,63,34,66,73,100,409.7879161293684,5.238095238095238,3242.2890546514377,180.12716970285766,618.9824558880017,83,44.63667542208218
ray_2.0.0,python/ray/tune/schedulers/pb2_utils.py,184,125,123,10,88,66,114,98,180,601.6492633889558,6.4772727272727275,7712.150340979778,428.45279672109876,1190.6477719407376,15,51.9700769959944
ray_2.0.0,python/ray/tune/schedulers/__init__.py,96,29,59,2,4,2,4,6,6,10.0,1.0,15.509775004326936,0.861654166907052,15.509775004326936,5,86.41012150654397
ray_2.0.0,python/ray/tune/schedulers/util.py,27,13,20,0,0,0,0,0,0,0,0,0,0.0,0,3,100.0
ray_2.0.0,python/ray/tune/schedulers/hyperband.py,534,258,344,18,116,78,144,134,222,870.5844454607599,11.172413793103448,17525.850458318848,973.6583587954915,1568.6718002816253,97,38.39470931627345
ray_2.0.0,python/ray/tune/schedulers/pbt.py,913,384,585,17,155,109,199,172,308,1197.2861511187627,10.912903225806451,24960.96944796263,1386.7205248868129,2287.289544448246,138,29.398773924802427
ray_2.0.0,python/ray/tune/schedulers/async_hyperband.py,271,131,185,17,91,60,115,108,175,661.6961805593371,10.741758241758241,12697.889487239981,705.4383048466657,1182.105312878607,59,50.40297919505298
ray_2.0.0,python/ray/tune/schedulers/trial_scheduler.py,167,79,87,3,10,6,12,13,18,37.974168451037094,1.8,119.8942468677714,6.660791492653967,66.60791492653966,30,69.7815132779504
ray_2.0.0,python/ray/tune/schedulers/resource_changing_scheduler.py,876,327,579,16,163,112,202,179,314,1261.8426891396657,9.914110429447852,23297.348079524774,1294.297115529154,2349.9181540609766,116,32.841931284505556
ray_2.0.0,python/ray/tune/schedulers/median_stopping_rule.py,215,105,147,14,47,30,55,61,85,314.3686449376554,8.191489361702128,4129.433603654159,229.41297798078662,504.11267369284536,49,55.1738763869246
ray_2.0.0,python/ray/tune/schedulers/pb2.py,403,153,201,13,69,45,77,82,122,469.59390385352793,7.253623188405797,5626.0649703476065,312.5591650193115,775.6213445634063,26,57.70056169598513
ray_2.0.0,python/ray/tune/schedulers/hb_bohb.py,165,68,88,10,36,23,42,46,65,219.33658100079685,5.833333333333333,2094.3505750049508,116.35280972249727,359.03152714370583,36,66.52521465755116
ray_2.0.0,python/ray/tune/impl/__init__.py,0,0,0,0,0,0,0,0,0,0,0,0,0.0,0,1,100.0
ray_2.0.0,python/ray/tune/impl/tuner_internal.py,419,187,291,11,64,48,85,75,133,422.0537478050103,7.3046875,6051.443345754807,336.1912969863781,828.4328858359521,57,47.31067176980404
ray_2.0.0,python/ray/tune/impl/test_utils.py,65,50,50,2,10,7,10,12,17,35.219280948873624,1.0,60.94436251225966,3.385797917347759,60.94436251225966,13,57.13827083799729
ray_2.0.0,python/ray/tune/impl/out_of_band_serialize_dataset.py,33,25,25,2,3,2,3,5,5,6.754887502163469,1.0,11.60964047443681,0.6449800263576005,11.60964047443681,4,73.28504369654917
ray_2.0.0,python/ray/tune/execution/trial_runner.py,1584,746,1107,15,234,157,291,249,448,1900.2687033166444,9.326923076923077,33260.561919226006,1847.8089955125558,3566.0808655665,265,1.8133959584170063
ray_2.0.0,python/ray/tune/execution/__init__.py,0,0,0,0,0,0,0,0,0,0,0,0,0.0,0,1,100.0
ray_2.0.0,python/ray/tune/execution/ray_trial_executor.py,1021,501,636,13,130,76,142,143,218,961.0135320295333,7.1,11082.04885506559,615.6693808369772,1560.8519514176887,153,25.95320280149879
ray_2.0.0,python/ray/tune/execution/checkpoint_manager.py,134,62,89,6,23,14,26,29,40,119.55169999363824,3.391304347826087,658.9956828173055,36.610871267628085,194.3192398051029,23,65.6921351862499
ray_2.0.0,python/ray/tune/execution/placement_groups.py,786,328,366,12,69,44,78,81,122,464.5077375263476,6.782608695652174,5246.088054560878,291.4493363644932,773.4617003519243,96,41.0312876930377
ray_2.0.0,python/ray/tune/execution/cluster_info.py,12,6,5,0,0,0,0,0,0,0,0,0,0.0,0,1,100.0
ray_2.0.0,python/ray/tune/execution/insufficient_resources_manager.py,137,60,86,9,25,17,28,34,45,144.62572975734892,5.04,1153.8365723955772,64.10203179975429,228.9358278562653,14,70.49842417115971
ray_2.0.0,python/ray/workflow/common.py,204,118,117,2,5,4,5,7,9,13.60964047443681,1.0,25.26619429851844,1.403677461028802,25.26619429851844,12,70.41443757661911
ray_2.0.0,python/ray/workflow/debug_utils.py,40,31,30,0,0,0,0,0,0,0,0,0,0.0,0,1,100.0
ray_2.0.0,python/ray/workflow/workflow_storage.py,878,409,487,9,78,53,102,87,155,518.7906980842362,5.884615384615385,5876.707884771254,326.48377137618075,998.6562418565529,115,35.590398383229356
ray_2.0.0,python/ray/workflow/exceptions.py,57,37,37,0,0,0,0,0,0,0,0,0,0.0,0,7,100.0
ray_2.0.0,python/ray/workflow/workflow_access.py,374,203,245,11,58,39,72,69,111,377.81664552240943,6.827586206896552,4629.418983140366,257.18994350779815,678.0462147023769,55,48.995478325065804
ray_2.0.0,python/ray/workflow/__init__.py,55,6,52,0,0,0,0,0,0,0,0,0,0.0,0,1,100.0
ray_2.0.0,python/ray/workflow/task_executor.py,163,81,102,2,6,3,6,8,9,17.509775004326936,1.0,27.0,1.5,27.0,13,74.16530389152697
ray_2.0.0,python/ray/workflow/event_listener.py,67,23,18,1,2,1,2,3,3,2.0,0.5,2.3774437510817346,0.1320802083934297,4.754887502163469,5,76.86650830099134
ray_2.0.0,python/ray/workflow/serialization_context.py,112,52,52,1,2,1,2,3,3,2.0,0.5,2.3774437510817346,0.1320802083934297,4.754887502163469,3,86.31927046862289
ray_2.0.0,python/ray/workflow/workflow_state_from_dag.py,200,95,123,5,11,10,18,16,28,49.663388279447084,4.090909090909091,458.1818181818182,25.454545454545453,112.0,9,69.63186432617805
ray_2.0.0,python/ray/workflow/workflow_context.py,123,71,63,1,4,2,4,5,6,8.0,0.5,6.965784284662087,0.3869880158145604,13.931568569324174,3,79.91972918468728
ray_2.0.0,python/ray/workflow/http_event_provider.py,263,86,116,3,6,3,6,9,9,20.264662506490406,1.5,42.793987519471216,2.377443751081734,28.529325012980813,17,72.3553810401193
ray_2.0.0,python/ray/workflow/workflow_state_from_storage.py,71,40,45,3,4,3,5,7,8,12.75488750216347,1.875,42.11032383086406,2.3394624350480036,22.458839376460833,7,82.60648462636425
ray_2.0.0,python/ray/workflow/workflow_executor.py,433,231,309,8,43,26,45,51,71,257.3293844521902,4.186046511627907,1685.897578381296,93.66097657673866,402.7421992799762,72,45.23214372916924
ray_2.0.0,python/ray/workflow/serialization.py,235,117,142,4,10,7,13,14,20,41.219280948873624,2.6,197.98245594699543,10.999025330388635,76.14709844115208,18,65.6942971872819
ray_2.0.0,python/ray/workflow/workflow_state.py,251,157,145,7,14,9,17,21,26,72.95445336320968,4.25,485.3510752170531,26.963948623169617,114.20025299224778,26,62.75500612638205
ray_2.0.0,python/ray/workflow/api.py,802,298,373,13,45,35,57,58,92,295.2391056706696,8.233333333333333,4437.225337775964,246.51251876533135,538.9342515517366,61,46.710548410409814
ray_2.0.0,python/ray/workflow/tests/test_http_events.py,112,53,80,3,17,9,18,20,27,74.24175580341925,1.588235294117647,185.3344459513463,10.296358108408128,116.69205856195879,10,69.4222059252941
ray_2.0.0,python/ray/workflow/tests/utils.py,59,43,42,6,17,16,27,23,43,84.99664330558272,4.764705882352941,926.7980172321516,51.48877873511953,194.51316411045156,18,45.9192742364914
ray_2.0.0,python/ray/workflow/tests/test_complex_workflow.py,87,58,63,8,23,13,25,31,38,128.0419249893113,4.3478260869565215,818.5193904117447,45.47329946731915,188.25945979470129,11,44.1252359196276
ray_2.0.0,python/ray/workflow/tests/test_serialization.py,115,67,68,2,17,9,18,19,27,71.48686830125578,1.0588235294117647,121.44075126668132,6.746708403704518,114.6940428629768,12,65.7748086983776
ray_2.0.0,python/ray/workflow/tests/test_basic_workflows_2.py,336,210,243,9,91,58,116,100,174,620.7386372710622,5.736263736263736,6631.298571481963,368.4054761934424,1156.030977020802,37,39.29554707191125
ray_2.0.0,python/ray/workflow/tests/test_serialization2.py,114,51,65,2,10,6,12,12,18,35.219280948873624,1.2,77.43519001557698,4.301955000865387,64.52932501298082,5,76.71695096676392
ray_2.0.0,python/ray/workflow/tests/test_error_handling.py,235,150,181,10,62,52,102,72,154,402.37945219285996,8.225806451612904,7815.9017679561175,434.21676488645096,950.1684502221161,19,39.895897185489154
ray_2.0.0,python/ray/workflow/tests/test_basic_workflows_4.py,74,37,50,2,9,5,10,11,15,30.529325012980813,1.1111111111111112,57.65719364395497,3.203177424664165,51.89147427955947,5,74.66353151490107
ray_2.0.0,python/ray/workflow/tests/test_workflow_manager.py,105,68,80,4,44,28,56,48,84,248.21499122004107,2.5454545454545454,1194.1665274269237,66.34258485705132,469.13685006057716,25,55.77611146874549
ray_2.0.0,python/ray/workflow/tests/test_basic_workflows.py,207,142,151,8,58,33,66,66,99,363.76289771739914,4.551724137931035,2723.729046612975,151.3182803673875,598.3950178164869,17,45.487680499970494
ray_2.0.0,python/ray/workflow/tests/test_workflow_indexing.py,92,51,63,2,26,14,26,28,40,124.2114326716684,1.0,192.29419688230416,10.683010937905786,192.29419688230416,2,61.0720462964849
ray_2.0.0,python/ray/workflow/tests/test_recovery.py,375,232,285,7,70,46,91,77,137,448.70129564055094,4.55,3906.401390142167,217.02229945234262,858.5497560752016,39,36.78517192327929
ray_2.0.0,python/ray/workflow/tests/test_workflow_queuing.py,211,115,159,4,56,31,59,60,90,333.21187563522585,2.107142857142857,1120.1996093814726,62.23331163230403,531.6201536047666,33,42.02858983370453
ray_2.0.0,python/ray/workflow/tests/test_cancellation.py,45,33,33,2,9,5,10,11,15,30.529325012980813,1.1111111111111112,57.65719364395497,3.203177424664165,51.89147427955947,7,53.92454624577992
ray_2.0.0,python/ray/workflow/tests/test_checkpoint_2.py,147,89,109,4,14,9,17,18,26,61.30296890880645,2.4285714285714284,263.30097866250026,14.627832147916681,108.41805003750011,5,52.40837945975242
ray_2.0.0,python/ray/workflow/tests/conftest.py,116,74,85,3,8,5,10,11,15,28.75488750216347,1.875,97.296514274174,5.405361904120777,51.89147427955947,5,65.61837070296217
ray_2.0.0,python/ray/workflow/tests/test_http_events_3.py,129,68,100,3,15,9,18,18,27,63.35824643629125,1.8,202.65835507009638,11.258797503894243,112.58797503894243,10,59.55498221829313
ray_2.0.0,python/ray/workflow/tests/test_lifetime.py,59,27,45,1,6,3,6,7,9,15.509775004326936,0.5,12.63309714925922,0.701838730514401,25.26619429851844,4,73.32551252749045
ray_2.0.0,python/ray/workflow/tests/test_checkpoint.py,102,64,81,2,4,2,4,6,6,10.0,1.0,15.509775004326936,0.861654166907052,15.509775004326936,8,57.8599809739484
ray_2.0.0,python/ray/workflow/tests/test_dataset.py,69,46,43,2,18,9,18,20,27,77.05865002596161,1.0,116.69205856195879,6.4828921423310435,116.69205856195879,5,57.66914833983677
ray_2.0.0,python/ray/workflow/tests/test_storage_failure.py,113,75,82,6,39,28,52,45,80,221.64046153995463,4.0,1757.3929908254959,97.63294393474978,439.34824770637397,10,53.56408474535408
ray_2.0.0,python/ray/workflow/tests/test_object_deref.py,113,70,82,5,24,11,26,29,37,121.64874049174458,2.7083333333333335,486.81017888674216,27.045009938152344,179.74529681972018,6,57.473554066207335
ray_2.0.0,python/ray/workflow/tests/test_basic_workflows_3.py,101,71,71,5,35,19,37,40,56,191.13454606751063,2.642857142857143,787.6453580433297,43.75807544685165,298.0279733136923,13,58.25328992646075
ray_2.0.0,python/ray/workflow/tests/test_dynamic_workflow_ref.py,31,14,19,2,7,4,8,9,12,21.651484454403228,1.1428571428571428,43.47325716263743,2.415180953479857,38.03910001730775,4,88.94518344307339
ray_2.0.0,python/ray/workflow/tests/test_metadata.py,274,174,199,8,86,48,95,94,143,576.6587689043804,4.4186046511627906,4141.58556046701,230.08808669261165,937.3062057899022,40,32.29447280769677
ray_2.0.0,python/ray/workflow/tests/test_events_with_crash.py,126,75,79,2,7,6,7,9,13,21.651484454403228,1.0,41.20902501875006,2.289390278819448,41.20902501875006,7,70.33071428610003
ray_2.0.0,python/ray/workflow/tests/test_signature_check.py,39,25,25,1,2,1,2,3,3,2.0,0.5,2.3774437510817346,0.1320802083934297,4.754887502163469,2,80.66734885521541
ray_2.0.0,python/ray/workflow/tests/test_storage.py,276,143,177,4,36,23,42,40,65,194.11730005192322,2.3333333333333335,807.15909439125,44.842171910625005,345.9253261676786,26,54.760234287418776
ray_2.0.0,python/ray/workflow/tests/test_event_resume_after_crash.py,139,84,105,5,18,12,21,23,33,86.66829050039843,2.9166666666666665,435.3928382704875,24.188491015027083,149.27754454988144,15,56.61059899307306
ray_2.0.0,python/ray/workflow/tests/test_http_events_2.py,82,45,61,3,12,7,14,15,21,47.77443751081735,1.75,143.57822938861307,7.9765682993673925,82.0447025077789,8,69.39792463236162
ray_2.0.0,python/ray/workflow/tests/test_large_intermediate.py,38,28,28,3,6,3,6,9,9,20.264662506490406,1.5,42.793987519471216,2.377443751081734,28.529325012980813,3,68.99776767568432
ray_2.0.0,python/ray/workflow/tests/test_dag_to_workflow.py,212,134,138,3,42,24,48,45,72,231.2322192588714,1.7142857142857142,677.8515821755484,37.65842123197491,395.4134229357366,15,51.85443486051337
ray_2.0.0,python/ray/workflow/tests/test_events.py,210,110,156,6,29,18,29,35,47,156.39122386302654,3.0,723.2289053892403,40.17938363273557,241.07630179641342,11,58.19570111110011
ray_2.0.0,python/ray/workflow/tests/test_logging.py,95,30,60,3,24,17,34,27,51,114.79398751947123,2.125,515.3109330469659,28.628385169275887,242.49926261033693,15,74.22048780015952
ray_2.0.0,python/ray/workflow/tests/test_variable_mutable.py,28,20,20,1,4,2,4,5,6,8.0,0.5,6.965784284662087,0.3869880158145604,13.931568569324174,3,76.2737032517854
ray_2.0.0,python/ray/workflow/storage/filesystem.py,172,119,118,4,13,10,17,17,27,56.105716335834195,2.6153846153846154,288.63776063598556,16.035431146443642,110.36149671375918,34,62.27314116569696
ray_2.0.0,python/ray/workflow/storage/__init__.py,9,3,8,0,0,0,0,0,0,0,0,0,0.0,0,1,100.0
ray_2.0.0,python/ray/workflow/storage/base.py,76,33,25,0,0,0,0,0,0,0,0,0,0.0,0,8,100.0
ray_2.0.0,python/ray/workflow/storage/debug.py,190,141,153,5,41,26,48,46,74,231.26927266377825,2.926829268292683,1196.322687067958,66.46237150377544,408.74358474821895,36,40.68780929349267
ray_2.0.0,python/ray/workflow/examples/function_chain.py,102,45,59,3,12,6,12,15,18,47.77443751081735,1.5,105.48604608143,5.860335893412778,70.32403072095333,8,77.24738231774289
ray_2.0.0,python/ray/workflow/examples/comparisons/airflow/etl_workflow.py,32,24,23,2,4,2,4,6,6,10.0,1.0,15.509775004326936,0.861654166907052,15.509775004326936,3,61.151977486130356
ray_2.0.0,python/ray/workflow/examples/comparisons/prefect/compute_fib_workflow.py,31,23,24,4,13,7,14,17,21,56.105716335834195,2.1538461538461537,184.87908851193845,10.27106047288547,85.83671966625714,8,67.68151975791713
ray_2.0.0,python/ray/workflow/examples/comparisons/metaflow/foreach_workflow.py,25,16,16,1,2,1,2,3,3,2.0,0.5,2.3774437510817346,0.1320802083934297,4.754887502163469,3,68.5885163204736
ray_2.0.0,python/ray/workflow/examples/comparisons/google_cloud_workflows/data_cond_workflow.py,41,26,26,2,5,3,6,7,9,13.60964047443681,1.2,30.319433158222125,1.6844129532345624,25.26619429851844,4,70.3329794773558
ray_2.0.0,python/ray/workflow/examples/comparisons/google_cloud_workflows/sub_workflows_workflow.py,23,15,15,1,2,1,2,3,3,2.0,0.5,2.3774437510817346,0.1320802083934297,4.754887502163469,2,69.33443681312195
ray_2.0.0,python/ray/workflow/examples/comparisons/google_cloud_workflows/concat_array_workflow.py,15,10,10,3,7,4,8,10,12,24.406371956566698,1.7142857142857142,68.33680652339717,3.796489251299843,39.863137138648355,3,66.5753046855467
ray_2.0.0,python/ray/workflow/examples/comparisons/argo/loops_workflow.py,19,13,13,1,2,1,2,3,3,2.0,0.5,2.3774437510817346,0.1320802083934297,4.754887502163469,3,70.55562609205698
ray_2.0.0,python/ray/workflow/examples/comparisons/argo/hello_world_workflow.py,12,7,7,1,2,1,2,3,3,2.0,0.5,2.3774437510817346,0.1320802083934297,4.754887502163469,2,97.18427176274999
ray_2.0.0,python/ray/workflow/examples/comparisons/argo/exit_handler_workflow.py,45,30,30,1,2,1,2,3,3,2.0,0.5,2.3774437510817346,0.1320802083934297,4.754887502163469,3,62.633276389103756
ray_2.0.0,python/ray/workflow/examples/comparisons/argo/conditionals_workflow.py,29,17,19,2,4,2,4,6,6,10.0,1.0,15.509775004326936,0.861654166907052,15.509775004326936,2,64.55339028023913
ray_2.0.0,python/ray/workflow/examples/comparisons/argo/dag_workflow.py,15,11,11,1,2,1,2,3,3,2.0,0.5,2.3774437510817346,0.1320802083934297,4.754887502163469,2,72.27274666021094
ray_2.0.0,python/ray/workflow/examples/comparisons/argo/multi_step_workflow.py,19,13,13,1,2,1,2,3,3,2.0,0.5,2.3774437510817346,0.1320802083934297,4.754887502163469,2,70.69012901603358
ray_2.0.0,python/ray/workflow/examples/comparisons/argo/retry_workflow.py,45,28,32,4,7,4,8,11,12,27.651484454403228,2.2857142857142856,94.88726725405158,5.27151484744731,41.51317942364757,3,71.17605821113
ray_2.0.0,python/ray/workflow/examples/comparisons/argo/recursion_workflow.py,31,21,21,2,4,2,4,6,6,10.0,1.0,15.509775004326936,0.861654166907052,15.509775004326936,2,62.551514656023485
ray_2.0.0,python/ray/workflow/examples/comparisons/cadence/trip_booking_workflow.py,92,50,65,1,2,1,2,3,3,2.0,0.5,2.3774437510817346,0.1320802083934297,4.754887502163469,3,72.17052045128749
ray_2.0.0,python/ray/workflow/examples/comparisons/cadence/sub_workflow_workflow.py,16,10,10,2,6,3,6,8,9,17.509775004326936,1.0,27.0,1.5,27.0,2,67.89460221653448
ray_2.0.0,python/ray/workflow/examples/comparisons/cadence/file_processing_workflow.py,61,37,37,3,6,3,6,9,9,20.264662506490406,1.5,42.793987519471216,2.377443751081734,28.529325012980813,6,71.06264422706889
ray_2.0.0,python/ray/ray_operator/__init__.py,0,0,0,0,0,0,0,0,0,0,0,0,0.0,0,1,100.0
ray_2.0.0,python/ray/ray_operator/operator.py,327,155,181,3,13,7,13,16,20,52.860603837997665,1.5,120.0,6.666666666666667,80.0,28,64.10539648524113
ray_2.0.0,python/ray/ray_operator/operator_utils.py,331,157,223,7,28,14,28,35,42,154.25742227201613,3.5,754.0046034909101,41.8891446383839,215.4298867116886,19,57.01095020493016
ray_2.0.0,python/ray/autoscaler/__init__.py,3,2,2,0,0,0,0,0,0,0,0,0,0.0,0,1,100.0
ray_2.0.0,python/ray/autoscaler/tags.py,41,20,19,0,0,0,0,0,0,0,0,0,0.0,0,1,100.0
ray_2.0.0,python/ray/autoscaler/node_provider.py,238,99,106,4,8,5,8,12,13,32.0,2.0,93.20902501875007,5.178279167708337,46.604512509375034,29,69.4319091355243
ray_2.0.0,python/ray/autoscaler/command_runner.py,92,20,31,0,0,0,0,0,0,0,0,0,0.0,0,6,100.0
ray_2.0.0,python/ray/autoscaler/kubernetes/__init__.py,0,0,0,0,0,0,0,0,0,0,0,0,0.0,0,1,100.0
ray_2.0.0,python/ray/autoscaler/gcp/__init__.py,0,0,0,0,0,0,0,0,0,0,0,0,0.0,0,1,100.0
ray_2.0.0,python/ray/autoscaler/_private/cli_logger.py,854,409,474,15,142,94,175,157,269,1073.8674499037927,9.242957746478874,18137.021395461623,1007.612299747868,1962.2529814518477,117,33.0269753854284
ray_2.0.0,python/ray/autoscaler/_private/resource_demand_scheduler.py,1036,396,657,16,178,108,206,194,314,1394.6805507120189,9.258426966292134,22094.05673186661,1227.4475962148117,2386.372632446758,128,30.90197971783823
ray_2.0.0,python/ray/autoscaler/_private/node_launcher.py,171,70,125,4,12,6,12,16,18,51.01955000865388,2.0,144.0,8.0,72.0,16,69.16747030078176
ray_2.0.0,python/ray/autoscaler/_private/event_summarizer.py,75,44,40,5,10,6,11,15,17,44.82892142331043,2.75,182.64713534469826,10.147063074705459,66.41714012534482,12,78.99888353006395
ray_2.0.0,python/ray/autoscaler/_private/node_tracker.py,77,32,30,5,14,7,14,19,21,64.91260938324326,2.5,223.01619445578822,12.389788580877124,89.20647778231529,12,77.04206718098234
ray_2.0.0,python/ray/autoscaler/_private/legacy_info_string.py,37,22,25,1,8,7,14,9,21,24.0,0.875,58.2473719015025,3.2359651056390275,66.56842503028857,4,78.96574669541924
ray_2.0.0,python/ray/autoscaler/_private/constants.py,113,33,71,3,6,3,6,9,9,20.264662506490406,1.5,42.793987519471216,2.377443751081734,28.529325012980813,3,85.47742165125184
ray_2.0.0,python/ray/autoscaler/_private/monitor.py,607,273,475,8,50,29,53,58,82,306.1928094887362,4.24,2036.7028323859545,113.15015735477525,480.3544416004609,70,40.111548653464396
ray_2.0.0,python/ray/autoscaler/_private/__init__.py,0,0,0,0,0,0,0,0,0,0,0,0,0.0,0,1,100.0
ray_2.0.0,python/ray/autoscaler/_private/util.py,735,403,495,16,131,83,160,147,243,985.3784132014059,9.770992366412214,17094.550275861853,949.6972375478807,1749.5203797952365,86,34.00445285643778
ray_2.0.0,python/ray/autoscaler/_private/prom_metrics.py,210,59,188,1,2,1,2,3,3,2.0,0.5,2.3774437510817346,0.1320802083934297,4.754887502163469,8,69.0008726993651
ray_2.0.0,python/ray/autoscaler/_private/commands.py,1561,641,1193,13,183,112,205,196,317,1423.478786741814,7.281420765027322,17576.352322015704,976.4640178897613,2413.8630205845207,140,16.119240879840767
ray_2.0.0,python/ray/autoscaler/_private/autoscaler.py,1433,672,978,18,193,113,208,211,321,1540.4028582187013,9.699481865284975,24039.902361059132,1335.5501311699518,2478.4728395750067,204,13.710115449205974
ray_2.0.0,python/ray/autoscaler/_private/event_system.py,106,38,44,4,10,5,10,14,15,41.219280948873624,2.0,114.22064766172811,6.345591536762672,57.110323830864054,11,77.72643249242986
ray_2.0.0,python/ray/autoscaler/_private/docker.py,129,53,93,5,16,10,18,21,28,75.60964047443682,2.8125,345.8949970438274,19.21638872465708,122.9848878378053,18,62.9018916446082
ray_2.0.0,python/ray/autoscaler/_private/cluster_dump.py,652,285,367,7,47,36,54,54,90,280.71716048325214,4.0212765957446805,2082.7794981234174,115.70997211796764,517.9398751947123,74,45.38351044485265
ray_2.0.0,python/ray/autoscaler/_private/command_runner.py,1104,473,899,15,182,115,216,197,331,1425.0219834502905,8.901098901098901,22456.574871587352,1247.5874928659641,2522.8991522400606,154,16.57464032717236
ray_2.0.0,python/ray/autoscaler/_private/subprocess_output_util.py,420,113,217,13,54,41,76,67,117,358.86964145266154,9.148148148148149,6492.737463519969,360.7076368622205,709.7324352835593,33,59.96845093286427
ray_2.0.0,python/ray/autoscaler/_private/providers.py,272,115,160,6,15,9,16,21,25,74.11313393845472,3.2,351.3853938223009,19.521410767905607,109.80793556946902,9,62.12527407689312
ray_2.0.0,python/ray/autoscaler/_private/cli_logger_demoall.py,40,32,32,1,4,2,4,5,6,8.0,0.5,6.965784284662087,0.3869880158145604,13.931568569324174,3,78.30838948643658
ray_2.0.0,python/ray/autoscaler/_private/updater.py,555,258,427,11,78,52,98,89,150,528.3151208762656,6.910256410256411,6712.346767867093,372.90815377039405,971.3600146449596,59,40.63667358469712
ray_2.0.0,python/ray/autoscaler/_private/load_metrics.py,388,191,270,14,71,52,93,85,145,489.9350143936389,9.169014084507042,8521.330386150963,473.4072436750535,929.3616857399669,61,46.35387647651685
ray_2.0.0,python/ray/autoscaler/_private/log_timer.py,33,18,26,3,6,3,6,9,9,20.264662506490406,1.5,42.793987519471216,2.377443751081734,28.529325012980813,7,61.48604005285999
ray_2.0.0,python/ray/autoscaler/_private/kuberay/autoscaling_config.py,386,164,247,10,33,19,36,43,55,199.6842868877026,5.454545454545454,1627.8794264106293,90.43774591170163,298.4445615086154,34,57.473799696865434
ray_2.0.0,python/ray/autoscaler/_private/kuberay/__init__.py,0,0,0,0,0,0,0,0,0,0,0,0,0.0,0,1,100.0
ray_2.0.0,python/ray/autoscaler/_private/kuberay/run_autoscaler.py,91,34,62,0,0,0,0,0,0,0,0,0,0.0,0,3,100.0
ray_2.0.0,python/ray/autoscaler/_private/kuberay/node_provider.py,339,166,229,10,72,43,81,82,124,477.4538810527201,5.625,4434.392523221114,246.3551401789508,788.3364485726426,42,49.56628795080219
ray_2.0.0,python/ray/autoscaler/_private/_kubernetes/__init__.py,58,41,41,1,8,4,8,9,12,24.0,0.5,19.019550008653876,1.0566416671474377,38.03910001730775,7,52.812477608742334
ray_2.0.0,python/ray/autoscaler/_private/_kubernetes/config.py,351,218,253,13,111,72,140,124,212,802.2858775006961,8.198198198198199,12086.518488286812,671.4732493492673,1474.2896178020176,51,38.539893138976694
ray_2.0.0,python/ray/autoscaler/_private/_kubernetes/node_provider.py,253,155,200,10,41,24,47,51,71,252.87891313821507,5.7317073170731705,2308.4004105071804,128.2444672503989,402.7421992799762,45,42.13883231456343
ray_2.0.0,python/ray/autoscaler/_private/readonly/__init__.py,0,0,0,0,0,0,0,0,0,0,0,0,0.0,0,1,100.0
ray_2.0.0,python/ray/autoscaler/_private/readonly/node_provider.py,80,41,53,2,4,2,4,6,6,10.0,1.0,15.509775004326936,0.861654166907052,15.509775004326936,15,77.3698788619
ray_2.0.0,python/ray/autoscaler/_private/staroid/__init__.py,1,1,1,0,0,0,0,0,0,0,0,0,0.0,0,1,100.0
ray_2.0.0,python/ray/autoscaler/_private/staroid/node_provider.py,449,270,345,12,84,51,100,96,151,579.9742135220697,7.142857142857143,7102.352411492105,394.5751339717836,994.3293376088945,67,33.73688731093941
ray_2.0.0,python/ray/autoscaler/_private/staroid/command_runner.py,23,8,18,1,2,1,2,3,3,2.0,0.5,2.3774437510817346,0.1320802083934297,4.754887502163469,3,75.15517382051522
ray_2.0.0,python/ray/autoscaler/_private/gcp/node.py,717,295,487,12,44,28,50,56,78,283.234541228695,6.818181818181818,3088.4569358215444,171.5809408789747,452.97368392049316,71,40.04741284090344
ray_2.0.0,python/ray/autoscaler/_private/gcp/__init__.py,0,0,0,0,0,0,0,0,0,0,0,0,0.0,0,1,100.0
ray_2.0.0,python/ray/autoscaler/_private/gcp/config.py,719,292,470,10,85,54,104,95,158,578.0175105205783,6.117647058823529,6350.345138593772,352.79695214409844,1038.0371861162898,70,37.84842857871789
ray_2.0.0,python/ray/autoscaler/_private/gcp/node_provider.py,221,129,150,6,17,10,20,23,30,84.99664330558272,3.5294117647058822,478.9653835825073,26.60918797680596,135.7068586817104,27,58.213112623825054
ray_2.0.0,python/ray/autoscaler/_private/_azure/__init__.py,0,0,0,0,0,0,0,0,0,0,0,0,0.0,0,1,100.0
ray_2.0.0,python/ray/autoscaler/_private/_azure/config.py,131,72,95,3,12,6,12,15,18,47.77443751081735,1.5,105.48604608143,5.860335893412778,70.32403072095333,12,63.886961017806414
ray_2.0.0,python/ray/autoscaler/_private/_azure/node_provider.py,361,197,261,7,22,14,23,29,37,117.75898006442377,3.659090909090909,657.7043815448852,36.539132308049176,179.74529681972018,46,49.17603535700188
ray_2.0.0,python/ray/autoscaler/_private/local/coordinator_node_provider.py,110,72,80,1,8,4,8,9,12,24.0,0.5,19.019550008653876,1.0566416671474377,38.03910001730775,15,66.72199065243822
ray_2.0.0,python/ray/autoscaler/_private/local/__init__.py,0,0,0,0,0,0,0,0,0,0,0,0,0.0,0,1,100.0
ray_2.0.0,python/ray/autoscaler/_private/local/config.py,121,60,79,5,13,8,16,18,24,59.715356810271004,3.076923076923077,307.9329231834323,17.107384621301794,100.07820003461549,10,71.48559021888798
ray_2.0.0,python/ray/autoscaler/_private/local/node_provider.py,304,169,220,9,44,27,52,53,79,268.7443162330219,5.318181818181818,2406.50767097853,133.69487060991833,452.50571591049277,50,48.8853261346511
ray_2.0.0,python/ray/autoscaler/_private/aws/utils.py,181,74,120,4,28,14,28,32,42,142.6059378176129,2.0,420.0,23.333333333333332,210.0,6,68.03615285164801
ray_2.0.0,python/ray/autoscaler/_private/aws/__init__.py,0,0,0,0,0,0,0,0,0,0,0,0,0.0,0,1,100.0
ray_2.0.0,python/ray/autoscaler/_private/aws/config.py,1195,488,760,15,128,91,165,143,256,954.6033589341278,9.66796875,17720.681558526514,984.4823088070285,1832.9270622152676,111,30.831685568313045
ray_2.0.0,python/ray/autoscaler/_private/aws/node_provider.py,660,341,483,12,101,57,111,113,168,715.4989097665853,6.594059405940594,7555.407759868422,419.74487554824566,1145.7900656857516,92,33.09566517307617
ray_2.0.0,python/ray/autoscaler/_private/aws/cloudwatch/__init__.py,0,0,0,0,0,0,0,0,0,0,0,0,0.0,0,1,100.0
ray_2.0.0,python/ray/autoscaler/_private/aws/cloudwatch/cloudwatch_helper.py,794,398,622,8,64,42,82,72,124,408.0,5.125,3920.987338416589,217.83262991203273,765.0707001788467,100,31.072126105516837
ray_2.0.0,python/ray/autoscaler/_private/aliyun/utils.py,461,246,269,2,36,21,42,38,63,188.11730005192322,1.1666666666666667,385.72267223810354,21.42903734656131,330.61943334694587,46,53.17217728870851
ray_2.0.0,python/ray/autoscaler/_private/aliyun/__init__.py,0,0,0,0,0,0,0,0,0,0,0,0,0.0,0,1,100.0
ray_2.0.0,python/ray/autoscaler/_private/aliyun/config.py,116,70,86,5,32,18,36,37,54,171.60964047443682,2.8125,791.1857299048968,43.95476277249426,281.3104817439633,15,58.74900163405548
ray_2.0.0,python/ray/autoscaler/_private/aliyun/node_provider.py,324,198,270,11,73,44,87,84,131,489.91094060325156,6.554794520547945,5488.942865352773,304.94127029737626,837.3935823840176,64,33.19656291092019
ray_2.0.0,python/ray/autoscaler/_private/fake_multi_node/__init__.py,0,0,0,0,0,0,0,0,0,0,0,0,0.0,0,1,100.0
ray_2.0.0,python/ray/autoscaler/_private/fake_multi_node/docker_monitor.py,243,112,159,8,35,21,37,43,58,203.5249055930738,4.228571428571429,1330.8301901246516,73.93501056248064,314.7233557727217,25,58.82550229270674
ray_2.0.0,python/ray/autoscaler/_private/fake_multi_node/node_provider.py,655,295,516,9,63,42,68,72,110,405.09796019347556,4.857142857142857,3296.5027864848926,183.13904369360515,678.6917501586544,80,30.166006639846692
ray_2.0.0,python/ray/autoscaler/_private/fake_multi_node/command_runner.py,91,40,65,7,10,7,12,17,19,52.87076540327685,4.2,326.1795347317771,18.121085262876505,77.66179398375645,15,69.23212055412809
ray_2.0.0,python/ray/autoscaler/_private/fake_multi_node/test_utils.py,398,215,251,9,35,27,42,44,69,208.05423060605463,5.4,2034.1842211042572,113.01023450579207,376.70078168597354,58,48.22015967042597
ray_2.0.0,python/ray/autoscaler/sdk/__init__.py,29,2,28,0,0,0,0,0,0,0,0,0,0.0,0,1,100.0
ray_2.0.0,python/ray/autoscaler/sdk/sdk.py,343,91,163,3,10,7,11,13,18,37.974168451037094,1.65,109.90305962879044,6.105725534932803,66.60791492653966,12,71.2067433085768
ray_2.0.0,python/ray/autoscaler/local/coordinator_server.py,124,65,80,3,14,7,14,17,21,58.05785641096992,1.5,128.75507949938572,7.153059972188095,85.83671966625714,5,70.57129912454336
ray_2.0.0,python/ray/autoscaler/local/__init__.py,0,0,0,0,0,0,0,0,0,0,0,0,0.0,0,1,100.0
ray_2.0.0,python/ray/autoscaler/aws/__init__.py,0,0,0,0,0,0,0,0,0,0,0,0,0.0,0,1,100.0
ray_2.0.0,python/ray/autoscaler/aliyun/__init__.py,0,0,0,0,0,0,0,0,0,0,0,0,0.0,0,1,100.0
ray_2.0.0,python/ray/autoscaler/azure/__init__.py,0,0,0,0,0,0,0,0,0,0,0,0,0.0,0,1,100.0
ray_2.0.0,doc/test_myst_doc.py,76,40,49,4,13,8,14,17,22,56.105716335834195,2.1538461538461537,193.68285463155456,10.76015859064192,89.92418250750748,10,70.65618356183724
ray_2.0.0,doc/kubernetes/example_scripts/job_example.py,55,34,37,5,8,5,10,13,15,35.60964047443681,3.125,173.4581117878637,9.636561765992427,55.506595772116384,9,73.34806485371757
ray_2.0.0,doc/kubernetes/example_scripts/run_on_head.py,53,33,37,5,8,5,10,13,15,35.60964047443681,3.125,173.4581117878637,9.636561765992427,55.506595772116384,9,69.71906941263887
ray_2.0.0,doc/kubernetes/example_scripts/run_local_example.py,62,35,38,5,8,5,10,13,15,35.60964047443681,3.125,173.4581117878637,9.636561765992427,55.506595772116384,9,77.62965952606302
ray_2.0.0,doc/source/preprocess_github_markdown.py,54,19,33,1,2,1,2,3,3,2.0,0.5,2.3774437510817346,0.1320802083934297,4.754887502163469,3,95.48798400923386
ray_2.0.0,doc/source/custom_directives.py,257,116,185,5,13,9,15,18,24,59.715356810271004,2.8846153846153846,288.68711548446777,16.038173082470433,100.07820003461549,27,55.7432000566629
ray_2.0.0,doc/source/conf.py,324,74,190,4,13,8,16,17,24,56.105716335834195,2.4615384615384617,241.47472785232782,13.415262658462657,98.09910819000817,7,73.4773890989764
ray_2.0.0,doc/source/ray-air/examples/pytorch_tabular_starter.py,149,58,88,1,2,1,2,3,3,2.0,0.5,2.3774437510817346,0.1320802083934297,4.754887502163469,3,84.46584356207617
ray_2.0.0,doc/source/ray-air/examples/tf_tabular_starter.py,179,62,115,1,2,1,2,3,3,2.0,0.5,2.3774437510817346,0.1320802083934297,4.754887502163469,2,82.08021259958187
ray_2.0.0,doc/source/ray-air/examples/tf_tabular_batch_prediction.py,44,21,30,0,0,0,0,0,0,0,0,0,0.0,0,1,100.0
ray_2.0.0,doc/source/ray-air/examples/torch_image_batch_pretrained.py,42,21,29,0,0,0,0,0,0,0,0,0,0.0,0,2,100.0
ray_2.0.0,doc/source/ray-air/examples/xgboost_batch_prediction.py,41,17,26,0,0,0,0,0,0,0,0,0,0.0,0,1,100.0
ray_2.0.0,doc/source/ray-air/examples/xgboost_starter.py,87,27,46,0,0,0,0,0,0,0,0,0,0.0,0,1,100.0
ray_2.0.0,doc/source/ray-air/examples/pytorch_tabular_batch_prediction.py,41,19,27,0,0,0,0,0,0,0,0,0,0.0,0,1,100.0
ray_2.0.0,doc/source/ray-air/doc_code/report_metrics_and_save_checkpoints.py,56,24,39,0,0,0,0,0,0,0,0,0,0.0,0,2,100.0
ray_2.0.0,doc/source/ray-air/doc_code/hf_trainer.py,89,35,59,3,4,3,6,7,9,12.75488750216347,2.25,56.848937171666485,3.158274287314805,25.26619429851844,4,80.1221514740878
ray_2.0.0,doc/source/ray-air/doc_code/tf_starter.py,113,55,77,3,6,3,6,9,9,20.264662506490406,1.5,42.793987519471216,2.377443751081734,28.529325012980813,5,71.03409726062019
ray_2.0.0,doc/source/ray-air/doc_code/preprocessors.py,200,91,90,1,5,4,8,6,12,11.60964047443681,0.8,24.8156400069231,1.3786466670512834,31.019550008653873,6,74.92979724476452
ray_2.0.0,doc/source/ray-air/doc_code/rl_trainer.py,16,5,15,0,0,0,0,0,0,0,0,0,0.0,0,1,100.0
ray_2.0.0,doc/source/ray-air/doc_code/predictors.py,100,39,54,2,4,2,4,6,6,10.0,1.0,15.509775004326936,0.861654166907052,15.509775004326936,2,85.91654066786165
ray_2.0.0,doc/source/ray-air/doc_code/lightgbm_trainer.py,13,8,11,1,2,1,2,3,3,2.0,0.5,2.3774437510817346,0.1320802083934297,4.754887502163469,2,75.28967674449181
ray_2.0.0,doc/source/ray-air/doc_code/tuner.py,242,75,169,0,0,0,0,0,0,0,0,0,0.0,0,4,100.0
ray_2.0.0,doc/source/ray-air/doc_code/torch_trainer.py,64,41,50,2,4,2,4,6,6,10.0,1.0,15.509775004326936,0.861654166907052,15.509775004326936,6,67.44868155769399
ray_2.0.0,doc/source/ray-air/doc_code/air_ingest.py,307,128,198,1,2,6,12,3,18,2.0,3.0,85.58797503894243,4.754887502163468,28.529325012980813,13,69.30826750376634
ray_2.0.0,doc/source/ray-air/doc_code/air_key_concepts.py,147,62,85,0,0,0,0,0,0,0,0,0,0.0,0,2,100.0
ray_2.0.0,doc/source/ray-air/doc_code/xgboost_trainer.py,13,8,11,1,2,1,2,3,3,2.0,0.5,2.3774437510817346,0.1320802083934297,4.754887502163469,2,75.28967674449181
ray_2.0.0,doc/source/ray-air/doc_code/pytorch_starter.py,145,69,93,6,21,13,26,27,39,107.74844088268091,3.7142857142857144,688.7794181705368,38.26552323169649,185.4406125843753,7,67.79084663375535
ray_2.0.0,doc/source/ray-air/doc_code/hvd_trainer.py,72,50,61,2,4,2,4,6,6,10.0,1.0,15.509775004326936,0.861654166907052,15.509775004326936,6,68.59201287747855
ray_2.0.0,doc/source/ray-air/doc_code/sklearn_trainer.py,13,8,11,1,2,1,2,3,3,2.0,0.5,2.3774437510817346,0.1320802083934297,4.754887502163469,2,75.28967674449181
ray_2.0.0,doc/source/ray-air/doc_code/checkpoint_mlflow.py,28,9,9,0,0,0,0,0,0,0,0,0,0.0,0,2,100.0
ray_2.0.0,doc/source/cluster/doc_code/xgboost_submit.py,19,6,14,0,0,0,0,0,0,0,0,0,0.0,0,1,100.0
ray_2.0.0,doc/source/cluster/doc_code/slurm-launch.py,108,46,91,2,4,2,4,6,6,10.0,1.0,15.509775004326936,0.861654166907052,15.509775004326936,4,71.7091145140946
ray_2.0.0,doc/source/cluster/doc_code/simple-trainer.py,32,20,20,1,2,1,2,3,3,2.0,0.5,2.3774437510817346,0.1320802083934297,4.754887502163469,3,87.50096861101913
ray_2.0.0,doc/source/cluster/doc_code/yarn/example.py,50,32,36,4,6,4,8,10,12,23.509775004326936,2.6666666666666665,106.3016990363956,5.905649946466422,39.863137138648355,6,68.87200234894533
ray_2.0.0,doc/source/train/doc_code/key_concepts.py,155,50,97,1,2,1,2,3,3,2.0,0.5,2.3774437510817346,0.1320802083934297,4.754887502163469,4,85.35792942191607
ray_2.0.0,doc/source/train/doc_code/xgboost_train_predict.py,33,15,21,1,2,1,2,3,3,2.0,0.5,2.3774437510817346,0.1320802083934297,4.754887502163469,3,95.35831663965777
ray_2.0.0,doc/source/train/doc_code/gbdt_user_guide.py,194,44,125,0,0,0,0,0,0,0,0,0,0.0,0,1,100.0
ray_2.0.0,doc/source/rllib/doc_code/training.py,131,34,28,0,0,0,0,0,0,0,0,0,0.0,0,1,100.0
ray_2.0.0,doc/source/workflows/doc_code/wait_for_event_http.py,49,22,25,2,10,7,14,12,21,35.219280948873624,1.4,105.397897521202,5.855438751177889,75.28421251514429,7,85.86801793092204
ray_2.0.0,doc/source/ray-overview/doc_test/ray_data.py,10,5,5,0,0,0,0,0,0,0,0,0,0.0,0,1,100.0
ray_2.0.0,doc/source/ray-overview/doc_test/ray_rllib.py,11,5,10,0,0,0,0,0,0,0,0,0,0.0,0,1,100.0
ray_2.0.0,doc/source/ray-overview/doc_test/ray_train.py,38,26,26,1,2,1,2,3,3,2.0,0.5,2.3774437510817346,0.1320802083934297,4.754887502163469,3,82.91170664913817
ray_2.0.0,doc/source/ray-overview/doc_test/ray_tune.py,32,16,20,5,12,7,13,17,20,54.62919048309069,2.7083333333333335,221.4042372343934,12.300235401910745,81.7492568250068,2,83.45382197933824
ray_2.0.0,doc/source/ray-overview/doc_test/ray_core.py,35,15,15,1,2,1,2,3,3,2.0,0.5,2.3774437510817346,0.1320802083934297,4.754887502163469,3,98.42257273196164
ray_2.0.0,doc/source/ray-overview/doc_test/ray_serve.py,42,25,25,0,0,0,0,0,0,0,0,0,0.0,0,4,100.0
ray_2.0.0,doc/source/serve/doc_code/migration_example.py,219,120,123,0,0,0,0,0,0,0,0,0,0.0,0,17,100.0
ray_2.0.0,doc/source/serve/doc_code/tutorial_sklearn.py,80,43,51,0,0,0,0,0,0,0,0,0,0.0,0,3,100.0
ray_2.0.0,doc/source/serve/doc_code/quickstart_graph.py,35,21,22,2,4,2,4,6,6,10.0,1.0,15.509775004326936,0.861654166907052,15.509775004326936,3,85.01899571023871
ray_2.0.0,doc/source/serve/doc_code/deploying_serve_example.py,54,27,27,0,0,0,0,0,0,0,0,0,0.0,0,1,100.0
ray_2.0.0,doc/source/serve/doc_code/batching_guide.py,35,19,19,2,8,5,10,10,15,26.0,1.25,62.28615177913805,3.4603417655076694,49.82892142331044,5,86.40532722114182
ray_2.0.0,doc/source/serve/doc_code/key-concepts-deployment-graph.py,27,19,19,2,6,3,6,8,9,17.509775004326936,1.0,27.0,1.5,27.0,4,61.5448753416849
ray_2.0.0,doc/source/serve/doc_code/transformers_example.py,29,14,17,0,0,0,0,0,0,0,0,0,0.0,0,3,100.0
ray_2.0.0,doc/source/serve/doc_code/ml_models_examples.py,26,16,16,0,0,0,0,0,0,0,0,0,0.0,0,5,100.0
ray_2.0.0,doc/source/serve/doc_code/production_fruit_example.py,213,114,154,4,22,15,28,26,43,106.10749561002054,2.5454545454545454,514.4844927856251,28.582471821423617,202.11890788006698,22,55.05189033022492
ray_2.0.0,doc/source/serve/doc_code/http_guide.py,112,70,68,1,10,5,10,11,15,33.219280948873624,0.5,25.945737139779734,1.4414298410988742,51.89147427955947,11,67.90614679003647
ray_2.0.0,doc/source/serve/doc_code/quickstart.py,24,13,12,0,0,0,0,0,0,0,0,0,0.0,0,3,100.0
ray_2.0.0,doc/source/serve/doc_code/handle_guide.py,121,75,74,3,9,5,10,12,15,33.28421251514428,1.6666666666666667,89.62406251802892,4.9791145843349405,53.77443751081735,14,69.1083916408409
ray_2.0.0,doc/source/serve/doc_code/managing_deployments.py,79,31,38,0,0,0,0,0,0,0,0,0,0.0,0,3,100.0
ray_2.0.0,doc/source/serve/doc_code/local_dev.py,34,20,20,2,5,3,6,7,9,13.60964047443681,1.2,30.319433158222125,1.6844129532345624,25.26619429851844,6,86.14943389901588
ray_2.0.0,doc/source/serve/doc_code/fastapi_example.py,23,13,12,0,0,0,0,0,0,0,0,0,0.0,0,2,100.0
ray_2.0.0,doc/source/serve/doc_code/tutorial_batch.py,34,17,17,0,0,0,0,0,0,0,0,0,0.0,0,5,100.0
ray_2.0.0,doc/source/serve/doc_code/tutorial_tensorflow.py,75,34,40,2,4,3,5,6,8,10.0,1.25,25.84962500721156,1.43609027817842,20.67970000576925,4,85.37813235012926
ray_2.0.0,doc/source/serve/doc_code/sklearn_quickstart.py,44,26,25,0,0,0,0,0,0,0,0,0,0.0,0,3,100.0
ray_2.0.0,doc/source/serve/doc_code/tutorial_pytorch.py,54,27,37,0,0,0,0,0,0,0,0,0,0.0,0,4,100.0
ray_2.0.0,doc/source/serve/doc_code/getting_started/model_graph.py,77,38,40,1,2,1,2,3,3,2.0,0.5,2.3774437510817346,0.1320802083934297,4.754887502163469,7,86.90514127057784
ray_2.0.0,doc/source/serve/doc_code/getting_started/models.py,63,24,27,1,4,2,4,5,6,8.0,0.5,6.965784284662087,0.3869880158145604,13.931568569324174,7,90.16990596612622
ray_2.0.0,doc/source/serve/doc_code/getting_started/model_deployment.py,59,28,26,1,2,1,2,3,3,2.0,0.5,2.3774437510817346,0.1320802083934297,4.754887502163469,5,92.09472552397894
ray_2.0.0,doc/source/serve/doc_code/getting_started/model_deployment_full.py,45,25,23,1,2,1,2,3,3,2.0,0.5,2.3774437510817346,0.1320802083934297,4.754887502163469,5,90.69770979583868
ray_2.0.0,doc/source/serve/doc_code/model_composition/deployment_graph_viz.py,38,24,24,1,6,3,6,7,9,15.509775004326936,0.5,12.63309714925922,0.701838730514401,25.26619429851844,3,79.22349941172916
ray_2.0.0,doc/source/serve/doc_code/model_composition/arithmetic.py,99,56,56,3,8,5,10,11,15,28.75488750216347,1.875,97.296514274174,5.405361904120777,51.89147427955947,7,73.49279727177161
ray_2.0.0,doc/source/serve/doc_code/model_composition/class_nodes.py,96,54,55,1,7,4,8,8,12,19.651484454403228,0.5714285714285714,20.57142857142857,1.1428571428571428,36.0,12,74.99462494952147
ray_2.0.0,doc/source/serve/doc_code/deployment_graph_patterns/linear_pipeline.py,37,22,22,4,6,4,7,10,11,23.509775004326936,2.3333333333333335,85.26282110210897,4.736823394561609,36.541209043760986,5,79.35441460999519
ray_2.0.0,doc/source/serve/doc_code/deployment_graph_patterns/conditional.py,49,32,32,2,8,4,8,10,12,26.0,1.0,39.863137138648355,2.2146187299249087,39.863137138648355,6,72.48370441822607
ray_2.0.0,doc/source/serve/doc_code/deployment_graph_patterns/branching_input.py,41,25,25,2,4,2,4,6,6,10.0,1.0,15.509775004326936,0.861654166907052,15.509775004326936,4,79.86234502662232
ray_2.0.0,doc/source/serve/doc_code/monitoring/metrics_snippet.py,23,13,13,1,2,1,2,3,3,2.0,0.5,2.3774437510817346,0.1320802083934297,4.754887502163469,3,91.78869651335508
ray_2.0.0,doc/source/serve/doc_code/monitoring/custom_metric_snippet.py,37,23,26,3,6,4,8,9,12,20.264662506490406,2.0,76.0782000346155,4.226566668589751,38.03910001730775,6,74.3175320406152
ray_2.0.0,doc/source/serve/doc_code/monitoring/monitoring.py,27,10,10,0,0,0,0,0,0,0,0,0,0.0,0,2,100.0
ray_2.0.0,doc/source/serve/doc_code/monitoring/deployment_logger.py,29,20,18,2,4,2,4,6,6,10.0,1.0,15.509775004326936,0.861654166907052,15.509775004326936,5,81.23804763340725
ray_2.0.0,doc/source/data/doc_code/tensor.py,498,132,151,1,7,8,16,8,24,19.651484454403228,1.1428571428571428,82.28571428571428,4.571428571428571,72.0,10,52.08092724610994
ray_2.0.0,doc/source/data/doc_code/quick_start.py,156,36,42,4,8,4,8,12,12,32.0,2.0,86.03910001730776,4.779950000961542,43.01955000865388,7,56.83321088145468
ray_2.0.0,doc/source/data/doc_code/key_concepts.py,91,29,46,2,6,3,6,8,9,17.509775004326936,1.0,27.0,1.5,27.0,2,86.8939952756024
ray_2.0.0,doc/source/data/doc_code/transforming_datasets.py,554,162,166,8,33,19,38,41,57,190.46500593882897,4.606060606060606,1406.600926303366,78.14449590574255,305.38046426323075,5,43.15857596805321
ray_2.0.0,doc/source/data/doc_code/accessing_datasets.py,222,105,115,3,19,19,38,22,57,85.46551025759159,3.0,762.5628067869778,42.36460037705432,254.18760226232595,36,63.46412144845665
ray_2.0.0,doc/source/data/doc_code/creating_datasets.py,592,108,130,4,10,7,14,14,21,41.219280948873624,2.8,223.8724694169871,12.437359412054839,79.95445336320968,8,28.473577518539027
ray_2.0.0,doc/source/data/doc_code/saving_datasets.py,91,21,21,0,0,0,0,0,0,0,0,0,0.0,0,1,100.0
ray_2.0.0,doc/source/tune/doc_code/faq.py,377,137,237,4,8,7,11,12,18,32.0,2.75,177.45564378569725,9.85864687698318,64.52932501298082,20,64.62128078959194
ray_2.0.0,doc/source/tune/doc_code/keras_hyperopt.py,38,16,22,0,0,0,0,0,0,0,0,0,0.0,0,1,100.0
ray_2.0.0,doc/source/tune/doc_code/key_concepts.py,163,62,99,4,17,12,20,21,32,77.48686830125578,2.3529411764705883,330.7156647739302,18.373092487440566,140.55415752892034,6,74.22462867058209
ray_2.0.0,doc/source/tune/doc_code/pytorch_optuna.py,121,70,94,7,19,11,21,26,32,100.36210720983135,3.8684210526315788,581.8649587930447,32.32583104405804,150.41407098051496,10,63.52752975752528
ray_2.0.0,doc/source/ray-core/_examples/datasets_train/datasets_train.py,705,338,498,16,88,51,99,104,150,632.4299824400822,9.0,9045.593619490473,502.53297886058186,1005.0659577211637,52,39.279605837505514
ray_2.0.0,doc/source/ray-core/examples/lm/ray_train.py,180,100,115,7,25,13,25,32,38,135.74788919877133,3.5,665.0,36.94444444444444,190.0,16,60.90169638358915
ray_2.0.0,doc/source/ray-core/examples/lbfgs/driver.py,144,73,77,5,11,6,11,16,17,49.663388279447084,2.5,170.0,9.444444444444445,68.0,14,73.79159801814028
ray_2.0.0,doc/source/ray-core/doc_code/monte_carlo_pi.py,90,40,46,7,19,14,26,26,40,100.36210720983135,4.7894736842105265,900.5052933701883,50.02807185389935,188.0175887256437,11,76.88652102878719
ray_2.0.0,doc/source/ray-core/doc_code/actor-pool.py,17,11,10,1,2,1,2,3,3,2.0,0.5,2.3774437510817346,0.1320802083934297,4.754887502163469,2,95.65344129371219
ray_2.0.0,doc/source/ray-core/doc_code/tf_example.py,97,42,50,2,4,2,4,6,6,10.0,1.0,15.509775004326936,0.861654166907052,15.509775004326936,8,84.41683686577547
ray_2.0.0,doc/source/ray-core/doc_code/tasks.py,36,15,15,1,2,1,2,3,3,2.0,0.5,2.3774437510817346,0.1320802083934297,4.754887502163469,3,98.22573898398117
ray_2.0.0,doc/source/ray-core/doc_code/getting_started.py,75,26,26,2,3,2,4,5,6,6.754887502163469,1.3333333333333333,18.575424759098897,1.0319680421721609,13.931568569324174,6,82.83466407502164
ray_2.0.0,doc/source/ray-core/doc_code/actor-repr.py,19,13,13,0,0,0,0,0,0,0,0,0,0.0,0,4,100.0
ray_2.0.0,doc/source/ray-core/doc_code/placement_group_capture_child_tasks_example.py,32,14,19,0,0,0,0,0,0,0,0,0,0.0,0,1,100.0
ray_2.0.0,doc/source/ray-core/doc_code/obj_ref.py,18,8,7,0,0,0,0,0,0,0,0,0,0.0,0,1,100.0
ray_2.0.0,doc/source/ray-core/doc_code/get_or_create.py,19,11,11,1,3,2,4,4,6,4.754887502163469,0.6666666666666666,8.0,0.4444444444444444,12.0,5,91.65612549969401
ray_2.0.0,doc/source/ray-core/doc_code/task_locality_aware_scheduling.py,40,15,18,1,3,2,4,4,6,4.754887502163469,0.6666666666666666,8.0,0.4444444444444444,12.0,2,95.7239795950645
ray_2.0.0,doc/source/ray-core/doc_code/actor-queue.py,19,12,12,1,1,1,1,2,2,0.0,0.5,1.0,0.05555555555555555,2.0,4,90.27847497094041
ray_2.0.0,doc/source/ray-core/doc_code/runtime_env_example.py,91,34,47,0,0,0,0,0,0,0,0,0,0.0,0,2,100.0
ray_2.0.0,doc/source/ray-core/doc_code/torch_example.py,200,89,125,5,23,14,27,28,41,115.65156546374811,2.9347826086956523,578.450206382366,32.13612257679811,197.10155180436175,16,65.26790601137988
ray_2.0.0,doc/source/ray-core/doc_code/actor-sync.py,46,23,23,0,0,0,0,0,0,0,0,0,0.0,0,7,100.0
ray_2.0.0,doc/source/ray-core/doc_code/gotchas.py,34,18,17,0,0,0,0,0,0,0,0,0,0.0,0,1,100.0
ray_2.0.0,doc/source/ray-core/doc_code/deser.py,15,6,6,0,0,0,0,0,0,0,0,0,0.0,0,1,100.0
ray_2.0.0,doc/source/ray-core/doc_code/metrics_example.py,61,34,44,4,7,4,7,11,11,27.651484454403228,2.0,76.10749561002055,4.228194200556697,38.053747805010275,3,72.22520419513475
ray_2.0.0,doc/source/ray-core/doc_code/obj_val.py,20,8,7,0,0,0,0,0,0,0,0,0,0.0,0,1,100.0
ray_2.0.0,doc/source/ray-core/doc_code/obj_capture.py,16,7,6,0,0,0,0,0,0,0,0,0,0.0,0,1,100.0
ray_2.0.0,doc/source/ray-core/doc_code/original_resource_unavailable_example.py,28,12,15,0,0,0,0,0,0,0,0,0,0.0,0,1,100.0
ray_2.0.0,doc/source/ray-core/doc_code/actor-http-server.py,33,25,25,1,2,1,2,3,3,2.0,0.5,2.3774437510817346,0.1320802083934297,4.754887502163469,6,75.73056797472302
ray_2.0.0,doc/yarn/example.py,50,32,36,4,6,4,8,10,12,23.509775004326936,2.6666666666666665,106.3016990363956,5.905649946466422,39.863137138648355,6,68.87200234894533
ray_2.0.0,cpp/test_python_call_cpp.py,102,70,75,2,26,14,28,28,42,124.2114326716684,1.0769230769230769,217.44036108999006,12.080020060555004,201.90890672641936,14,41.72732781086194
ray_2.0.0,cpp/src/ray/test/cluster/test_cross_language_invocation.py,21,14,14,1,2,1,2,3,3,2.0,0.5,2.3774437510817346,0.1320802083934297,4.754887502163469,3,69.85355056639015
ray_2.0.0,rllib/evaluate.py,555,273,423,11,59,40,69,70,109,385.12968771735893,6.432203389830509,4297.302654871814,238.73903638176748,668.0918488470014,74,38.83697490029646
ray_2.0.0,rllib/__init__.py,74,38,55,2,6,3,6,8,9,17.509775004326936,1.0,27.0,1.5,27.0,5,68.44793784098447
ray_2.0.0,rllib/train.py,287,106,242,7,20,12,21,27,33,106.09004635215048,3.675,576.6489818248747,32.036054545826374,156.91128757139447,22,52.750055241797625
ray_2.0.0,rllib/rollout.py,15,9,9,1,2,1,2,3,3,2.0,0.5,2.3774437510817346,0.1320802083934297,4.754887502163469,2,98.40493427763637
ray_2.0.0,rllib/scripts.py,48,23,37,1,4,3,6,5,9,8.0,0.75,15.673014640489694,0.8707230355827608,20.89735285398626,4,76.78233776718689
ray_2.0.0,rllib/policy/sample_batch.py,1437,672,779,19,278,216,411,297,627,2337.776240972563,14.04496402877698,72336.87499098365,4018.7152772768695,5150.378088742081,214,12.78905155638184
ray_2.0.0,rllib/policy/dynamic_tf_policy.py,1330,496,928,20,206,143,273,226,416,1669.85767049749,13.25242718446602,43112.72254386253,2395.151252436807,3253.1944483647185,181,18.682044774663673
ray_2.0.0,rllib/policy/eager_tf_policy_v2.py,936,402,604,11,68,41,77,79,118,452.0012210100334,6.227941176470588,4632.629931303741,257.3683295168745,743.8461282848982,126,33.46573933435099
ray_2.0.0,rllib/policy/torch_policy.py,1195,517,802,17,174,107,208,191,315,1364.5590365789346,10.160919540229886,24252.99806269925,1347.3887812610694,2386.890080831261,168,21.220033316638474
ray_2.0.0,rllib/policy/policy.py,1327,435,679,15,133,94,180,148,274,996.955922855786,10.150375939849624,20050.953383053748,1113.941854614097,1975.390222182332,155,27.165396810871016
ray_2.0.0,rllib/policy/__init__.py,15,7,14,0,0,0,0,0,0,0,0,0,0.0,0,1,100.0
ray_2.0.0,rllib/policy/view_requirement.py,147,64,64,4,8,4,8,12,12,32.0,2.0,86.03910001730776,4.779950000961542,43.01955000865388,11,73.32388464152805
ray_2.0.0,rllib/policy/eager_tf_policy.py,993,476,720,12,130,79,147,142,226,955.927365702353,6.7846153846153845,10962.872252500825,609.0484584722681,1615.8428490080582,16,39.13081895737491
ray_2.0.0,rllib/policy/dynamic_tf_policy_v2.py,1049,403,717,14,124,86,163,138,249,915.6233113967791,9.201612903225806,16287.06270073217,904.8368167073427,1770.0225897377643,140,28.19444077971795
ray_2.0.0,rllib/policy/tf_policy.py,1170,535,761,14,143,96,184,157,280,1077.164570068116,9.006993006993007,18396.727460701233,1022.0404144834018,2042.4938096896556,182,20.12280435342325
ray_2.0.0,rllib/policy/torch_mixins.py,199,96,105,6,14,13,22,20,35,68.81274391313339,4.714285714285714,713.1181356564148,39.61767420313416,151.26748332105768,25,67.35954328961164
ray_2.0.0,rllib/policy/torch_policy_v2.py,1203,532,787,17,151,94,181,168,275,1162.4859839393428,10.188741721854305,20712.56356033052,1150.6979755739178,2032.887291264159,163,22.42707565743258
ray_2.0.0,rllib/policy/tf_mixins.py,375,193,250,8,34,29,51,42,80,196.97373660251156,6.0,2588.312362933805,143.7951312741003,431.38539382230084,46,51.72233290958331
ray_2.0.0,rllib/policy/policy_template.py,457,129,269,3,10,5,10,13,15,37.974168451037094,1.5,83.25989365817458,4.625549647676365,55.506595772116384,2,70.7139569009845
ray_2.0.0,rllib/policy/torch_policy_template.py,101,17,95,0,0,0,0,0,0,0,0,0,0.0,0,1,100.0
ray_2.0.0,rllib/policy/tf_policy_template.py,381,112,212,5,10,6,11,15,17,44.82892142331043,2.75,182.64713534469826,10.147063074705459,66.41714012534482,5,71.00610284950065
ray_2.0.0,rllib/policy/rnn_sequencing.py,511,219,310,19,110,83,157,129,240,826.6601912431406,13.559090909090909,22815.808257739165,1267.5449032077313,1682.694541301581,75,45.26453721953483
ray_2.0.0,rllib/policy/policy_map.py,309,151,184,6,39,21,42,45,63,221.64046153995463,3.230769230769231,1117.8033302221784,62.100185012343246,345.9867450687695,33,58.88118950105101
ray_2.0.0,rllib/policy/tests/test_multi_agent_batch.py,241,44,215,3,9,6,12,12,18,33.28421251514428,2.0,129.05865002596164,7.169925001442313,64.52932501298082,11,62.02632724818786
ray_2.0.0,rllib/policy/tests/test_sample_batch.py,349,169,290,2,18,10,20,20,30,77.05865002596161,1.1111111111111112,144.06426982957873,8.003570546087708,129.65784284662087,24,49.175333528671786
ray_2.0.0,rllib/policy/tests/test_policy.py,42,28,32,1,2,1,2,3,3,2.0,0.5,2.3774437510817346,0.1320802083934297,4.754887502163469,6,77.36176415581993
ray_2.0.0,rllib/policy/tests/test_compute_log_likelihoods.py,263,149,216,10,28,20,34,38,54,167.82521876648653,6.071428571428571,1720.570520479004,95.58725113772245,283.3880857259536,30,46.57193317373355
ray_2.0.0,rllib/policy/tests/test_view_requirement.py,38,22,27,2,3,2,3,5,5,6.754887502163469,1.0,11.60964047443681,0.6449800263576005,11.60964047443681,3,74.21046930305268
ray_2.0.0,rllib/policy/tests/test_rnn_sequencing.py,195,98,160,5,21,21,37,26,58,103.84830635279079,4.404761904761905,1200.850432753665,66.71391293075916,272.6255036521834,10,53.28055400666323
ray_2.0.0,rllib/tests/test_io.py,495,279,433,7,64,50,97,71,147,403.6514844544032,5.3046875,4795.5055409306315,266.41697449614617,904.0128265671883,59,30.005630306795332
ray_2.0.0,rllib/tests/test_dependency_torch.py,43,14,26,2,4,3,6,6,9,10.0,1.5,34.89699375973561,1.938721875540867,23.264662506490403,4,92.34079700692719
ray_2.0.0,rllib/tests/test_local.py,30,21,21,1,2,1,2,3,3,2.0,0.5,2.3774437510817346,0.1320802083934297,4.754887502163469,6,65.60879340185666
ray_2.0.0,rllib/tests/test_placement_groups.py,132,75,99,6,24,13,26,30,39,125.5488750216347,3.25,621.9483829933797,34.55268794407665,191.36873322873222,20,57.532034544682205
ray_2.0.0,rllib/tests/test_pettingzoo_env.py,95,65,72,1,2,1,2,3,3,2.0,0.5,2.3774437510817346,0.1320802083934297,4.754887502163469,6,77.44967960866441
ray_2.0.0,rllib/tests/test_filters.py,109,86,88,2,7,4,8,9,12,21.651484454403228,1.1428571428571428,43.47325716263743,2.415180953479857,38.03910001730775,19,44.18057192529379
ray_2.0.0,rllib/tests/test_export.py,159,78,132,7,32,23,38,39,61,179.65148445440323,4.15625,1340.0146313009195,74.44525729449553,322.4095353505972,25,45.17659836455022
ray_2.0.0,rllib/tests/test_lstm.py,331,131,306,4,10,9,16,14,25,41.219280948873624,3.2,304.58839376460827,16.921577431367126,95.18387305144009,21,45.500784162171556
ray_2.0.0,rllib/tests/test_multi_agent_env.py,455,256,400,8,44,29,53,52,82,264.21499122004104,4.818181818181818,2252.19191045829,125.12177280323833,467.4360568875696,27,40.38060003271007
ray_2.0.0,rllib/tests/test_ray_client.py,71,40,53,2,4,2,4,6,6,10.0,1.0,15.509775004326936,0.861654166907052,15.509775004326936,11,69.07435391489648
ray_2.0.0,rllib/tests/test_reproducibility.py,74,50,56,5,10,6,12,15,18,44.82892142331043,3.0,210.97209216286,11.720671786825555,70.32403072095333,11,63.903278826938575
ray_2.0.0,rllib/tests/test_catalog.py,282,163,236,7,44,25,50,51,75,259.8664756744443,3.977272727272727,1692.0586957585429,94.00326087547461,425.4319006478622,24,43.77419690408927
ray_2.0.0,rllib/tests/test_nn_framework_import_errors.py,37,21,20,1,2,1,2,3,3,2.0,0.5,2.3774437510817346,0.1320802083934297,4.754887502163469,3,94.77544508767424
ray_2.0.0,rllib/tests/test_nested_action_spaces.py,128,66,103,4,12,9,13,16,22,51.01955000865388,2.1666666666666665,190.66666666666666,10.592592592592592,88.0,14,63.808807003473426
ray_2.0.0,rllib/tests/test_custom_resource.py,39,17,29,1,2,1,2,3,3,2.0,0.5,2.3774437510817346,0.1320802083934297,4.754887502163469,3,68.01417779800212
ray_2.0.0,rllib/tests/test_rllib_train_and_evaluate.py,278,155,217,8,66,53,84,74,137,422.93001187765793,5.090909090909091,4330.811474645937,240.60063748032982,850.6951110911663,44,40.940687827528635
ray_2.0.0,rllib/tests/test_algorithm_imports.py,23,15,15,1,2,1,2,3,3,2.0,0.5,2.3774437510817346,0.1320802083934297,4.754887502163469,6,68.79642511721552
ray_2.0.0,rllib/tests/test_dnc.py,73,40,58,2,6,3,6,8,9,17.509775004326936,1.0,27.0,1.5,27.0,10,61.54294977913496
ray_2.0.0,rllib/tests/__init__.py,0,0,0,0,0,0,0,0,0,0,0,0,0.0,0,1,100.0
ray_2.0.0,rllib/tests/test_dependency_tf.py,34,14,17,2,4,3,6,6,9,10.0,1.5,34.89699375973561,1.938721875540867,23.264662506490403,4,93.28433315632219
ray_2.0.0,rllib/tests/test_supported_spaces.py,247,135,209,10,27,27,44,37,71,161.6012435072873,8.148148148148149,3013.7652433749704,167.4314024097206,369.87118895965546,26,43.581999691171625
ray_2.0.0,rllib/tests/conftest.py,4,2,2,0,0,0,0,0,0,0,0,0,0.0,0,1,100.0
ray_2.0.0,rllib/tests/mock_worker.py,46,39,35,4,7,7,10,11,17,27.651484454403228,2.857142857142857,168.02953576238303,9.33497420902128,58.81033751683406,13,51.15429799145004
ray_2.0.0,rllib/tests/test_vector_env.py,35,22,23,2,4,2,4,6,6,10.0,1.0,15.509775004326936,0.861654166907052,15.509775004326936,6,61.572787022523336
ray_2.0.0,rllib/tests/test_checkpoint_restore.py,217,105,167,7,27,18,36,34,54,148.0334470128169,4.666666666666667,1282.0406359950857,71.22447977750477,274.72299342751836,37,49.834203532666905
ray_2.0.0,rllib/tests/test_supported_multi_agent.py,171,77,142,6,16,9,18,22,27,79.50977500432694,3.375,406.3657062483237,22.57587256935132,120.40465370320703,21,50.128737251990394
ray_2.0.0,rllib/tests/run_regression_tests.py,171,75,110,10,27,17,31,37,48,161.6012435072873,5.7407407407407405,1435.493816306644,79.74965646148023,250.05376155018962,22,67.36259154514582
ray_2.0.0,rllib/tests/test_nested_observation_spaces.py,645,322,529,5,16,25,40,21,65,75.60964047443682,6.25,1784.3789530038716,99.13216405577064,285.50063248061946,62,33.17735213268395
ray_2.0.0,rllib/tests/test_model_imports.py,220,118,173,5,12,7,13,17,20,54.62919048309069,2.7083333333333335,221.4042372343934,12.300235401910745,81.7492568250068,21,52.559716426168364
ray_2.0.0,rllib/tests/test_perf.py,42,28,31,5,9,6,12,14,18,40.13896548741762,3.3333333333333335,228.44129532345625,12.691183073525346,68.53238859703687,7,72.20466478174664
ray_2.0.0,rllib/tests/test_execution.py,260,184,225,6,78,46,92,84,138,505.7711480755823,3.5384615384615383,3121.417769215351,173.41209828974172,882.1398043434689,61,27.441916797631702
ray_2.0.0,rllib/tests/test_gpus.py,112,63,77,8,22,16,31,30,47,122.10749561002054,5.636363636363637,1299.8799268730204,72.21555149294558,230.62385799360038,19,66.2820048169308
ray_2.0.0,rllib/tests/test_eager_support.py,146,95,101,7,18,11,21,25,32,94.71013448036484,4.083333333333333,606.7972087972306,33.71095604429059,148.60339807279118,33,54.95279486582564
ray_2.0.0,rllib/tests/test_timesteps.py,56,42,40,2,5,3,6,7,9,13.60964047443681,1.2,30.319433158222125,1.6844129532345624,25.26619429851844,9,71.376812341366
ray_2.0.0,rllib/tests/test_multi_agent_pendulum.py,70,26,58,3,5,3,5,8,8,16.36452797660028,1.5,36.0,2.0,24.0,7,66.38573049615887
ray_2.0.0,rllib/tests/backward_compat/test_backward_compat.py,46,21,26,2,6,3,6,8,9,17.509775004326936,1.0,27.0,1.5,27.0,5,88.5163409461074
ray_2.0.0,rllib/tests/backward_compat/old_registry.py,236,115,143,2,7,6,12,9,18,21.651484454403228,1.7142857142857142,97.8148286159342,5.434157145329678,57.058650025961626,10,41.40519599410064
ray_2.0.0,rllib/tests/backward_compat/old_ppo.py,32,4,30,0,0,0,0,0,0,0,0,0,0.0,0,1,100.0
ray_2.0.0,rllib/tests/git_bisect/debug_learning_failure_git_bisect.py,238,97,174,8,20,12,23,28,35,110.43856189774725,4.6,773.9841424512741,42.99911902507078,168.25742227201613,26,62.46234439736447
ray_2.0.0,rllib/models/modelv2.py,509,213,240,13,81,56,103,94,159,561.6335665694888,8.265432098765432,8614.064945129758,478.5591636183199,1042.1796274167443,59,48.33751158672118
ray_2.0.0,rllib/models/utils.py,194,95,134,6,89,58,116,95,174,591.8500503603364,3.9101123595505616,4469.86400893995,248.32577827444163,1143.1548758495849,48,55.093038137645564
ray_2.0.0,rllib/models/preprocessors.py,393,275,288,13,53,42,76,66,118,351.6855004276838,9.320754716981131,6647.921169917791,369.3289538843217,713.2385060842975,71,37.03454369296611
ray_2.0.0,rllib/models/__init__.py,12,5,11,0,0,0,0,0,0,0,0,0,0.0,0,1,100.0
ray_2.0.0,rllib/models/catalog.py,1048,352,784,13,124,86,163,137,249,910.4260588238069,8.544354838709678,15101.378088566718,838.9654493648177,1767.4099886571712,135,30.582711808584474
ray_2.0.0,rllib/models/repeated_values.py,173,81,79,1,3,2,4,4,6,4.754887502163469,0.6666666666666666,8.0,0.4444444444444444,12.0,29,74.89464210672315
ray_2.0.0,rllib/models/action_dist.py,101,48,39,0,0,0,0,0,0,0,0,0,0.0,0,11,100.0
ray_2.0.0,rllib/models/tests/test_attention_nets.py,134,38,95,2,3,4,5,5,9,6.754887502163469,1.6666666666666667,34.82892142331043,1.9349400790728017,20.89735285398626,8,81.33947766571283
ray_2.0.0,rllib/models/tests/test_distributions.py,711,347,560,14,148,188,291,162,479,1120.302067021891,13.763513513513514,48389.59773219321,2688.310985121845,3515.788151381735,77,30.425765316293514
ray_2.0.0,rllib/models/tests/test_convtranspose2d_stack.py,63,44,45,4,7,4,7,11,11,27.651484454403228,2.0,76.10749561002055,4.228194200556697,38.053747805010275,5,73.73467625900435
ray_2.0.0,rllib/models/tests/test_lstms.py,62,24,53,2,3,4,5,5,9,6.754887502163469,1.6666666666666667,34.82892142331043,1.9349400790728017,20.89735285398626,6,71.29603643778783
ray_2.0.0,rllib/models/tests/test_models.py,84,59,65,3,19,14,25,22,39,85.46551025759159,1.9736842105263157,343.2588811714235,19.069937842856863,173.9178331268546,9,58.849897336754786
ray_2.0.0,rllib/models/tests/test_conv2d_default_stacks.py,52,33,40,2,7,4,7,9,11,21.651484454403228,1.0,34.86917501586544,1.937176389770302,34.86917501586544,6,64.67717886772168
ray_2.0.0,rllib/models/tests/test_preprocessors.py,162,84,137,2,10,9,13,12,22,35.219280948873624,1.3,102.52992752062507,5.69610708447917,78.86917501586544,13,55.278795004787256
ray_2.0.0,rllib/models/jax/misc.py,66,26,38,2,4,2,4,6,6,10.0,1.0,15.509775004326936,0.861654166907052,15.509775004326936,7,88.59717011244985
ray_2.0.0,rllib/models/jax/fcnet.py,129,71,100,9,14,14,22,23,36,81.83229392178725,7.071428571428571,1151.5696293847996,63.976090521377756,162.84823041805248,20,59.98940190826126
ray_2.0.0,rllib/models/jax/jax_modelv2.py,33,10,23,0,0,0,0,0,0,0,0,0,0.0,0,2,100.0
ray_2.0.0,rllib/models/jax/__init__.py,0,0,0,0,0,0,0,0,0,0,0,0,0.0,0,1,100.0
ray_2.0.0,rllib/models/jax/jax_action_dist.py,70,50,50,4,6,4,8,10,12,23.509775004326936,2.6666666666666665,106.3016990363956,5.905649946466422,39.863137138648355,13,64.19468396470042
ray_2.0.0,rllib/models/tf/tf_action_dist.py,724,396,497,13,161,117,212,174,329,1228.3833337122876,8.559006211180124,20958.681671832117,1164.3712039906732,2448.7284101342316,110,28.861021934292086
ray_2.0.0,rllib/models/tf/complex_input_net.py,212,96,168,6,19,16,27,25,43,96.22039775975506,4.2631578947368425,851.2921636308088,47.29400909060049,199.68581616031315,19,59.05769094693497
ray_2.0.0,rllib/models/tf/tf_modelv2.py,142,84,95,2,11,8,16,13,24,40.053747805010275,1.4545454545454546,129.17898652419814,7.1766103624554525,88.81055323538621,31,66.33121572749974
ray_2.0.0,rllib/models/tf/noop.py,16,10,9,0,0,0,0,0,0,0,0,0,0.0,0,2,100.0
ray_2.0.0,rllib/models/tf/visionnet.py,503,155,405,10,36,38,60,46,98,219.33658100079685,8.333333333333334,4510.908930779894,250.60605170999412,541.3090716935873,58,45.20131490435426
ray_2.0.0,rllib/models/tf/misc.py,88,37,69,6,23,13,24,29,37,119.55169999363824,3.130434782608696,562.6809291747762,31.260051620820903,179.74529681972018,2,65.21200079121328
ray_2.0.0,rllib/models/tf/fcnet.py,281,111,220,11,32,41,70,43,111,198.0537478050103,12.03125,7246.607009131067,402.58927828505927,602.3153877719328,36,50.18802248955091
ray_2.0.0,rllib/models/tf/__init__.py,11,5,10,0,0,0,0,0,0,0,0,0,0.0,0,1,100.0
ray_2.0.0,rllib/models/tf/recurrent_net.py,459,174,295,6,31,38,59,37,97,169.0898606263201,5.709677419354839,2885.1969301446275,160.2887183413682,505.31697646600816,45,53.333334597923894
ray_2.0.0,rllib/models/tf/attention_net.py,918,307,607,6,59,67,107,65,174,362.58571491667556,5.440677966101695,5701.24291235409,316.735717353005,1047.8919994669511,70,42.38497306717625
ray_2.0.0,rllib/models/tf/layers/skip_connection.py,40,18,16,2,4,2,4,6,6,10.0,1.0,15.509775004326936,0.861654166907052,15.509775004326936,4,90.25356977636852
ray_2.0.0,rllib/models/tf/layers/multi_head_attention.py,55,35,34,6,16,15,25,22,40,79.50977500432694,4.6875,836.1434284944933,46.452412694138516,178.37726474549189,3,77.16988071684075
ray_2.0.0,rllib/models/tf/layers/gru_gate.py,52,30,38,5,19,13,23,24,36,92.32026322986493,3.026315789473684,499.5195987627786,27.75108882015437,165.05865002596164,5,61.22216771485782
ray_2.0.0,rllib/models/tf/layers/__init__.py,17,6,16,0,0,0,0,0,0,0,0,0,0.0,0,1,100.0
ray_2.0.0,rllib/models/tf/layers/relative_multi_head_attention.py,141,69,76,7,35,36,63,42,99,199.17639004747704,6.3,3363.1883765871125,186.84379869928404,533.8394248550973,8,68.88709948128309
ray_2.0.0,rllib/models/tf/layers/noisy_layer.py,112,38,76,5,26,16,30,31,46,133.82107314610522,2.8846153846153846,657.3837411859508,36.52131895477505,227.8930302777963,6,75.35084831940163
ray_2.0.0,rllib/models/torch/torch_modelv2.py,81,29,49,1,1,1,1,2,2,0.0,0.5,1.0,0.05555555555555555,2.0,12,92.47433665940956
ray_2.0.0,rllib/models/torch/complex_input_net.py,234,97,175,6,20,16,28,26,44,101.94833690207419,4.2,868.641259912474,48.25784777291522,206.81934759820808,19,61.93710612156067
ray_2.0.0,rllib/models/torch/noop.py,13,8,7,0,0,0,0,0,0,0,0,0,0.0,0,2,100.0
ray_2.0.0,rllib/models/torch/visionnet.py,293,122,239,13,33,25,41,46,66,214.57072227466315,8.075757575757576,2944.0585225783884,163.55880680991046,364.5550890997629,29,51.11377200275026
ray_2.0.0,rllib/models/torch/misc.py,195,102,119,8,36,23,46,44,69,210.11730005192322,5.111111111111111,1925.35955083942,106.9644194910789,376.70078168597354,21,63.029685971391004
ray_2.0.0,rllib/models/torch/fcnet.py,160,73,132,9,18,17,26,27,43,103.58797503894243,6.5,1328.9910568546895,73.8328364919272,204.46016259302917,20,56.95009469349082
ray_2.0.0,rllib/models/torch/__init__.py,12,0,0,0,0,0,0,0,0,0,0,0,0.0,0,1,100.0
ray_2.0.0,rllib/models/torch/recurrent_net.py,285,104,155,6,20,19,31,26,50,101.94833690207419,4.65,1092.8522344678042,60.714013025989125,235.02198590705464,25,65.2656043043562
ray_2.0.0,rllib/models/torch/torch_action_dist.py,637,370,441,12,99,80,138,111,218,699.3258553965352,8.363636363636363,12388.073146865248,688.2262859369582,1481.1826588643232,100,32.13669877924679
ray_2.0.0,rllib/models/torch/attention_net.py,447,162,296,7,32,33,56,39,89,179.65148445440323,6.125,2881.204884557283,160.06693803096016,470.4007974787401,37,55.34737252924995
ray_2.0.0,rllib/models/torch/modules/skip_connection.py,41,18,18,2,4,2,4,6,6,10.0,1.0,15.509775004326936,0.861654166907052,15.509775004326936,4,91.49145398068916
ray_2.0.0,rllib/models/torch/modules/convtranspose2d_stack.py,82,34,54,6,13,10,18,19,28,63.61549134016113,4.153846153846154,494.066646178977,27.448147009943167,118.94197037642039,8,78.83289359071165
ray_2.0.0,rllib/models/torch/modules/multi_head_attention.py,68,39,39,6,18,17,29,24,46,90.56842503028855,4.833333333333333,1019.3899959936705,56.632777555203916,210.90827503317323,3,77.46746466189026
ray_2.0.0,rllib/models/torch/modules/gru_gate.py,65,37,47,3,16,9,18,19,27,68.75488750216347,1.6875,193.54619733127336,10.752566518404075,114.6940428629768,3,70.69028744364044
ray_2.0.0,rllib/models/torch/modules/__init__.py,13,5,12,0,0,0,0,0,0,0,0,0,0.0,0,1,100.0
ray_2.0.0,rllib/models/torch/modules/relative_multi_head_attention.py,175,80,96,7,36,36,64,43,100,205.76878450632645,6.222222222222222,3376.3425140368613,187.57458411315895,542.6264754702098,8,67.23095564878832
ray_2.0.0,rllib/models/torch/modules/noisy_layer.py,99,34,69,5,27,15,28,32,43,139.9916030328505,2.5925925925925926,557.4074074074074,30.96707818930041,215.0,6,74.02312447492982
ray_2.0.0,rllib/evaluation/sample_batch_builder.py,267,125,154,9,27,18,33,36,51,156.9112875713945,5.5,1450.1639629045685,80.56466460580936,263.6661750735579,38,60.69995520639775
ray_2.0.0,rllib/evaluation/rollout_worker.py,2050,705,1141,13,213,148,281,226,429,1695.598865443938,8.575117370892018,28768.290607094958,1598.238367060831,3354.856774876116,247,9.188284627419185
ray_2.0.0,rllib/evaluation/observation_function.py,74,11,17,0,0,0,0,0,0,0,0,0,0.0,0,2,100.0
ray_2.0.0,rllib/evaluation/episode_v2.py,347,155,198,11,53,34,63,64,97,341.6335318968599,6.537735849056604,3804.9622641509436,211.3867924528302,582.0,36,56.98972255868869
ray_2.0.0,rllib/evaluation/__init__.py,24,8,23,0,0,0,0,0,0,0,0,0,0.0,0,1,100.0
ray_2.0.0,rllib/evaluation/episode.py,466,222,237,7,32,19,36,39,55,179.65148445440323,3.9375,1144.6199180223557,63.58999544568643,290.6971220374237,50,53.86835509201097
ray_2.0.0,rllib/evaluation/sampler.py,1325,515,890,13,111,92,167,124,259,802.2858775006961,9.77927927927928,17613.82022149156,978.5455678606421,1801.1368443902008,153,25.22045069428961
ray_2.0.0,rllib/evaluation/worker_set.py,767,326,509,10,103,64,125,113,189,721.928835248745,6.067961165048544,7821.6858246145075,434.5381013674726,1289.0138238964707,103,36.91750006535944
ray_2.0.0,rllib/evaluation/postprocessing.py,220,65,105,9,36,30,48,45,78,214.64662506490404,6.0,2570.187249082288,142.78818050457156,428.36454151371464,10,69.2460205423584
ray_2.0.0,rllib/evaluation/env_runner_v2.py,1124,427,701,17,150,103,191,167,294,1153.8096718756378,10.823333333333334,23495.390080909987,1305.2994489394437,2170.8090619873715,129,30.352496706554163
ray_2.0.0,rllib/evaluation/metrics.py,249,136,184,8,34,23,45,42,68,196.97373660251156,5.294117647058823,1941.2342722003539,107.84634845557521,366.6775847489557,38,50.61663095425668
ray_2.0.0,rllib/evaluation/tests/test_trajectory_view_api.py,691,332,582,17,125,115,223,142,338,940.2099038840167,15.164,36645.54267821713,2035.8634821231738,2416.614526392583,108,27.404014165645
ray_2.0.0,rllib/evaluation/tests/test_envs_that_crash.py,175,55,133,1,8,4,8,9,12,24.0,0.5,19.019550008653876,1.0566416671474377,38.03910001730775,11,76.50650416313115
ray_2.0.0,rllib/evaluation/tests/test_episode.py,141,94,120,4,16,15,29,20,44,72.0,3.625,689.3475311345343,38.297085063029684,190.16483617504394,26,37.502684211654156
ray_2.0.0,rllib/evaluation/tests/test_rollout_worker.py,918,460,787,12,43,32,56,55,88,276.3489344608441,7.813953488372093,3975.424279290631,220.85690440503507,508.7596547901701,62,30.097805120878395
ray_2.0.0,rllib/evaluation/tests/test_env_runner_v2.py,80,33,60,1,2,1,2,3,3,2.0,0.5,2.3774437510817346,0.1320802083934297,4.754887502163469,6,79.14427171733556
ray_2.0.0,rllib/evaluation/tests/test_agent_collector.py,346,186,240,10,50,56,79,60,135,315.41209043760983,7.9,6299.698820216486,349.98326778980476,797.43023040715,28,49.07913482336429
ray_2.0.0,rllib/evaluation/tests/test_episode_v2.py,104,63,85,2,8,5,10,10,15,26.0,1.25,62.28615177913805,3.4603417655076694,49.82892142331044,16,55.84936047683961
ray_2.0.0,rllib/evaluation/tests/test_postprocessing.py,180,98,155,4,9,7,10,13,17,36.52932501298081,2.2222222222222223,139.7943893519968,7.766354963999823,62.907475208398566,9,54.35131549461279
ray_2.0.0,rllib/evaluation/collectors/__init__.py,0,0,0,0,0,0,0,0,0,0,0,0,0.0,0,1,100.0
ray_2.0.0,rllib/evaluation/collectors/agent_collector.py,556,223,303,14,103,69,126,117,195,742.0125232086779,8.563106796116505,11472.175030302426,637.3430572390237,1339.721120318764,87,44.412368902048286
ray_2.0.0,rllib/evaluation/collectors/simple_list_collector.py,689,299,460,15,108,76,142,123,218,788.1312091677825,9.86111111111111,14924.477710227882,829.1376505682157,1513.4681621639543,109,35.77273599799788
ray_2.0.0,rllib/evaluation/collectors/sample_collector.py,261,54,61,0,0,0,0,0,0,0,0,0,0.0,0,11,100.0
ray_2.0.0,rllib/connectors/__init__.py,0,0,0,0,0,0,0,0,0,0,0,0,0.0,0,1,100.0
ray_2.0.0,rllib/connectors/util.py,101,56,66,3,5,3,5,8,8,16.36452797660028,1.5,36.0,2.0,24.0,7,75.6695588503555
ray_2.0.0,rllib/connectors/connector.py,435,124,140,7,29,20,35,36,55,160.53293331310283,4.224137931034483,1201.1161964557787,66.72867758087659,284.3458750793272,37,50.07538626684731
ray_2.0.0,rllib/connectors/tests/test_connector.py,59,41,41,1,2,1,2,3,3,2.0,0.5,2.3774437510817346,0.1320802083934297,4.754887502163469,3,75.2180605161449
ray_2.0.0,rllib/connectors/tests/test_agent.py,462,224,358,7,39,38,63,46,101,225.78217099003092,5.653846153846154,3154.166321599172,175.23146231106512,557.8797575617583,25,46.58430261992509
ray_2.0.0,rllib/connectors/tests/test_action.py,105,69,75,1,2,1,2,3,3,2.0,0.5,2.3774437510817346,0.1320802083934297,4.754887502163469,7,54.2045466864437
ray_2.0.0,rllib/connectors/action/immutable.py,39,19,29,0,0,0,0,0,0,0,0,0,0.0,0,5,100.0
ray_2.0.0,rllib/connectors/action/__init__.py,0,0,0,0,0,0,0,0,0,0,0,0,0.0,0,1,100.0
ray_2.0.0,rllib/connectors/action/lambdas.py,75,24,50,0,0,0,0,0,0,0,0,0,0.0,0,1,100.0
ray_2.0.0,rllib/connectors/action/normalize.py,43,20,33,0,0,0,0,0,0,0,0,0,0.0,0,6,100.0
ray_2.0.0,rllib/connectors/action/clip.py,40,20,30,0,0,0,0,0,0,0,0,0,0.0,0,6,100.0
ray_2.0.0,rllib/connectors/action/pipeline.py,45,25,36,1,2,1,2,3,3,2.0,0.5,2.3774437510817346,0.1320802083934297,4.754887502163469,11,63.284509851128355
ray_2.0.0,rllib/connectors/agent/clip_reward.py,53,29,43,5,9,6,9,14,15,40.13896548741762,2.5,142.77580957716015,7.931989420953341,57.110323830864054,10,54.45373453732203
ray_2.0.0,rllib/connectors/agent/state_buffer.py,82,48,59,6,14,9,17,20,26,68.81274391313339,3.642857142857143,409.34833241576024,22.74157402309779,112.37013046707143,16,65.9566065702727
ray_2.0.0,rllib/connectors/agent/__init__.py,0,0,0,0,0,0,0,0,0,0,0,0,0.0,0,1,100.0
ray_2.0.0,rllib/connectors/agent/view_requirement.py,132,57,88,7,17,11,19,24,30,89.13835275565901,3.911764705882353,538.0588346434533,29.89215748019185,137.5488750216347,18,69.80065367341805
ray_2.0.0,rllib/connectors/agent/obs_preproc.py,67,30,39,2,5,3,6,7,9,13.60964047443681,1.2,30.319433158222125,1.6844129532345624,25.26619429851844,9,84.41548153415815
ray_2.0.0,rllib/connectors/agent/lambdas.py,86,39,53,3,6,3,6,9,9,20.264662506490406,1.5,42.793987519471216,2.377443751081734,28.529325012980813,6,79.87360918650884
ray_2.0.0,rllib/connectors/agent/pipeline.py,54,32,43,1,2,1,2,3,3,2.0,0.5,2.3774437510817346,0.1320802083934297,4.754887502163469,15,60.407823732712735
ray_2.0.0,rllib/utils/framework.py,333,158,190,8,46,33,64,54,97,278.0838499786226,5.565217391304348,3106.638401167897,172.59102228710537,558.2240877098565,45,55.53699660521184
ray_2.0.0,rllib/utils/sgd.py,136,56,71,7,18,10,19,25,29,94.71013448036484,3.6944444444444446,497.5375923322531,27.64097735179184,134.671829503467,17,73.89108634393638
ray_2.0.0,rllib/utils/actors.py,271,126,141,13,32,22,41,45,63,208.1057163358342,8.328125,2881.420861275846,160.078936737547,345.9867450687695,46,59.373535325133986
ray_2.0.0,rllib/utils/torch_utils.py,588,215,256,15,88,66,117,103,183,627.03334137421,9.971590909090908,12201.53376029999,677.8629866833328,1223.629596474529,44,48.732060373726306
ray_2.0.0,rllib/utils/threading.py,34,14,17,1,2,1,2,3,3,2.0,0.5,2.3774437510817346,0.1320802083934297,4.754887502163469,1,99.30406169489322
ray_2.0.0,rllib/utils/tf_utils.py,545,197,262,14,76,56,101,90,157,528.145459930519,9.302631578947368,9481.43686630918,526.7464925727322,1019.220936123759,50,50.743279971994085
ray_2.0.0,rllib/utils/timer.py,10,4,8,0,0,0,0,0,0,0,0,0,0.0,0,1,100.0
ray_2.0.0,rllib/utils/memory.py,8,3,7,0,0,0,0,0,0,0,0,0,0.0,0,1,100.0
ray_2.0.0,rllib/utils/deprecation.py,128,34,52,5,12,9,17,17,26,54.62919048309069,3.5416666666666665,376.38720329846876,20.910400183248264,106.27403387250884,6,76.66414518651426
ray_2.0.0,rllib/utils/numpy.py,562,241,275,16,112,84,160,128,244,826.4237512704516,11.428571428571429,19520.0,1084.4444444444443,1708.0,54,46.84496615310435
ray_2.0.0,rllib/utils/window_stat.py,9,4,8,0,0,0,0,0,0,0,0,0,0.0,0,1,100.0
ray_2.0.0,rllib/utils/error.py,60,12,35,0,0,0,0,0,0,0,0,0,0.0,0,1,100.0
ray_2.0.0,rllib/utils/policy.py,245,96,147,7,15,9,18,22,27,78.25484338853101,4.2,505.69954555346953,28.094419197414975,120.40465370320703,22,67.86699420601506
ray_2.0.0,rllib/utils/__init__.py,139,43,103,3,8,4,8,11,12,28.75488750216347,1.5,62.26976913547136,3.4594316186372978,41.51317942364757,10,70.69059614075624
ray_2.0.0,rllib/utils/tf_run_builder.py,103,63,84,6,13,8,14,19,22,63.61549134016113,3.230769230769231,301.9296171093748,16.77386761718749,93.45440529575887,19,57.1707818001205
ray_2.0.0,rllib/utils/from_config.py,258,115,150,9,52,36,74,61,110,324.9521903563176,6.403846153846154,4177.748243748626,232.09712465270144,652.3811071319176,51,57.708272027578666
ray_2.0.0,rllib/utils/filter.py,346,213,215,12,60,42,83,72,125,397.432985745165,8.3,6401.297188996399,355.6276216109111,771.240625180289,52,47.98545495151659
ray_2.0.0,rllib/utils/filter_manager.py,66,28,46,0,0,0,0,0,0,0,0,0,0.0,0,10,100.0
ray_2.0.0,rllib/utils/typing.py,192,67,80,0,0,0,0,0,0,0,0,0,0.0,0,5,100.0
ray_2.0.0,rllib/utils/serialization.py,227,124,153,2,8,4,8,10,12,26.0,1.0,39.863137138648355,2.2146187299249087,39.863137138648355,12,64.73233061679342
ray_2.0.0,rllib/utils/annotations.py,161,33,26,1,2,1,2,3,3,2.0,0.5,2.3774437510817346,0.1320802083934297,4.754887502163469,1,39.82745511202315
ray_2.0.0,rllib/utils/test_utils.py,923,422,618,14,191,146,278,205,424,1500.5918750636345,10.188481675392671,33174.710722630065,1843.0394845905591,3256.0995621903094,162,23.528268488174103
ray_2.0.0,rllib/utils/compression.py,91,61,65,7,24,19,38,31,57,129.690584471711,5.541666666666667,1564.9067595434544,86.9392644190808,282.3891896920519,10,59.764627967537926
ray_2.0.0,rllib/utils/images.py,45,31,31,1,2,1,2,3,3,2.0,0.5,2.3774437510817346,0.1320802083934297,4.754887502163469,7,61.784624266453186
ray_2.0.0,rllib/utils/tests/test_errors.py,84,45,58,1,2,1,2,3,3,2.0,0.5,2.3774437510817346,0.1320802083934297,4.754887502163469,11,78.06140246020084
ray_2.0.0,rllib/utils/tests/test_serialization.py,166,91,133,2,4,4,5,6,9,10.0,1.25,29.080828133113002,1.6156015629507223,23.264662506490403,12,46.081877769113575
ray_2.0.0,rllib/utils/tests/test_check_env.py,334,252,288,1,2,1,2,3,3,2.0,0.5,2.3774437510817346,0.1320802083934297,4.754887502163469,21,48.66523386353108
ray_2.0.0,rllib/utils/tests/test_taskpool.py,139,72,84,1,2,1,2,3,3,2.0,0.5,2.3774437510817346,0.1320802083934297,4.754887502163469,20,79.26619053734737
ray_2.0.0,rllib/utils/tests/__init__.py,0,0,0,0,0,0,0,0,0,0,0,0,0.0,0,1,100.0
ray_2.0.0,rllib/utils/tests/test_check_multi_agent.py,53,25,44,1,2,1,2,3,3,2.0,0.5,2.3774437510817346,0.1320802083934297,4.754887502163469,5,64.09152739498799
ray_2.0.0,rllib/utils/tests/run_memory_leak_tests.py,127,56,82,5,14,9,14,19,23,64.91260938324326,2.5,244.25583202300615,13.569768445722564,97.70233280920246,12,74.09620568187643
ray_2.0.0,rllib/utils/tests/test_framework_agnostic_components.py,176,102,125,5,22,16,26,27,42,109.71713608445735,2.9545454545454546,590.0383127684669,32.77990626491483,199.7052750908657,19,62.36181925417282
ray_2.0.0,rllib/utils/tests/test_utils.py,570,83,528,2,8,10,13,10,23,26.0,1.625,124.15706254641518,6.897614585911954,76.40434618240934,8,54.195299116010084
ray_2.0.0,rllib/utils/schedules/schedule.py,75,28,23,1,2,1,2,3,3,2.0,0.5,2.3774437510817346,0.1320802083934297,4.754887502163469,7,80.66719237693924
ray_2.0.0,rllib/utils/schedules/polynomial_schedule.py,67,29,41,8,28,15,31,36,46,158.6059378176129,4.428571428571429,1053.1875788652483,58.51042104806935,237.81655006634637,8,78.81036386540387
ray_2.0.0,rllib/utils/schedules/__init__.py,15,7,14,0,0,0,0,0,0,0,0,0,0.0,0,1,100.0
ray_2.0.0,rllib/utils/schedules/constant_schedule.py,32,19,17,0,0,0,0,0,0,0,0,0,0.0,0,4,100.0
ray_2.0.0,rllib/utils/schedules/exponential_schedule.py,50,22,25,6,12,6,13,18,19,58.52932501298082,3.25,257.4928688390628,14.305159379947932,79.22857502740393,7,85.60844043652455
ray_2.0.0,rllib/utils/schedules/piecewise_schedule.py,102,43,58,9,32,24,43,41,67,188.52932501298082,6.046875,2170.5619676209735,120.58677597894297,358.95598430941163,13,73.71746310225814
ray_2.0.0,rllib/utils/schedules/linear_schedule.py,18,8,6,0,0,0,0,0,0,0,0,0,0.0,0,2,100.0
ray_2.0.0,rllib/utils/schedules/tests/test_schedules.py,127,92,102,11,51,28,56,62,84,327.3474402455566,6.03921568627451,3020.5287635750833,167.80715353194907,500.1524900724976,36,33.4207469503161
ray_2.0.0,rllib/utils/debug/deterministic.py,56,32,33,6,15,11,22,21,33,74.11313393845472,4.4,637.7644897874761,35.431360543748674,144.94647495169912,10,79.48813482669647
ray_2.0.0,rllib/utils/debug/summary.py,79,41,58,3,8,4,8,11,12,28.75488750216347,1.5,62.26976913547136,3.4594316186372978,41.51317942364757,17,71.54707947087311
ray_2.0.0,rllib/utils/debug/memory.py,369,135,234,14,76,52,101,90,153,528.145459930519,9.302631578947368,9239.871595829964,513.3261997683313,993.2535237384402,41,55.45331481818278
ray_2.0.0,rllib/utils/debug/__init__.py,10,4,8,0,0,0,0,0,0,0,0,0,0.0,0,1,100.0
ray_2.0.0,rllib/utils/metrics/window_stat.py,71,34,31,4,12,9,17,16,26,51.01955000865388,2.8333333333333335,294.6666666666667,16.37037037037037,104.0,8,79.0849538912953
ray_2.0.0,rllib/utils/metrics/__init__.py,31,21,23,0,0,0,0,0,0,0,0,0,0.0,0,1,100.0
ray_2.0.0,rllib/utils/metrics/learner_info.py,110,52,69,7,16,13,20,23,33,83.65148445440323,4.375,653.0892574057314,36.28273652254063,149.27754454988144,20,72.59849184284482
ray_2.0.0,rllib/utils/exploration/stochastic_sampling.py,157,58,114,7,17,10,20,24,30,89.13835275565901,4.117647058823529,566.3777206773193,31.46542892651774,137.5488750216347,13,68.60717472125161
ray_2.0.0,rllib/utils/exploration/random.py,169,72,134,5,19,12,24,24,36,92.32026322986493,3.1578947368421053,521.2378421872473,28.95765789929152,165.05865002596164,10,63.18005863223435
ray_2.0.0,rllib/utils/exploration/parameter_noise.py,441,197,295,13,66,48,89,79,137,447.0357282134921,8.765151515151516,7569.742292521247,420.5412384734026,863.6179625002632,66,47.42987737286409
ray_2.0.0,rllib/utils/exploration/epsilon_greedy.py,247,92,168,11,31,18,35,42,53,191.63383342700342,6.209677419354839,1774.6812421258167,98.59340234032315,285.79282340727434,25,63.05205951208914
ray_2.0.0,rllib/utils/exploration/random_encoder.py,293,111,160,10,47,33,61,57,94,294.2849569777226,6.48936170212766,3558.062908640493,197.67016159113848,548.2916613314858,19,62.88784166579473
ray_2.0.0,rllib/utils/exploration/ornstein_uhlenbeck_noise.py,274,97,199,11,63,38,74,74,112,414.62238298550506,6.4603174603174605,4492.88447966397,249.60469331466498,695.4587769504425,23,59.01375788453364
ray_2.0.0,rllib/utils/exploration/gaussian_noise.py,248,86,177,9,36,22,44,45,66,214.64662506490404,5.5,1993.5426739676718,110.75237077598177,362.4623043577585,24,61.939855711728455
ray_2.0.0,rllib/utils/exploration/__init__.py,39,18,38,0,0,0,0,0,0,0,0,0,0.0,0,1,100.0
ray_2.0.0,rllib/utils/exploration/per_worker_gaussian_noise.py,49,19,27,6,10,8,16,16,24,48.72905595320056,4.8,460.79999999999995,25.599999999999998,96.0,5,86.78405138954675
ray_2.0.0,rllib/utils/exploration/slate_epsilon_greedy.py,110,48,84,5,11,6,11,16,17,49.663388279447084,2.5,170.0,9.444444444444445,68.0,8,66.86731498066526
ray_2.0.0,rllib/utils/exploration/slate_soft_q.py,47,24,33,1,2,1,2,3,3,2.0,0.5,2.3774437510817346,0.1320802083934297,4.754887502163469,4,85.7211837505286
ray_2.0.0,rllib/utils/exploration/exploration.py,222,66,97,0,0,0,0,0,0,0,0,0,0.0,0,14,100.0
ray_2.0.0,rllib/utils/exploration/per_worker_epsilon_greedy.py,58,21,34,7,11,10,20,18,30,57.705232259413506,6.363636363636363,796.0765911844414,44.226477288024526,125.09775004326937,6,84.74200804958592
ray_2.0.0,rllib/utils/exploration/thompson_sampling.py,47,27,41,2,5,5,7,7,12,13.60964047443681,1.4,47.16356269056775,2.620197927253764,33.68825906469125,7,57.13933683614068
ray_2.0.0,rllib/utils/exploration/curiosity.py,445,147,298,10,76,54,99,86,153,508.06177197058616,6.5131578947368425,6403.857384175834,355.7698546764352,983.218507469421,30,55.113075433542996
ray_2.0.0,rllib/utils/exploration/per_worker_ornstein_uhlenbeck_noise.py,54,19,32,6,10,8,16,16,24,48.72905595320056,4.8,460.79999999999995,25.599999999999998,96.0,5,86.6297493827011
ray_2.0.0,rllib/utils/exploration/soft_q.py,56,23,35,1,2,1,2,3,3,2.0,0.5,2.3774437510817346,0.1320802083934297,4.754887502163469,5,93.13622861882165
ray_2.0.0,rllib/utils/exploration/upper_confidence_bound.py,45,27,39,2,5,5,7,7,12,13.60964047443681,1.4,47.16356269056775,2.620197927253764,33.68825906469125,7,57.13933683614068
ray_2.0.0,rllib/utils/exploration/tests/test_curiosity.py,290,130,201,9,37,23,43,46,66,221.27909954125198,5.22972972972973,1906.5245875893006,105.91803264385004,364.5550890997629,21,60.431889192891425
ray_2.0.0,rllib/utils/exploration/tests/test_random_encoder.py,75,53,55,3,8,5,9,11,14,28.75488750216347,1.6875,81.72907199030617,4.540503999461453,48.43204266092217,12,62.577574097720394
ray_2.0.0,rllib/utils/exploration/tests/test_explorations.py,204,77,159,6,12,9,17,18,26,58.52932501298082,4.25,460.77671265937545,25.598706258854193,108.41805003750011,26,59.43095007137435
ray_2.0.0,rllib/utils/exploration/tests/test_parameter_noise.py,232,139,158,6,18,11,21,24,32,90.56842503028855,3.5,513.5158000807696,28.528655560042758,146.71880002307702,21,61.70439363164737
ray_2.0.0,rllib/utils/replay_buffers/prioritized_replay_buffer.py,240,109,121,13,43,30,57,56,87,281.4351007880244,8.616279069767442,4353.287787910321,241.84932155057336,505.2398782190116,25,62.236979281393786
ray_2.0.0,rllib/utils/replay_buffers/utils.py,364,129,227,14,56,39,75,70,114,378.5148445440323,9.375,6550.671224359933,363.9261791311074,698.7382639317262,38,57.02830696684783
ray_2.0.0,rllib/utils/replay_buffers/multi_agent_prioritized_replay_buffer.py,284,91,173,10,40,26,51,50,77,246.09640474436813,6.375,2770.427907155668,153.91266150864823,434.5769266126538,31,63.73767504870977
ray_2.0.0,rllib/utils/replay_buffers/__init__.py,28,8,27,0,0,0,0,0,0,0,0,0,0.0,0,1,100.0
ray_2.0.0,rllib/utils/replay_buffers/simple_replay_buffer.py,0,0,0,0,0,0,0,0,0,0,0,0,0.0,0,1,100.0
ray_2.0.0,rllib/utils/replay_buffers/replay_buffer.py,445,188,217,12,51,35,68,63,103,332.3132424492002,8.0,4925.278656963931,273.62659205355175,615.6598321204914,42,53.88399950607861
ray_2.0.0,rllib/utils/replay_buffers/reservoir_replay_buffer.py,132,64,65,5,14,12,24,19,36,64.91260938324326,4.285714285714286,655.3945306455817,36.41080725808787,152.92539048396907,9,72.900445267386
ray_2.0.0,rllib/utils/replay_buffers/multi_agent_mixin_replay_buffer.py,382,128,195,15,47,35,67,62,102,319.66903496297675,10.691489361702128,6493.24110401871,360.73561688992834,607.3280236594613,30,59.18060604071871
ray_2.0.0,rllib/utils/replay_buffers/multi_agent_replay_buffer.py,399,171,240,11,44,30,59,55,89,278.26873902505133,7.375,3794.739981964749,210.8188878869305,514.5410145036948,47,54.84112819334788
ray_2.0.0,rllib/utils/replay_buffers/tests/test_prioritized_replay_buffer_replay_buffer_api.py,593,300,450,10,188,168,307,198,475,1453.4819850642693,8.164893617021276,29589.120455401833,1643.8400253001018,3623.9443945378143,81,31.926338717582226
ray_2.0.0,rllib/utils/replay_buffers/tests/test_multi_agent_replay_buffer.py,335,139,232,6,70,46,91,76,137,444.55958619047465,3.9,3338.2676704329083,185.45931502405045,855.9660693417713,42,49.23659012619145
ray_2.0.0,rllib/utils/replay_buffers/tests/test_segment_tree_replay_buffer_api.py,102,78,78,2,23,19,32,25,51,106.0419249893113,1.391304347826087,329.51188268314564,18.306215704619202,236.83666567851094,52,35.10584164668114
ray_2.0.0,rllib/utils/replay_buffers/tests/__init__.py,0,0,0,0,0,0,0,0,0,0,0,0,0.0,0,1,100.0
ray_2.0.0,rllib/utils/replay_buffers/tests/test_multi_agent_mixin_replay_buffer.py,209,101,148,4,37,27,53,41,80,200.74977452827116,2.864864864864865,1227.8929999773338,68.21627777651855,428.60416036944673,28,59.64181641923676
ray_2.0.0,rllib/utils/replay_buffers/tests/test_reservoir_buffer.py,98,54,71,4,23,16,32,27,48,112.0419249893113,2.782608695652174,635.0875828976598,35.282643494314435,228.2346001038465,6,63.62603204823987
ray_2.0.0,rllib/utils/replay_buffers/tests/test_multi_agent_prioritized_replay_buffer.py,238,109,180,4,48,32,62,52,94,276.0782000346155,2.5833333333333335,1384.2567782219287,76.9031543456627,535.8413335052627,35,49.97012871688579
ray_2.0.0,rllib/utils/replay_buffers/tests/test_replay_buffer.py,386,176,291,7,125,124,247,132,371,890.3745200371642,6.916,18074.760029638215,1004.1533349799008,2613.470218281986,77,35.75342975965994
ray_2.0.0,rllib/utils/spaces/space_utils.py,359,122,157,12,43,36,71,55,107,276.3489344608441,9.906976744186046,6128.510196787931,340.4727887104406,618.6054893471386,20,59.10690126266411
ray_2.0.0,rllib/utils/spaces/__init__.py,0,0,0,0,0,0,0,0,0,0,0,0,0.0,0,1,100.0
ray_2.0.0,rllib/utils/spaces/repeated.py,38,16,22,3,7,3,7,10,10,24.406371956566698,1.5,49.82892142331043,2.7682734124061352,33.219280948873624,9,88.77898683900354
ray_2.0.0,rllib/utils/spaces/flexdict.py,47,26,28,4,13,8,15,17,23,56.105716335834195,2.3076923076923075,216.94995080482573,12.05277504471254,94.01164534875782,13,77.50835240747803
ray_2.0.0,rllib/utils/spaces/simplex.py,61,29,35,6,17,13,21,23,34,84.99664330558272,3.7058823529411766,569.9688064631837,31.664933692399092,153.80110650593844,14,77.7292714772815
ray_2.0.0,rllib/utils/spaces/tests/test_space_utils.py,77,39,64,2,3,2,3,5,5,6.754887502163469,1.0,11.60964047443681,0.6449800263576005,11.60964047443681,5,57.16418422533145
ray_2.0.0,rllib/utils/pre_checks/__init__.py,0,0,0,0,0,0,0,0,0,0,0,0,0.0,0,1,100.0
ray_2.0.0,rllib/utils/pre_checks/env.py,534,231,420,6,99,68,103,105,171,671.8160803922083,3.121212121212121,3583.5759485652547,199.08755269806971,1148.1359835209068,81,35.89973185592546
ray_2.0.0,rllib/utils/pre_checks/multi_agent.py,136,49,90,7,26,17,29,33,46,141.86291712607164,3.9038461538461537,905.8567747417161,50.325376374539786,232.04212949048886,22,71.02687977801578
ray_2.0.0,rllib/agents/trainer_config.py,10,3,9,0,0,0,0,0,0,0,0,0,0.0,0,1,100.0
ray_2.0.0,rllib/agents/mock.py,13,3,11,0,0,0,0,0,0,0,0,0,0.0,0,1,100.0
ray_2.0.0,rllib/agents/__init__.py,8,3,7,0,0,0,0,0,0,0,0,0,0.0,0,1,100.0
ray_2.0.0,rllib/agents/trainer.py,11,4,8,0,0,0,0,0,0,0,0,0,0.0,0,1,100.0
ray_2.0.0,rllib/agents/callbacks.py,13,3,12,0,0,0,0,0,0,0,0,0,0.0,0,1,100.0
ray_2.0.0,rllib/agents/pg/__init__.py,15,6,12,0,0,0,0,0,0,0,0,0,0.0,0,1,100.0
ray_2.0.0,rllib/agents/mbmpo/__init__.py,11,4,7,0,0,0,0,0,0,0,0,0,0.0,0,1,100.0
ray_2.0.0,rllib/agents/qmix/__init__.py,11,4,8,0,0,0,0,0,0,0,0,0,0.0,0,1,100.0
ray_2.0.0,rllib/agents/sac/__init__.py,23,8,19,0,0,0,0,0,0,0,0,0,0.0,0,1,100.0
ray_2.0.0,rllib/agents/a3c/a2c.py,4,1,4,0,0,0,0,0,0,0,0,0,0.0,0,1,100.0
ray_2.0.0,rllib/agents/a3c/a3c.py,6,1,6,0,0,0,0,0,0,0,0,0,0.0,0,1,100.0
ray_2.0.0,rllib/agents/a3c/__init__.py,22,6,19,0,0,0,0,0,0,0,0,0,0.0,0,1,100.0
ray_2.0.0,rllib/agents/bandit/__init__.py,19,4,16,0,0,0,0,0,0,0,0,0,0.0,0,1,100.0
ray_2.0.0,rllib/agents/ddpg/ddpg.py,6,1,6,0,0,0,0,0,0,0,0,0,0.0,0,1,100.0
ray_2.0.0,rllib/agents/ddpg/apex.py,4,1,4,0,0,0,0,0,0,0,0,0,0.0,0,1,100.0
ray_2.0.0,rllib/agents/ddpg/__init__.py,22,8,18,0,0,0,0,0,0,0,0,0,0.0,0,1,100.0
ray_2.0.0,rllib/agents/ddpg/td3.py,4,1,4,0,0,0,0,0,0,0,0,0,0.0,0,1,100.0
ray_2.0.0,rllib/agents/alpha_star/__init__.py,18,4,14,0,0,0,0,0,0,0,0,0,0.0,0,1,100.0
ray_2.0.0,rllib/agents/dreamer/__init__.py,18,4,14,0,0,0,0,0,0,0,0,0,0.0,0,1,100.0
ray_2.0.0,rllib/agents/cql/__init__.py,13,6,11,0,0,0,0,0,0,0,0,0,0.0,0,1,100.0
ray_2.0.0,rllib/agents/marwil/__init__.py,31,7,27,0,0,0,0,0,0,0,0,0,0.0,0,1,100.0
ray_2.0.0,rllib/agents/ppo/appo.py,4,1,4,0,0,0,0,0,0,0,0,0,0.0,0,1,100.0
ray_2.0.0,rllib/agents/ppo/ddppo.py,4,1,4,0,0,0,0,0,0,0,0,0,0.0,0,1,100.0
ray_2.0.0,rllib/agents/ppo/__init__.py,24,9,23,0,0,0,0,0,0,0,0,0,0.0,0,1,100.0
ray_2.0.0,rllib/agents/ppo/ppo.py,6,1,6,0,0,0,0,0,0,0,0,0,0.0,0,1,100.0
ray_2.0.0,rllib/agents/maddpg/__init__.py,19,4,16,0,0,0,0,0,0,0,0,0,0.0,0,1,100.0
ray_2.0.0,rllib/agents/impala/__init__.py,17,4,14,0,0,0,0,0,0,0,0,0,0.0,0,1,100.0
ray_2.0.0,rllib/agents/maml/__init__.py,10,4,7,0,0,0,0,0,0,0,0,0,0.0,0,1,100.0
ray_2.0.0,rllib/agents/slateq/__init__.py,21,6,18,0,0,0,0,0,0,0,0,0,0.0,0,1,100.0
ray_2.0.0,rllib/agents/es/__init__.py,10,6,6,0,0,0,0,0,0,0,0,0,0.0,0,1,100.0
ray_2.0.0,rllib/agents/ars/__init__.py,14,6,11,0,0,0,0,0,0,0,0,0,0.0,0,1,100.0
ray_2.0.0,rllib/agents/dqn/apex.py,4,1,4,0,0,0,0,0,0,0,0,0,0.0,0,1,100.0
ray_2.0.0,rllib/agents/dqn/__init__.py,55,22,52,0,0,0,0,0,0,0,0,0,0.0,0,1,100.0
ray_2.0.0,rllib/agents/dqn/simple_q.py,4,1,4,0,0,0,0,0,0,0,0,0,0.0,0,1,100.0
ray_2.0.0,rllib/agents/dqn/dqn.py,6,1,6,0,0,0,0,0,0,0,0,0,0.0,0,1,100.0
ray_2.0.0,rllib/contrib/__init__.py,0,0,0,0,0,0,0,0,0,0,0,0,0.0,0,1,100.0
ray_2.0.0,rllib/contrib/registry.py,30,12,18,0,0,0,0,0,0,0,0,0,0.0,0,1,100.0
ray_2.0.0,rllib/contrib/random_agent/random_agent.py,54,36,39,4,9,5,9,13,14,36.52932501298081,2.0,103.61231210795059,5.75623956155281,51.80615605397529,8,75.46694627103383
ray_2.0.0,rllib/contrib/sumo/utils.py,329,205,201,11,66,45,87,77,132,436.9837596826682,7.25,5997.314719445021,333.184151080279,827.2158233717271,63,49.01863003375459
ray_2.0.0,rllib/contrib/sumo/connector.py,261,122,162,9,34,19,36,43,55,201.50306161549238,4.764705882352941,1422.0005577763438,79.00003098757466,298.4445615086154,36,60.97958645279272
ray_2.0.0,rllib/contrib/maddpg/__init__.py,7,2,6,0,0,0,0,0,0,0,0,0,0.0,0,1,100.0
ray_2.0.0,rllib/contrib/alpha_zero/__init__.py,7,2,6,0,0,0,0,0,0,0,0,0,0.0,0,1,100.0
ray_2.0.0,rllib/examples/bare_metal_policy_with_custom_view_reqs.py,87,31,71,2,4,2,4,6,6,10.0,1.0,15.509775004326936,0.861654166907052,15.509775004326936,4,77.32968552369496
ray_2.0.0,rllib/examples/eager_execution.py,126,48,72,4,8,4,8,12,12,32.0,2.0,86.03910001730776,4.779950000961542,43.01955000865388,4,80.06532671840135
ray_2.0.0,rllib/examples/restore_1_of_n_agents_from_checkpoint.py,148,57,107,3,6,4,8,9,12,20.264662506490406,2.0,76.0782000346155,4.226566668589751,38.03910001730775,9,72.64911905478192
ray_2.0.0,rllib/examples/multi_agent_custom_policy.py,97,29,72,2,4,2,4,6,6,10.0,1.0,15.509775004326936,0.861654166907052,15.509775004326936,3,85.99275156165952
ray_2.0.0,rllib/examples/custom_model_loss_and_metrics.py,105,38,70,3,12,8,15,15,23,47.77443751081735,1.875,168.48465693561735,9.360258718645408,89.85848369899593,9,77.15519650038321
ray_2.0.0,rllib/examples/cartpole_lstm.py,124,31,81,2,4,2,4,6,6,10.0,1.0,15.509775004326936,0.861654166907052,15.509775004326936,4,86.93644582461253
ray_2.0.0,rllib/examples/coin_game_env.py,92,27,77,1,2,1,2,3,3,2.0,0.5,2.3774437510817346,0.1320802083934297,4.754887502163469,6,81.33703863593482
ray_2.0.0,rllib/examples/remote_base_env_with_custom_api.py,139,57,96,3,7,4,8,10,12,24.406371956566698,1.7142857142857142,68.33680652339717,3.796489251299843,39.863137138648355,9,75.58627720363215
ray_2.0.0,rllib/examples/random_parametric_agent.py,90,46,56,3,6,3,6,9,9,20.264662506490406,1.5,42.793987519471216,2.377443751081734,28.529325012980813,11,75.29311615818105
ray_2.0.0,rllib/examples/custom_experiment.py,57,40,42,6,15,9,17,21,26,74.11313393845472,3.4,388.28086017364245,21.571158898535693,114.20025299224778,6,62.61314451799858
ray_2.0.0,rllib/examples/batch_norm_model.py,89,30,77,3,7,4,8,10,12,24.406371956566698,1.7142857142857142,68.33680652339717,3.796489251299843,39.863137138648355,6,62.604442931867354
ray_2.0.0,rllib/examples/curriculum_learning.py,131,39,83,2,4,2,4,6,6,10.0,1.0,15.509775004326936,0.861654166907052,15.509775004326936,3,85.05360140493796
ray_2.0.0,rllib/examples/complex_struct_space.py,58,22,43,1,4,2,4,5,6,8.0,0.5,6.965784284662087,0.3869880158145604,13.931568569324174,3,83.9981355053868
ray_2.0.0,rllib/examples/rnnsac_stateless_cartpole.py,136,47,120,4,9,5,10,13,15,36.52932501298081,2.2222222222222223,123.34799060470309,6.852666144705727,55.506595772116384,5,60.04768082251844
ray_2.0.0,rllib/examples/custom_train_fn.py,64,34,47,2,4,2,4,6,6,10.0,1.0,15.509775004326936,0.861654166907052,15.509775004326936,4,81.59969262686408
ray_2.0.0,rllib/examples/custom_vector_env.py,69,30,57,1,2,1,2,3,3,2.0,0.5,2.3774437510817346,0.1320802083934297,4.754887502163469,3,79.47226934589564
ray_2.0.0,rllib/examples/custom_keras_model.py,148,68,120,4,11,7,13,15,20,46.053747805010275,2.3636363636363638,184.68937361058454,10.260520756143585,78.13781191217038,17,56.48715719263173
ray_2.0.0,rllib/examples/parametric_actions_cartpole_embeddings_learnt_by_model.py,97,36,70,1,4,2,4,5,6,8.0,0.5,6.965784284662087,0.3869880158145604,13.931568569324174,4,81.95807459584559
ray_2.0.0,rllib/examples/multi_agent_independent_learning.py,37,11,30,1,2,1,2,3,3,2.0,0.5,2.3774437510817346,0.1320802083934297,4.754887502163469,2,95.65344129371219
ray_2.0.0,rllib/examples/hierarchical_training.py,125,38,90,1,2,1,2,3,3,2.0,0.5,2.3774437510817346,0.1320802083934297,4.754887502163469,5,83.0391474378727
ray_2.0.0,rllib/examples/two_step_game.py,181,55,159,2,8,5,10,10,15,26.0,1.25,62.28615177913805,3.4603417655076694,49.82892142331044,8,62.91178026279975
ray_2.0.0,rllib/examples/autoregressive_action_dist.py,203,70,137,6,18,11,20,24,31,90.56842503028855,3.3333333333333335,473.77945840785287,26.321081022658493,142.13383752235586,13,69.58579848301868
ray_2.0.0,rllib/examples/multi_agent_different_spaces_for_agents.py,150,53,106,3,8,6,9,11,15,28.75488750216347,1.6875,87.5668628467566,4.864825713708701,51.89147427955947,8,74.87958303182351
ray_2.0.0,rllib/examples/offline_rl.py,137,77,83,4,6,4,6,10,10,23.509775004326936,2.0,66.43856189774725,3.691031216541514,33.219280948873624,6,76.212722827944
ray_2.0.0,rllib/examples/remote_envs_with_inference_done_on_main_node.py,165,51,121,4,10,5,10,14,15,41.219280948873624,2.0,114.22064766172811,6.345591536762672,57.110323830864054,8,76.01334503745328
ray_2.0.0,rllib/examples/__init__.py,0,0,0,0,0,0,0,0,0,0,0,0,0.0,0,1,100.0
ray_2.0.0,rllib/examples/partial_gpus.py,4,1,3,0,0,0,0,0,0,0,0,0,0.0,0,1,100.0
ray_2.0.0,rllib/examples/parallel_evaluation_and_training.py,165,51,139,8,25,14,28,33,42,140.0964047443681,4.48,949.1531974984866,52.73073319436037,211.86455301305503,15,67.88547972935451
ray_2.0.0,rllib/examples/custom_metrics_and_callbacks.py,171,60,142,6,22,14,26,28,40,113.61727061434748,3.5454545454545454,681.7703344008966,37.8761296889387,192.29419688230416,20,60.23894411557311
ray_2.0.0,rllib/examples/centralized_critic.py,303,121,232,7,24,15,27,31,42,129.690584471711,3.9375,819.3002148302296,45.51667860167942,208.0762450362488,20,54.3386036512086
ray_2.0.0,rllib/examples/trajectory_view_api.py,130,48,111,4,7,4,7,11,11,27.651484454403228,2.0,76.10749561002055,4.228194200556697,38.053747805010275,9,69.4641688883814
ray_2.0.0,rllib/examples/self_play_league_based_with_open_spiel.py,393,172,284,13,54,38,73,67,111,358.86964145266154,8.787037037037036,5916.627492903992,328.7015273835551,673.3359001408127,35,52.68654506619265
ray_2.0.0,rllib/examples/two_trainer_workflow.py,228,100,177,10,27,16,31,37,47,161.6012435072873,5.7407407407407405,1405.5876951335888,78.08820528519938,244.84430818456065,16,58.95383067331103
ray_2.0.0,rllib/examples/deterministic_training.py,73,31,58,1,2,1,2,3,3,2.0,0.5,2.3774437510817346,0.1320802083934297,4.754887502163469,3,85.27009183147977
ray_2.0.0,rllib/examples/multi_agent_cartpole.py,119,52,92,4,9,5,10,13,15,36.52932501298081,2.2222222222222223,123.34799060470309,6.852666144705727,55.506595772116384,7,68.61464310799386
ray_2.0.0,rllib/examples/replay_buffer_api.py,88,29,62,2,4,2,4,6,6,10.0,1.0,15.509775004326936,0.861654166907052,15.509775004326936,4,82.98858281109548
ray_2.0.0,rllib/examples/sb2rllib_rllib_example.py,50,26,34,0,0,0,0,0,0,0,0,0,0.0,0,3,100.0
ray_2.0.0,rllib/examples/checkpoint_by_custom_criteria.py,91,30,61,4,8,4,8,12,12,32.0,2.0,86.03910001730776,4.779950000961542,43.01955000865388,4,83.21745197855911
ray_2.0.0,rllib/examples/compute_adapted_gae_on_postprocess_trajectory.py,150,43,84,6,21,18,30,27,48,107.74844088268091,4.285714285714286,978.1482861593421,54.34157145329678,228.2346001038465,9,75.86291773364074
ray_2.0.0,rllib/examples/custom_env.py,213,102,155,11,26,18,34,37,52,160.26518047667867,7.1923076923076925,1948.3355587452274,108.24086437473485,270.8915750127054,24,57.86306451088612
ray_2.0.0,rllib/examples/custom_rnn_model.py,121,38,84,2,6,3,6,8,9,17.509775004326936,1.0,27.0,1.5,27.0,5,81.29364820304113
ray_2.0.0,rllib/examples/env_rendering_and_recording.py,126,50,82,9,15,13,25,24,38,87.1326839471086,7.5,1306.7143127055297,72.59523959475165,174.22857502740396,13,74.16713022399561
ray_2.0.0,rllib/examples/custom_torch_policy.py,50,26,38,3,5,3,5,8,8,16.36452797660028,1.5,36.0,2.0,24.0,4,75.00950756028924
ray_2.0.0,rllib/examples/vizdoom_with_attention_net.py,82,24,75,3,6,3,6,9,9,20.264662506490406,1.5,42.793987519471216,2.377443751081734,28.529325012980813,3,69.00475499692878
ray_2.0.0,rllib/examples/sb2rllib_sb_example.py,40,25,24,0,0,0,0,0,0,0,0,0,0.0,0,3,100.0
ray_2.0.0,rllib/examples/rollout_worker_custom_workflow.py,126,57,81,4,10,5,10,14,15,41.219280948873624,2.0,114.22064766172811,6.345591536762672,57.110323830864054,17,72.17188303322696
ray_2.0.0,rllib/examples/custom_input_api.py,119,31,70,2,3,2,3,5,5,6.754887502163469,1.0,11.60964047443681,0.6449800263576005,11.60964047443681,3,88.61350062904552
ray_2.0.0,rllib/examples/rock_paper_scissors_multiagent.py,213,89,158,6,25,14,26,31,40,131.60617974869504,3.12,618.2836995362821,34.34909441868234,198.16785241547504,9,60.22827366470367
ray_2.0.0,rllib/examples/custom_tf_policy.py,60,28,45,4,7,4,7,11,11,27.651484454403228,2.0,76.10749561002055,4.228194200556697,38.053747805010275,4,71.73561566891294
ray_2.0.0,rllib/examples/iterated_prisoners_dilemma_env.py,90,29,73,1,2,1,2,3,3,2.0,0.5,2.3774437510817346,0.1320802083934297,4.754887502163469,4,76.45272462027827
ray_2.0.0,rllib/examples/parametric_actions_cartpole.py,110,36,84,1,6,3,6,7,9,15.509775004326936,0.5,12.63309714925922,0.701838730514401,25.26619429851844,5,78.5405245345175
ray_2.0.0,rllib/examples/custom_metrics_and_callbacks_legacy.py,98,50,77,4,15,9,18,19,27,66.60335893412778,2.4,275.2657028711443,15.292539048396906,114.6940428629768,9,58.93564657507711
ray_2.0.0,rllib/examples/centralized_critic_2.py,150,47,119,2,9,5,9,11,14,30.529325012980813,1.0,48.43204266092217,2.6906690367178983,48.43204266092217,8,69.72493578713572
ray_2.0.0,rllib/examples/custom_model_api.py,108,41,79,3,10,14,24,13,38,37.974168451037094,3.6,506.22015344170137,28.123341857872298,140.6167092893615,14,73.14970949142436
ray_2.0.0,rllib/examples/custom_eval.py,210,48,100,2,4,2,4,6,6,10.0,1.0,15.509775004326936,0.861654166907052,15.509775004326936,8,80.52182044532455
ray_2.0.0,rllib/examples/nested_action_spaces.py,88,30,80,3,5,4,6,8,10,16.36452797660028,1.8,54.0,3.0,30.0,4,68.31762252178241
ray_2.0.0,rllib/examples/custom_fast_model.py,65,25,51,3,10,5,10,13,15,37.974168451037094,1.5,83.25989365817458,4.625549647676365,55.506595772116384,5,74.28634873836965
ray_2.0.0,rllib/examples/multi_agent_parameter_sharing.py,54,9,47,1,2,1,2,3,3,2.0,0.5,2.3774437510817346,0.1320802083934297,4.754887502163469,2,98.0558031539458
ray_2.0.0,rllib/examples/dmlab_watermaze.py,32,12,26,0,0,0,0,0,0,0,0,0,0.0,0,3,100.0
ray_2.0.0,rllib/examples/custom_logger.py,134,38,99,4,8,4,8,12,12,32.0,2.0,86.03910001730776,4.779950000961542,43.01955000865388,9,81.4167040181301
ray_2.0.0,rllib/examples/fractional_gpus.py,119,31,71,2,4,2,4,6,6,10.0,1.0,15.509775004326936,0.861654166907052,15.509775004326936,4,87.77930800173566
ray_2.0.0,rllib/examples/attention_net_supervised.py,76,41,60,3,8,6,9,11,15,28.75488750216347,1.6875,87.5668628467566,4.864825713708701,51.89147427955947,5,52.13715151779583
ray_2.0.0,rllib/examples/custom_loss.py,5,1,4,0,0,0,0,0,0,0,0,0,0.0,0,1,100.0
ray_2.0.0,rllib/examples/self_play_with_open_spiel.py,295,121,211,11,38,27,50,49,77,237.47499331586653,7.2368421052631575,3128.723182872093,173.81795460400517,432.33265799687103,23,59.706353299339575
ray_2.0.0,rllib/examples/preprocessing_disabled.py,118,31,93,2,3,3,4,5,7,6.754887502163469,1.3333333333333333,21.67132888561538,1.2039627158675212,16.253496664211536,2,80.86821817142209
ray_2.0.0,rllib/examples/attention_net.py,226,87,163,6,18,10,18,24,28,90.56842503028855,3.0,385.1368500605772,21.396491670032066,128.3789500201924,13,66.5686938429781
ray_2.0.0,rllib/examples/re3_exploration.py,48,20,33,1,2,1,2,3,3,2.0,0.5,2.3774437510817346,0.1320802083934297,4.754887502163469,3,91.39334547512031
ray_2.0.0,rllib/examples/unity3d_env_local.py,200,40,160,4,11,8,16,15,24,46.053747805010275,2.909090909090909,272.7719979479402,15.153999885996676,93.76537429460444,9,73.41462182366091
ray_2.0.0,rllib/examples/action_masking.py,187,60,121,7,16,9,16,23,25,83.65148445440323,3.5,395.81167115498863,21.989537286388256,113.08904890142533,10,73.35953747300513
ray_2.0.0,rllib/examples/mobilenet_v2_with_lstm.py,87,25,71,1,4,4,8,5,12,8.0,1.0,27.863137138648348,1.5479520632582415,27.863137138648348,5,80.71785186911656
ray_2.0.0,rllib/examples/sumo_env_local.py,180,82,143,2,4,2,4,6,6,10.0,1.0,15.509775004326936,0.861654166907052,15.509775004326936,5,68.85399375328952
ray_2.0.0,rllib/examples/multi_agent_two_trainers.py,177,65,137,4,18,11,23,22,34,83.05865002596161,2.5555555555555554,387.475058419374,21.52639213440967,151.6206750336681,13,66.06677202321922
ray_2.0.0,rllib/examples/lstm_auto_wrapping.py,61,24,38,2,4,2,4,6,6,10.0,1.0,15.509775004326936,0.861654166907052,15.509775004326936,5,89.07158886198054
ray_2.0.0,rllib/examples/saving_experiences.py,59,29,44,3,5,3,5,8,8,16.36452797660028,1.5,36.0,2.0,24.0,4,81.46030161570529
ray_2.0.0,rllib/examples/custom_observation_filters.py,144,96,102,6,42,32,64,48,96,241.98710676103488,4.571428571428571,2451.0006860307703,136.16670477948725,536.156400069231,28,51.549590015671406
ray_2.0.0,rllib/examples/recommender_system_with_recsim_and_slateq.py,196,72,168,5,15,10,19,20,29,70.2129994085646,3.1666666666666665,396.89706338048944,22.049836854471636,125.33591475173351,12,57.96640315764489
ray_2.0.0,rllib/examples/policy/bare_metal_policy_with_custom_view_reqs.py,103,43,73,4,11,6,11,15,17,46.053747805010275,2.0,132.83428025068963,7.379682236149424,66.41714012534482,15,74.19370107350117
ray_2.0.0,rllib/examples/policy/random_policy.py,89,44,66,3,5,3,5,8,8,16.36452797660028,1.5,36.0,2.0,24.0,12,72.18261437334226
ray_2.0.0,rllib/examples/policy/episode_env_aware_policy.py,155,65,130,3,7,8,11,10,19,24.406371956566698,2.357142857142857,148.77492253531258,8.265273474184033,63.11663380285989,15,60.99442177559454
ray_2.0.0,rllib/examples/policy/__init__.py,0,0,0,0,0,0,0,0,0,0,0,0,0.0,0,1,100.0
ray_2.0.0,rllib/examples/policy/rock_paper_scissors_dummies.py,92,51,74,2,10,9,16,12,25,35.219280948873624,1.6,143.39850002884626,7.966583334935903,89.62406251802891,10,57.50412856018948
ray_2.0.0,rllib/examples/policy/memory_leaking_policy.py,38,23,22,0,0,0,0,0,0,0,0,0,0.0,0,6,100.0
ray_2.0.0,rllib/examples/models/parametric_actions_model.py,200,66,127,3,15,15,27,18,42,63.35824643629125,2.7,472.8694951635582,26.270527509086566,175.1368500605771,10,68.22768472507396
ray_2.0.0,rllib/examples/models/eager_model.py,63,33,45,2,3,2,3,5,5,6.754887502163469,1.0,11.60964047443681,0.6449800263576005,11.60964047443681,7,78.54986524417043
ray_2.0.0,rllib/examples/models/simple_rpg_model.py,64,39,39,0,0,0,0,0,0,0,0,0,0.0,0,8,100.0
ray_2.0.0,rllib/examples/models/mobilenet_v2_with_lstm_models.py,159,73,118,5,20,17,25,25,42,98.04820237218406,3.125,609.5061249079325,33.86145138377403,195.04195997053841,11,59.12744140067692
ray_2.0.0,rllib/examples/models/autoregressive_action_model.py,161,59,113,2,4,4,6,6,10,10.0,1.5,38.77443751081734,2.1541354172676304,25.84962500721156,9,72.23079791996855
ray_2.0.0,rllib/examples/models/batch_norm_model.py,236,96,164,3,4,5,6,7,11,12.75488750216347,2.25,69.4820343209257,3.860113017829206,30.880904142633646,18,69.06460028111678
ray_2.0.0,rllib/examples/models/modelv3.py,60,26,46,1,1,3,3,2,6,0.0,1.5,9.0,0.5,6.0,4,77.90769390948195
ray_2.0.0,rllib/examples/models/autoregressive_action_dist.py,148,100,101,1,18,10,20,19,30,75.05865002596161,0.5555555555555556,70.79879189072642,3.933266216151468,127.43782540330756,19,59.46050394986249
ray_2.0.0,rllib/examples/models/__init__.py,0,0,0,0,0,0,0,0,0,0,0,0,0.0,0,1,100.0
ray_2.0.0,rllib/examples/models/centralized_critic_models.py,181,78,121,2,8,10,16,10,26,26.0,2.0,172.74026093414287,9.596681163007936,86.37013046707143,15,67.70310013567209
ray_2.0.0,rllib/examples/models/trajectory_view_utilizing_models.py,128,71,101,5,14,19,30,19,49,64.91260938324326,5.357142857142857,1115.080972278941,61.94894290438562,208.14844815873568,9,53.89138381007559
ray_2.0.0,rllib/examples/models/rnn_model.py,141,61,102,3,5,4,6,8,10,16.36452797660028,1.8,54.0,3.0,30.0,10,71.25542316438697
ray_2.0.0,rllib/examples/models/fast_model.py,79,42,55,4,8,8,11,12,19,32.0,2.75,187.3142906626804,10.406349481260023,68.11428751370197,9,71.31952334976083
ray_2.0.0,rllib/examples/models/neural_computer.py,246,100,200,7,29,24,44,36,68,160.53293331310283,5.310344827586207,1866.8777453484101,103.71543029713389,351.5549000980772,25,55.932889491772
ray_2.0.0,rllib/examples/models/custom_loss_model.py,151,69,84,3,8,6,10,11,16,28.75488750216347,1.875,103.78294855911894,5.765719364395497,55.350905898196764,13,74.71574966724211
ray_2.0.0,rllib/examples/models/rnn_spy_model.py,141,57,104,3,6,4,7,9,11,20.264662506490406,1.75,61.021056277764515,3.3900586820980285,34.86917501586544,9,71.88463594178623
ray_2.0.0,rllib/examples/models/custom_model_api.py,176,59,67,3,10,10,16,13,26,37.974168451037094,2.4,230.90743841200413,12.828191022889118,96.21143267166839,9,69.28435044791725
ray_2.0.0,rllib/examples/models/action_mask_model.py,125,50,78,3,15,11,24,18,35,63.35824643629125,2.4,350.2737001211542,19.45965000673079,145.94737505048093,12,70.70235666047788
ray_2.0.0,rllib/examples/models/shared_weights_model.py,205,86,144,3,5,6,8,8,14,16.36452797660028,2.4,100.8,5.6,42.0,16,65.82250027700415
ray_2.0.0,rllib/examples/documentation/custom_gym_env.py,41,27,31,7,8,8,15,15,23,43.65148445440323,6.5625,589.6962992746608,32.76090551525893,89.85848369899593,9,75.50655778606746
ray_2.0.0,rllib/examples/documentation/rllib_on_ray_readme.py,94,37,44,8,11,10,18,19,28,62.053747805010275,6.545454545454546,778.5292606456608,43.2516255914256,118.94197037642039,10,76.19711939136069
ray_2.0.0,rllib/examples/documentation/replay_buffer_demo.py,142,66,95,5,16,10,18,21,28,75.60964047443682,2.8125,345.8949970438274,19.21638872465708,122.9848878378053,9,68.65373290545672
ray_2.0.0,rllib/examples/documentation/rllib_in_60s.py,43,7,28,0,0,0,0,0,0,0,0,0,0.0,0,2,100.0
ray_2.0.0,rllib/examples/documentation/rllib_on_rllib_readme.py,92,36,42,5,12,9,13,17,22,54.62919048309069,2.7083333333333335,243.54466095783278,13.53025894210182,89.92418250750748,6,78.19038061801177
ray_2.0.0,rllib/examples/serving/unity3d_dummy_client.py,157,44,112,4,15,11,20,19,31,66.60335893412778,2.6666666666666665,351.16200777800304,19.50900043211128,131.68575291675114,8,74.61160223916266
ray_2.0.0,rllib/examples/serving/unity3d_server.py,171,44,115,8,18,12,23,26,35,99.05865002596161,5.111111111111111,840.856438467462,46.714246581525664,164.51539013493823,9,75.87697932484575
ray_2.0.0,rllib/examples/serving/cartpole_client.py,128,35,52,4,6,5,8,10,13,23.509775004326936,2.6666666666666665,115.16017395609524,6.397787442005291,43.18506523353572,6,78.5260705550684
ray_2.0.0,rllib/examples/serving/cartpole_server.py,259,83,193,8,28,19,38,36,57,158.6059378176129,5.428571428571429,1599.7225075891497,88.87347264384165,294.6857250822118,18,64.0065763279522
ray_2.0.0,rllib/examples/serving/unity3d_client.py,130,35,80,4,12,8,14,16,22,51.01955000865388,2.3333333333333335,205.33333333333334,11.407407407407408,88.0,5,80.79309026393736
ray_2.0.0,rllib/examples/serving/dummy_client_with_two_episodes.py,90,39,49,1,2,1,2,3,3,2.0,0.5,2.3774437510817346,0.1320802083934297,4.754887502163469,2,89.50637985295727
ray_2.0.0,rllib/examples/inference_and_serving/policy_inference_after_training_with_lstm.py,172,61,138,5,9,6,12,14,18,40.13896548741762,3.3333333333333335,228.44129532345625,12.691183073525346,68.53238859703687,10,68.37903126152807
ray_2.0.0,rllib/examples/inference_and_serving/policy_inference_after_training.py,124,45,99,4,9,5,10,13,15,36.52932501298081,2.2222222222222223,123.34799060470309,6.852666144705727,55.506595772116384,5,72.1588620286671
ray_2.0.0,rllib/examples/inference_and_serving/policy_inference_after_training_with_attention.py,186,64,151,6,13,8,16,19,24,63.61549134016113,3.6923076923076925,376.43173042207775,20.912873912337652,101.95026032264605,11,66.20930535502865
ray_2.0.0,rllib/examples/inference_and_serving/serve_and_rllib.py,121,53,62,2,3,2,3,5,5,6.754887502163469,1.0,11.60964047443681,0.6449800263576005,11.60964047443681,8,82.99591667456538
ray_2.0.0,rllib/examples/simulators/sumo/marlenvironment.py,414,219,244,8,37,21,39,45,60,216.74977452827116,4.216216216216216,1389.2904049093445,77.18280027274136,329.5111857797805,47,52.68966333310266
ray_2.0.0,rllib/examples/connectors/adapt_connector_policy.py,118,57,73,4,8,6,9,12,15,32.0,2.25,120.99248439933903,6.721804688852169,53.77443751081735,8,73.55480084027592
ray_2.0.0,rllib/examples/connectors/run_connector_policy.py,55,25,34,3,6,4,7,9,11,20.264662506490406,1.75,61.021056277764515,3.3900586820980285,34.86917501586544,5,83.6265231061795
ray_2.0.0,rllib/examples/connectors/self_play_with_policy_checkpoint.py,150,41,121,4,11,6,12,15,18,46.053747805010275,2.1818181818181817,153.43424884571635,8.52412493587313,70.32403072095333,9,74.63627737085767
ray_2.0.0,rllib/examples/bandit/tune_lin_ucb_train_recommendation.py,103,38,82,4,12,6,12,16,18,51.01955000865388,2.0,144.0,8.0,72.0,3,70.66252376865769
ray_2.0.0,rllib/examples/bandit/tune_lin_ucb_train_recsim_env.py,82,31,66,4,12,6,12,16,18,51.01955000865388,2.0,144.0,8.0,72.0,3,75.9473099788361
ray_2.0.0,rllib/examples/bandit/lin_ts_train_wheel_env.py,69,41,47,3,8,4,8,11,12,28.75488750216347,1.5,62.26976913547136,3.4594316186372978,41.51317942364757,7,70.83767488322401
ray_2.0.0,rllib/examples/bandit/tune_lin_ts_train_wheel_env.py,104,52,72,4,10,5,10,14,15,41.219280948873624,2.0,114.22064766172811,6.345591536762672,57.110323830864054,6,69.86095156272268
ray_2.0.0,rllib/examples/export/cartpole_dqn_export.py,63,43,47,2,4,2,4,6,6,10.0,1.0,15.509775004326936,0.861654166907052,15.509775004326936,4,70.11035069100629
ray_2.0.0,rllib/examples/export/onnx_tf.py,59,32,32,0,0,0,0,0,0,0,0,0,0.0,0,4,100.0
ray_2.0.0,rllib/examples/export/onnx_torch.py,68,34,39,1,2,1,2,3,3,2.0,0.5,2.3774437510817346,0.1320802083934297,4.754887502163469,4,88.52639558370896
ray_2.0.0,rllib/examples/multi_agent_and_self_play/policy_mapping_fn.py,9,4,3,0,0,0,0,0,0,0,0,0,0.0,0,2,100.0
ray_2.0.0,rllib/examples/multi_agent_and_self_play/__init__.py,0,0,0,0,0,0,0,0,0,0,0,0,0.0,0,1,100.0
ray_2.0.0,rllib/examples/env/halfcheetah_rand_direc.py,66,39,42,5,22,13,23,27,36,109.71713608445735,2.6136363636363638,447.3916877035628,24.855093761309046,171.1759500778849,10,74.467331909005
ray_2.0.0,rllib/examples/env/repeat_after_me_env.py,46,33,32,7,13,10,16,20,26,67.75720079023742,4.3076923076923075,484.0559466273846,26.8919970348547,112.37013046707143,11,70.59246381724127
ray_2.0.0,rllib/examples/env/debug_counter_env.py,70,45,46,8,20,13,25,28,38,110.43856189774725,5.0,913.3974351909446,50.74430195505248,182.67948703818894,13,71.83541443314675
ray_2.0.0,rllib/examples/env/windy_maze_env.py,155,112,129,11,47,30,62,58,92,299.11942383385923,7.25531914893617,3910.139995300897,217.22999973893874,538.9342515517366,33,49.00674178219111
ray_2.0.0,rllib/examples/env/bandit_envs_discrete.py,203,116,141,12,41,34,57,53,91,262.6791821979953,8.341463414634147,4347.91074114429,241.55059673023834,521.2407613652512,28,53.14360002021215
ray_2.0.0,rllib/examples/env/ant_rand_goal.py,86,41,59,5,37,24,41,42,65,204.35941500270798,2.77027027027027,970.9814818719863,53.943415659554795,350.50063248061946,9,71.56540985235257
ray_2.0.0,rllib/examples/env/curriculum_capable_env.py,74,45,49,5,10,6,12,15,18,44.82892142331043,3.0,210.97209216286,11.720671786825555,70.32403072095333,11,73.8360522952538
ray_2.0.0,rllib/examples/env/coin_game_vectorized_env.py,386,187,315,16,87,68,126,103,194,624.5360841388394,11.586206896551724,15029.408633238309,834.9671462910171,1297.1811022735444,59,32.214836739636276
ray_2.0.0,rllib/examples/env/random_env.py,118,55,77,9,20,18,29,29,47,114.96788691072805,6.525,1489.8213216807485,82.76785120448602,228.32510677099592,19,69.7354750666787
ray_2.0.0,rllib/examples/env/pendulum_mass.py,33,14,11,0,0,0,0,0,0,0,0,0,0.0,0,4,100.0
ray_2.0.0,rllib/examples/env/env_with_subprocess.py,42,34,30,1,4,2,4,5,6,8.0,0.5,6.965784284662087,0.3869880158145604,13.931568569324174,7,75.45799299568017
ray_2.0.0,rllib/examples/env/recommender_system_envs_with_recsim.py,108,25,62,0,0,0,0,0,0,0,0,0,0.0,0,2,100.0
ray_2.0.0,rllib/examples/env/two_step_game.py,124,96,103,6,18,14,27,24,41,90.56842503028855,4.5,845.9255813830536,46.99586563239186,187.98346252956745,27,48.814415662934906
ray_2.0.0,rllib/examples/env/stateless_pendulum.py,35,19,16,2,5,4,5,7,9,13.60964047443681,1.0,25.26619429851844,1.403677461028802,25.26619429851844,5,90.84786856018071
ray_2.0.0,rllib/examples/env/__init__.py,0,0,0,0,0,0,0,0,0,0,0,0,0.0,0,1,100.0
ray_2.0.0,rllib/examples/env/fast_image_env.py,19,15,15,2,3,2,4,5,6,6.754887502163469,1.3333333333333333,18.575424759098897,1.0319680421721609,13.931568569324174,4,65.79647271311852
ray_2.0.0,rllib/examples/env/mbmpo_env.py,104,60,57,12,58,48,87,70,135,382.782447726053,9.0,7447.078865588135,413.72660364378527,827.4532072875705,14,67.39290139191542
ray_2.0.0,rllib/examples/env/gpu_requiring_env.py,27,9,8,1,2,1,2,3,3,2.0,0.5,2.3774437510817346,0.1320802083934297,4.754887502163469,3,88.06276403727841
ray_2.0.0,rllib/examples/env/bandit_envs_recommender_system.py,221,78,144,9,28,22,40,37,62,163.13526283059372,6.428571428571429,2076.3392700149675,115.3521816674982,322.9861086689949,27,65.63709339180615
ray_2.0.0,rllib/examples/env/dm_control_suite.py,131,20,109,0,0,0,0,0,0,0,0,0,0.0,0,1,100.0
ray_2.0.0,rllib/examples/env/cartpole_sparse_rewards.py,47,30,38,1,2,1,2,3,3,2.0,0.5,2.3774437510817346,0.1320802083934297,4.754887502163469,7,62.095264693197315
ray_2.0.0,rllib/examples/env/simple_rpg.py,49,20,25,1,2,2,2,3,4,2.0,0.5,3.1699250014423126,0.17610694452457293,6.339850002884625,4,94.14321522078875
ray_2.0.0,rllib/examples/env/nested_space_repeat_after_me_env.py,49,31,33,5,9,7,13,14,20,40.13896548741762,3.611111111111111,274.97563325971583,15.276424069984213,76.14709844115208,9,78.89883295008009
ray_2.0.0,rllib/examples/env/correlated_actions_env.py,43,24,23,3,8,6,12,11,18,28.75488750216347,2.25,140.10698055481055,7.78372114193392,62.26976913547136,6,85.68107333598786
ray_2.0.0,rllib/examples/env/matrix_sequential_social_dilemma.py,317,174,202,14,50,112,151,64,263,335.49577839754267,21.14,33358.92,1853.2733333333333,1578.0,22,51.299575986656734
ray_2.0.0,rllib/examples/env/simple_corridor.py,33,25,24,8,10,9,18,18,27,57.219280948873624,7.2,810.6334202803855,45.03519001557697,112.58797503894243,11,70.12680429105536
ray_2.0.0,rllib/examples/env/env_using_remote_actor.py,67,32,38,3,5,4,6,8,10,16.36452797660028,1.8,54.0,3.0,30.0,7,83.2596793538447
ray_2.0.0,rllib/examples/env/stateless_cartpole.py,39,15,20,2,4,3,5,6,8,10.0,1.25,25.84962500721156,1.43609027817842,20.67970000576925,4,93.35846076085535
ray_2.0.0,rllib/examples/env/parametric_actions_cartpole.py,144,65,99,3,9,8,15,12,23,33.28421251514428,2.5,206.13534379146648,11.45196354397036,82.4541375165866,12,71.75921728745372
ray_2.0.0,rllib/examples/env/d4rl_env.py,46,23,22,0,0,0,0,0,0,0,0,0,0.0,0,2,100.0
ray_2.0.0,rllib/examples/env/cartpole_crashing.py,86,41,49,7,22,13,26,29,39,117.75898006442377,4.136363636363637,783.6806614412617,43.53781452451454,189.46125880997533,13,75.47541625845444
ray_2.0.0,rllib/examples/env/mock_env.py,185,114,117,3,11,11,22,14,33,42.808635307173745,3.0,376.92813728370277,20.94045207131682,125.64271242790092,34,61.21162102862612
ray_2.0.0,rllib/examples/env/memory_leaking_env.py,35,21,20,2,3,2,4,5,6,6.754887502163469,1.3333333333333333,18.575424759098897,1.0319680421721609,13.931568569324174,5,87.63201339721688
ray_2.0.0,rllib/examples/env/transformed_action_space_env.py,56,23,26,5,11,7,13,16,20,49.663388279447084,2.9545454545454546,236.36363636363637,13.131313131313131,80.0,3,85.46330744778571
ray_2.0.0,rllib/examples/env/multi_agent.py,233,187,186,7,38,22,44,45,66,219.07272996525947,4.052631578947368,1468.9261808182844,81.60701004546024,362.4623043577585,38,41.52933659573144
ray_2.0.0,rllib/examples/env/cartpole_mass.py,31,17,14,1,1,1,1,2,2,0.0,0.5,1.0,0.05555555555555555,2.0,4,99.278310843145
ray_2.0.0,rllib/examples/env/coin_game_non_vectorized_env.py,343,216,252,16,71,58,109,87,167,500.6320454848324,12.28169014084507,13214.749347034864,734.1527415019368,1075.9715638067378,64,38.40807970555451
ray_2.0.0,rllib/examples/env/look_and_push.py,65,43,42,4,8,7,12,12,19,32.0,3.0,204.3428625411059,11.35238125228366,68.11428751370197,15,74.29148013226217
ray_2.0.0,rllib/examples/env/action_mask_env.py,42,25,30,1,1,1,1,2,2,0.0,0.5,1.0,0.05555555555555555,2.0,7,86.52811968941215
ray_2.0.0,rllib/examples/env/repeat_initial_obs_env.py,32,23,22,4,5,4,7,9,11,19.60964047443681,2.8,97.63369004442322,5.424093891356845,34.86917501586544,5,81.42459044243334
ray_2.0.0,rllib/examples/env/tests/test_matrix_sequential_social_dilemma.py,322,187,263,8,72,50,96,80,146,468.23460010384645,5.333333333333333,4922.674676552292,273.48192647512735,923.0015018535548,60,30.612099198665835
ray_2.0.0,rllib/examples/env/tests/test_coin_game_non_vectorized_env.py,882,390,766,10,78,59,114,88,173,523.480654020129,7.3076923076923075,8166.2122040233835,453.67845577907684,1117.4816700242525,68,18.32076630629759
ray_2.0.0,rllib/examples/env/tests/__init__.py,0,0,0,0,0,0,0,0,0,0,0,0,0.0,0,1,100.0
ray_2.0.0,rllib/examples/env/tests/test_wrappers.py,58,37,47,5,16,11,22,21,33,75.60964047443682,3.4375,498.2535076464657,27.68075042480365,144.94647495169912,9,49.4479732327025
ray_2.0.0,rllib/examples/env/tests/test_coin_game_vectorized_env.py,906,399,782,10,137,108,209,147,317,1005.6496763144658,7.627737226277373,17408.755177461448,967.1530654145249,2282.2961333131275,89,13.054295989078492
ray_2.0.0,rllib/examples/env/utils/mixins.py,71,43,43,7,30,22,44,37,66,166.8582023226588,5.133333333333334,1764.9628002750883,98.05348890417157,343.8239221315107,18,71.24812771079984
ray_2.0.0,rllib/examples/env/utils/interfaces.py,23,14,14,0,0,0,0,0,0,0,0,0,0.0,0,5,100.0
ray_2.0.0,rllib/examples/env/utils/__init__.py,0,0,0,0,0,0,0,0,0,0,0,0,0.0,0,1,100.0
ray_2.0.0,rllib/examples/tune/framework.py,89,29,70,1,2,1,2,3,3,2.0,0.5,2.3774437510817346,0.1320802083934297,4.754887502163469,6,77.92846655903294
ray_2.0.0,rllib/examples/tune/__init__.py,0,0,0,0,0,0,0,0,0,0,0,0,0.0,0,1,100.0
ray_2.0.0,rllib/env/external_env.py,450,227,279,10,26,17,31,36,48,155.43071362054204,5.961538461538462,1479.3939234896463,82.18855130498035,248.15640006923098,58,51.575741327755814
ray_2.0.0,rllib/env/utils.py,52,19,18,0,0,0,0,0,0,0,0,0,0.0,0,4,100.0
ray_2.0.0,rllib/env/external_multi_agent_env.py,171,65,87,6,15,9,17,21,26,74.11313393845472,3.4,388.28086017364245,21.571158898535693,114.20025299224778,20,72.59147775410072
ray_2.0.0,rllib/env/env_context.py,123,26,48,4,14,10,19,18,29,61.30296890880645,2.7142857142857144,328.23266797067345,18.23514822059297,120.92782504182705,13,74.66080078489571
ray_2.0.0,rllib/env/__init__.py,34,16,32,0,0,0,0,0,0,0,0,0,0.0,0,1,100.0
ray_2.0.0,rllib/env/multi_agent_env.py,779,365,449,11,85,54,96,96,150,582.851977376715,6.211764705882353,6135.635647730771,340.86864709615395,987.7443751081734,121,35.990037787609054
ray_2.0.0,rllib/env/vector_env.py,477,227,282,6,32,20,36,38,56,175.50977500432694,3.375,991.8583000408375,55.103238891157645,293.8839407528408,64,51.50958011269226
ray_2.0.0,rllib/env/remote_vector_env.py,10,4,8,0,0,0,0,0,0,0,0,0,0.0,0,1,100.0
ray_2.0.0,rllib/env/policy_server_input.py,298,152,179,3,15,11,22,18,33,63.35824643629125,2.2,302.7365551047119,16.818697505817326,137.6075250475963,7,64.70195561512975
ray_2.0.0,rllib/env/policy_client.py,412,189,272,9,17,10,19,26,29,98.0161933142366,5.029411764705882,685.5729577135788,38.08738653964327,136.3127518260917,35,56.48668275148547
ray_2.0.0,rllib/env/base_env.py,537,145,193,5,11,7,12,16,19,49.663388279447084,2.727272727272727,207.27272727272725,11.515151515151514,76.0,38,55.0076589937943
ray_2.0.0,rllib/env/remote_base_env.py,403,221,242,9,30,17,32,39,49,175.7360428812364,4.8,1243.1266018764009,69.06258899313337,258.9847087242502,60,52.25466590160483
ray_2.0.0,rllib/env/tests/test_external_env.py,248,185,217,6,16,10,16,22,26,79.50977500432694,3.0,347.8356662537092,19.32420368076162,115.94522208456974,45,34.13681078038835
ray_2.0.0,rllib/env/tests/test_external_multi_agent_env.py,72,46,61,2,4,2,4,6,6,10.0,1.0,15.509775004326936,0.861654166907052,15.509775004326936,9,54.18149878935455
ray_2.0.0,rllib/env/tests/test_multi_agent_env.py,48,27,32,2,3,2,3,5,5,6.754887502163469,1.0,11.60964047443681,0.6449800263576005,11.60964047443681,11,84.99855044819812
ray_2.0.0,rllib/env/tests/test_env_with_subprocess.py,67,32,51,2,4,3,4,6,7,10.0,1.0,18.094737505048094,1.0052631947248942,18.094737505048094,7,71.50354723339602
ray_2.0.0,rllib/env/tests/test_remote_worker_envs.py,99,54,52,1,2,1,2,3,3,2.0,0.5,2.3774437510817346,0.1320802083934297,4.754887502163469,6,85.6386396099755
ray_2.0.0,rllib/env/apis/__init__.py,0,0,0,0,0,0,0,0,0,0,0,0,0.0,0,1,100.0
ray_2.0.0,rllib/env/apis/task_settable_env.py,50,14,10,0,0,0,0,0,0,0,0,0,0.0,0,4,100.0
ray_2.0.0,rllib/env/wrappers/dm_env_wrapper.py,98,61,77,3,10,6,10,13,16,37.974168451037094,1.5,88.81055323538621,4.933919624188123,59.207035490257475,19,46.08914236083664
ray_2.0.0,rllib/env/wrappers/kaggle_wrapper.py,172,74,133,8,32,28,47,40,75,184.0,5.875,2344.9745668097444,130.27636482276358,399.1446071165522,18,62.669563566619374
ray_2.0.0,rllib/env/wrappers/group_agents_wrapper.py,150,81,94,5,18,10,19,23,29,86.66829050039843,2.638888888888889,346.17814413714086,19.232119118730047,131.18329672565338,27,68.21378990604197
ray_2.0.0,rllib/env/wrappers/atari_wrappers.py,327,226,226,14,61,36,72,75,108,415.07794650014256,8.262295081967213,5558.148507558553,308.7860281976974,672.712418573555,66,41.48743076724751
ray_2.0.0,rllib/env/wrappers/uncertainty_wrappers.py,23,11,15,1,2,1,2,3,3,2.0,0.5,2.3774437510817346,0.1320802083934297,4.754887502163469,1,98.05662322584278
ray_2.0.0,rllib/env/wrappers/recsim.py,265,94,138,5,9,7,11,14,18,40.13896548741762,3.0555555555555554,209.4045207131682,11.633584484064901,68.53238859703687,16,71.19087767036719
ray_2.0.0,rllib/env/wrappers/dm_control_wrapper.py,218,122,162,8,43,28,53,51,81,257.3293844521902,4.930232558139535,2265.276464472896,125.84869247071644,459.46645269969116,34,52.53223373929812
ray_2.0.0,rllib/env/wrappers/__init__.py,0,0,0,0,0,0,0,0,0,0,0,0,0.0,0,1,100.0
ray_2.0.0,rllib/env/wrappers/exception_wrapper.py,38,28,30,2,3,2,4,5,6,6.754887502163469,1.3333333333333333,18.575424759098897,1.0319680421721609,13.931568569324174,9,59.2109172704387
ray_2.0.0,rllib/env/wrappers/recsim_wrapper.py,14,3,12,0,0,0,0,0,0,0,0,0,0.0,0,1,100.0
ray_2.0.0,rllib/env/wrappers/model_vector_env.py,135,63,87,5,9,6,11,14,17,40.13896548741762,3.0555555555555554,197.77093622910328,10.987274234950183,64.72503367497926,16,71.8179107993226
ray_2.0.0,rllib/env/wrappers/open_spiel.py,106,63,65,4,21,14,22,25,36,100.23866587835397,2.0952380952380953,350.2794383144364,19.459968795246468,167.17882283189007,23,69.91964693192358
ray_2.0.0,rllib/env/wrappers/pettingzoo_env.py,199,74,100,2,7,5,9,9,14,21.651484454403228,1.2857142857142858,57.05865002596163,3.169925001442313,44.37895002019238,21,73.87716076408282
ray_2.0.0,rllib/env/wrappers/unity3d_env.py,377,120,254,11,43,32,58,54,90,271.3831322572005,7.4186046511627906,3842.391167142168,213.46617595234267,517.9398751947123,35,59.50822065189273
ray_2.0.0,rllib/env/wrappers/tests/test_group_agents_wrapper.py,25,17,19,3,15,9,18,18,27,63.35824643629125,1.8,202.65835507009638,11.258797503894243,112.58797503894243,6,57.98743991875638
ray_2.0.0,rllib/env/wrappers/tests/test_exception_wrapper.py,61,42,46,1,2,1,2,3,3,2.0,0.5,2.3774437510817346,0.1320802083934297,4.754887502163469,7,58.90763297783845
ray_2.0.0,rllib/env/wrappers/tests/test_unity3d_env.py,58,35,37,2,10,5,10,12,15,35.219280948873624,1.0,53.77443751081735,2.987468750600964,53.77443751081735,6,77.40468920994016
ray_2.0.0,rllib/env/wrappers/tests/test_recsim_wrapper.py,46,34,36,1,2,1,2,3,3,2.0,0.5,2.3774437510817346,0.1320802083934297,4.754887502163469,6,70.94233567100689
ray_2.0.0,rllib/env/wrappers/tests/test_kaggle_wrapper.py,68,51,54,5,8,5,9,13,14,35.60964047443681,2.8125,145.70481390180552,8.09471188343364,51.80615605397529,7,57.941519742142056
ray_2.0.0,rllib/tuned_examples/cleanup_experiment.py,186,84,130,12,31,22,42,43,64,196.59963563064704,8.129032258064516,2823.057998833401,156.8365554907445,347.28094430093427,23,63.82201495620607
ray_2.0.0,rllib/tuned_examples/create_plots.py,5,0,0,0,0,0,0,0,0,0,0,0,0.0,0,1,100.0
ray_2.0.0,rllib/execution/common.py,47,20,31,1,1,1,1,2,2,0.0,0.5,1.0,0.05555555555555555,2.0,2,93.60130407735025
ray_2.0.0,rllib/execution/parallel_requests.py,251,101,134,10,33,24,42,43,66,199.6842868877026,6.363636363636363,2279.031196974881,126.61284427638228,358.13347381033844,36,62.55522530297111
ray_2.0.0,rllib/execution/learner_thread.py,131,63,92,4,7,4,7,11,11,27.651484454403228,2.0,76.10749561002055,4.228194200556697,38.053747805010275,10,74.12850431185306
ray_2.0.0,rllib/execution/replay_ops.py,212,90,96,9,30,21,42,39,63,175.7360428812364,6.3,2097.7761406664263,116.54311892591257,332.98033978832166,24,64.54093134368448
ray_2.0.0,rllib/execution/minibatch_buffer.py,58,28,32,6,13,9,18,19,27,63.61549134016113,4.153846153846154,476.42140881544213,26.46785604530234,114.6940428629768,6,82.43379618368957
ray_2.0.0,rllib/execution/multi_gpu_impl.py,11,4,8,0,0,0,0,0,0,0,0,0,0.0,0,1,100.0
ray_2.0.0,rllib/execution/__init__.py,63,9,62,0,0,0,0,0,0,0,0,0,0.0,0,1,100.0
ray_2.0.0,rllib/execution/multi_gpu_learner.py,15,5,12,0,0,0,0,0,0,0,0,0,0.0,0,1,100.0
ray_2.0.0,rllib/execution/metric_ops.py,241,87,143,8,23,17,32,31,49,128.0419249893113,5.565217391304348,1350.9877938585428,75.05487743658571,242.75561920895692,23,67.01740890983157
ray_2.0.0,rllib/execution/multi_gpu_learner_thread.py,231,88,132,6,12,8,14,18,22,58.52932501298082,3.5,321.08422511105806,17.838012506169893,91.73835003173087,21,70.12590190634485
ray_2.0.0,rllib/execution/rollout_ops.py,431,161,218,13,57,40,77,70,117,380.5804471432245,8.780701754385966,6296.870518381963,349.8261399101091,717.1261129825612,45,54.91898301462827
ray_2.0.0,rllib/execution/train_ops.py,575,250,353,14,88,54,104,102,158,621.7329513488886,8.272727272727273,8721.466506078741,484.5259170043745,1054.2432040314961,66,45.82371555503121
ray_2.0.0,rllib/execution/concurrency_ops.py,148,57,66,5,15,9,16,20,25,70.2129994085646,2.6666666666666665,288.12853965915747,16.007141092175416,108.04820237218406,18,72.62364640034254
ray_2.0.0,rllib/execution/tree_agg.py,140,61,101,3,10,6,12,13,18,37.974168451037094,1.8,119.8942468677714,6.660791492653967,66.60791492653966,10,68.91069082543964
ray_2.0.0,rllib/execution/segment_tree.py,212,75,79,13,45,43,83,58,126,295.2391056706696,11.988888888888889,8849.06609123971,491.6147828466506,738.1056053860741,29,58.33673357417349
ray_2.0.0,rllib/execution/tests/test_async_requests_manager.py,266,165,229,8,81,57,96,89,153,537.5278502336546,4.7407407407407405,4697.06531526096,260.94807307005334,990.7872149378588,63,31.800507919942856
ray_2.0.0,rllib/execution/buffers/__init__.py,0,0,0,0,0,0,0,0,0,0,0,0,0.0,0,1,100.0
ray_2.0.0,rllib/execution/buffers/mixin_replay_buffer.py,179,68,78,10,29,20,40,39,60,174.10072980757323,6.896551724137931,2187.0629871154133,121.50349928418963,317.12413313173494,18,66.0998202500361
ray_2.0.0,rllib/algorithms/mock.py,158,83,123,9,20,13,26,29,39,114.96788691072805,5.85,1108.3483640383556,61.57490911324198,189.46125880997533,21,52.28472735562727
ray_2.0.0,rllib/algorithms/__init__.py,8,3,6,0,0,0,0,0,0,0,0,0,0.0,0,1,100.0
ray_2.0.0,rllib/algorithms/registry.py,361,150,233,5,14,10,19,19,29,64.91260938324326,3.392857142857143,417.96572498346706,23.22031805463706,123.18989788986397,13,43.98527430149
ray_2.0.0,rllib/algorithms/algorithm_config.py,1264,417,603,3,121,105,210,124,315,841.9373392123895,2.603305785123967,5702.728338001139,316.81824100006327,2190.571837771866,127,28.53152796148325
ray_2.0.0,rllib/algorithms/callbacks.py,638,176,395,6,13,10,19,19,29,63.61549134016113,4.384615384615385,540.1403215170959,30.007795639838662,123.18989788986397,56,57.16209474863101
ray_2.0.0,rllib/algorithms/algorithm.py,2732,992,1706,19,375,258,492,394,750,3287.2406672741445,12.464,80598.94040827821,4477.718911571012,6466.538864592283,315,0.0
ray_2.0.0,rllib/algorithms/pg/pg.py,106,39,40,1,4,2,4,5,6,8.0,0.5,6.965784284662087,0.3869880158145604,13.931568569324174,8,80.70291740486067
ray_2.0.0,rllib/algorithms/pg/utils.py,38,8,18,0,0,0,0,0,0,0,0,0,0.0,0,1,100.0
ray_2.0.0,rllib/algorithms/pg/pg_torch_policy.py,118,43,64,2,3,2,3,5,5,6.754887502163469,1.0,11.60964047443681,0.6449800263576005,11.60964047443681,5,85.02732981077824
ray_2.0.0,rllib/algorithms/pg/pg_tf_policy.py,150,50,84,2,3,2,3,5,5,6.754887502163469,1.0,11.60964047443681,0.6449800263576005,11.60964047443681,1,84.03060079491868
ray_2.0.0,rllib/algorithms/pg/__init__.py,17,5,15,0,0,0,0,0,0,0,0,0,0.0,0,1,100.0
ray_2.0.0,rllib/algorithms/pg/tests/test_pg.py,183,80,151,4,8,11,17,12,28,32.0,4.25,426.6105375858176,23.70058542143431,100.37895002019238,17,57.04717091545343
ray_2.0.0,rllib/algorithms/mbmpo/utils.py,104,53,71,10,28,18,32,38,50,167.82521876648653,5.714285714285714,1499.4078609838816,83.30043672132676,262.39637567217926,18,65.03117972423102
ray_2.0.0,rllib/algorithms/mbmpo/__init__.py,7,2,6,0,0,0,0,0,0,0,0,0,0.0,0,1,100.0
ray_2.0.0,rllib/algorithms/mbmpo/mbmpo_torch_policy.py,90,29,59,4,7,4,7,11,11,27.651484454403228,2.0,76.10749561002055,4.228194200556697,38.053747805010275,6,82.84925172486813
ray_2.0.0,rllib/algorithms/mbmpo/mbmpo.py,612,286,357,14,65,47,90,79,137,444.756876755656,9.692307692307692,8370.451021156396,465.0250567309109,863.6179625002632,53,47.584500074227
ray_2.0.0,rllib/algorithms/mbmpo/model_ensemble.py,354,219,272,14,69,42,79,83,121,474.7911564265002,8.014492753623188,6182.217586517634,343.456532584313,771.379771192978,56,35.28053513425391
ray_2.0.0,rllib/algorithms/mbmpo/tests/test_mbmpo.py,48,28,35,1,2,1,2,3,3,2.0,0.5,2.3774437510817346,0.1320802083934297,4.754887502163469,7,72.78186817713791
ray_2.0.0,rllib/algorithms/simple_q/utils.py,34,11,27,1,1,1,1,2,2,0.0,0.5,1.0,0.05555555555555555,2.0,2,74.9062755799735
ray_2.0.0,rllib/algorithms/simple_q/simple_q_tf_policy.py,210,77,150,6,19,10,19,25,29,96.22039775975506,3.0,404.015488510401,22.4453049172445,134.671829503467,1,66.32403956741835
ray_2.0.0,rllib/algorithms/simple_q/__init__.py,19,4,18,0,0,0,0,0,0,0,0,0,0.0,0,1,100.0
ray_2.0.0,rllib/algorithms/simple_q/simple_q.py,411,132,192,11,41,24,47,52,71,257.7133799943517,6.304878048780488,2551.7809845585984,141.76561025325546,404.7312199880176,30,58.616587089877875
ray_2.0.0,rllib/algorithms/simple_q/simple_q_torch_policy.py,179,74,124,5,18,9,18,23,27,86.66829050039843,2.5,305.34043203384834,16.963357335213797,122.13617281353935,11,67.4917504969987
ray_2.0.0,rllib/algorithms/simple_q/tests/test_simple_q.py,151,63,119,6,18,23,41,24,64,90.56842503028855,6.833333333333333,2005.1569336487191,111.39760742492884,293.43760004615405,23,57.60416737591295
ray_2.0.0,rllib/algorithms/qmix/mixers.py,62,34,37,3,7,10,13,10,23,24.406371956566698,2.7857142857142856,212.84067865099743,11.824482147277635,76.40434618240934,5,79.76992883331557
ray_2.0.0,rllib/algorithms/qmix/qmix.py,325,118,190,8,29,19,38,37,57,164.8814488586996,5.241379310344827,1556.369102062387,86.46495011457705,296.93884184085016,25,63.35977735293521
ray_2.0.0,rllib/algorithms/qmix/qmix_policy.py,652,293,492,20,105,72,127,125,199,791.4343412526902,12.095238095238095,16766.31106916809,931.4617260648938,1386.1910726477554,70,36.1466263477422
ray_2.0.0,rllib/algorithms/qmix/__init__.py,3,2,2,0,0,0,0,0,0,0,0,0,0.0,0,1,100.0
ray_2.0.0,rllib/algorithms/qmix/model.py,42,29,32,1,1,1,1,2,2,0.0,0.5,1.0,0.05555555555555555,2.0,4,75.92595708573744
ray_2.0.0,rllib/algorithms/qmix/tests/test_qmix.py,122,60,105,7,15,9,18,22,27,78.25484338853101,4.2,505.69954555346953,28.094419197414975,120.40465370320703,13,53.142548579786066
ray_2.0.0,rllib/algorithms/tests/test_algorithm.py,356,171,267,7,41,30,59,48,89,239.31111664374467,5.036585365853658,2503.4934955976532,139.0829719776474,497.061662564183,21,52.9041405642336
ray_2.0.0,rllib/algorithms/tests/test_callbacks.py,110,50,77,4,17,13,21,21,34,77.48686830125578,2.4705882352941178,368.95466351341594,20.497481306300884,149.33879237447786,12,72.25949170749689
ray_2.0.0,rllib/algorithms/tests/test_registry.py,16,10,10,1,2,1,2,3,3,2.0,0.5,2.3774437510817346,0.1320802083934297,4.754887502163469,4,72.9066793577724
ray_2.0.0,rllib/algorithms/tests/test_worker_failures.py,732,265,547,12,54,40,66,66,106,353.78347512548123,7.333333333333333,4698.509028781305,261.02827937673914,640.7057766519961,72,41.93093996303762
ray_2.0.0,rllib/algorithms/tests/test_memory_leaks.py,58,42,41,1,2,1,2,3,3,2.0,0.5,2.3774437510817346,0.1320802083934297,4.754887502163469,8,76.40359474564941
ray_2.0.0,rllib/algorithms/td3/__init__.py,7,2,6,0,0,0,0,0,0,0,0,0,0.0,0,1,100.0
ray_2.0.0,rllib/algorithms/td3/td3.py,122,33,56,1,2,1,2,3,3,2.0,0.5,2.3774437510817346,0.1320802083934297,4.754887502163469,6,86.43665878234151
ray_2.0.0,rllib/algorithms/td3/tests/test_td3.py,107,71,80,4,11,9,16,15,25,46.053747805010275,2.909090909090909,284.1374978624377,15.785416547913208,97.67226489021297,14,64.82771533354806
ray_2.0.0,rllib/algorithms/appo/utils.py,45,12,27,0,0,0,0,0,0,0,0,0,0.0,0,1,100.0
ray_2.0.0,rllib/algorithms/appo/appo.py,316,148,183,10,40,24,48,50,72,246.09640474436813,6.0,2438.1458739826808,135.45254855459336,406.35764566378015,31,59.05402107144002
ray_2.0.0,rllib/algorithms/appo/appo_tf_policy.py,444,190,336,8,49,40,66,57,106,299.1207823616452,5.387755102040816,3331.1753909466556,185.06529949703642,618.2863415014626,6,49.3043980889426
ray_2.0.0,rllib/algorithms/appo/__init__.py,12,4,11,0,0,0,0,0,0,0,0,0,0.0,0,1,100.0
ray_2.0.0,rllib/algorithms/appo/appo_torch_policy.py,411,170,305,7,43,38,65,50,103,252.98086890659343,5.290697674418604,3075.5734922534007,170.86519401407782,581.3171875467966,26,49.20055982111305
ray_2.0.0,rllib/algorithms/appo/tests/test_appo.py,178,90,133,1,2,1,2,3,3,2.0,0.5,2.3774437510817346,0.1320802083934297,4.754887502163469,18,70.83738740915102
ray_2.0.0,rllib/algorithms/sac/sac_tf_policy.py,829,268,513,13,99,75,134,112,209,704.4120217237156,8.797979797979798,12517.212956125697,695.4007197847609,1422.7371787100392,48,46.97236482909917
ray_2.0.0,rllib/algorithms/sac/rnnsac_torch_policy.py,480,156,319,13,75,64,108,88,172,515.2671181230253,9.36,10399.168151476559,577.73156397092,1111.0222384056153,22,55.243801442283605
ray_2.0.0,rllib/algorithms/sac/__init__.py,22,6,20,0,0,0,0,0,0,0,0,0,0.0,0,1,100.0
ray_2.0.0,rllib/algorithms/sac/sac_torch_policy.py,552,182,322,10,70,58,98,80,156,462.26909213502137,7.0,6903.545479616999,383.5303044231666,986.2207828024284,30,54.81598613480455
ray_2.0.0,rllib/algorithms/sac/rnnsac.py,139,47,88,6,12,7,12,18,19,58.52932501298082,3.0,237.6857250822118,13.204762504567322,79.22857502740393,12,77.73877118531513
ray_2.0.0,rllib/algorithms/sac/rnnsac_torch_model.py,173,72,143,10,26,18,34,36,52,155.43071362054204,6.538461538461538,1757.774500490386,97.65413891613255,268.8361000750002,26,54.869860166815975
ray_2.0.0,rllib/algorithms/sac/sac_torch_model.py,329,120,171,10,32,22,37,42,59,193.21928094887363,5.78125,1839.2857709259429,102.18254282921905,318.14672794394687,32,61.93580153247647
ray_2.0.0,rllib/algorithms/sac/sac.py,355,121,186,9,38,28,56,47,84,227.95057052383706,6.631578947368421,3094.1983371661117,171.89990762033955,466.5854635409216,35,59.743469827540856
ray_2.0.0,rllib/algorithms/sac/sac_tf_model.py,321,118,167,10,32,22,37,42,59,193.21928094887363,5.78125,1839.2857709259429,102.18254282921905,318.14672794394687,32,62.10366048768147
ray_2.0.0,rllib/algorithms/sac/tests/test_rnnsac.py,71,29,58,1,2,1,2,3,3,2.0,0.5,2.3774437510817346,0.1320802083934297,4.754887502163469,7,73.39161036206558
ray_2.0.0,rllib/algorithms/sac/tests/test_sac.py,741,313,609,14,77,89,157,91,246,535.8455325423139,14.272727272727273,22849.458599432186,1269.4143666351215,1600.9174814888793,84,31.264095745794627
ray_2.0.0,rllib/algorithms/a3c/a3c.py,287,124,163,7,29,19,38,36,57,160.53293331310283,4.586206896551724,1351.489704687385,75.08276137152139,294.6857250822118,29,62.20577368255382
ray_2.0.0,rllib/algorithms/a3c/a3c_torch_policy.py,165,68,127,5,18,12,20,23,32,86.66829050039843,2.7777777777777777,402.0943960939567,22.33857756077537,144.75398259382442,9,61.68171855830806
ray_2.0.0,rllib/algorithms/a3c/__init__.py,3,2,2,0,0,0,0,0,0,0,0,0,0.0,0,1,100.0
ray_2.0.0,rllib/algorithms/a3c/a3c_tf_policy.py,197,72,151,4,16,9,16,20,25,72.0,2.0,216.09640474436813,12.005355819131562,108.04820237218406,1,62.87731054061779
ray_2.0.0,rllib/algorithms/a3c/tests/test_a3c.py,98,48,66,1,4,2,4,5,6,8.0,0.5,6.965784284662087,0.3869880158145604,13.931568569324174,10,77.22651156093256
ray_2.0.0,rllib/algorithms/bandit/bandit.py,135,66,64,1,6,4,8,7,12,15.509775004326936,0.6666666666666666,22.458839376460833,1.2477132986922685,33.68825906469125,14,76.56453071415261
ray_2.0.0,rllib/algorithms/bandit/bandit_tf_model.py,272,167,209,11,50,36,64,61,100,320.2465572937465,7.04,4175.239085644273,231.95772698023737,593.0737337562887,48,43.49397934799298
ray_2.0.0,rllib/algorithms/bandit/bandit_tf_policy.py,158,74,120,5,13,8,15,18,23,59.715356810271004,2.8846153846153846,276.658485672615,15.369915870700831,95.90827503317318,12,62.743146723290124
ray_2.0.0,rllib/algorithms/bandit/__init__.py,13,2,12,0,0,0,0,0,0,0,0,0,0.0,0,1,100.0
ray_2.0.0,rllib/algorithms/bandit/bandit_torch_model.py,278,164,211,12,48,37,66,60,103,311.0977500432694,8.25,5019.380283618339,278.8544602010188,608.4097313476774,48,45.47669795350034
ray_2.0.0,rllib/algorithms/bandit/bandit_torch_policy.py,108,60,92,3,10,6,12,13,18,37.974168451037094,1.8,119.8942468677714,6.660791492653967,66.60791492653966,15,55.220338999986566
ray_2.0.0,rllib/algorithms/bandit/tests/test_bandits.py,72,46,56,1,6,3,6,7,9,15.509775004326936,0.5,12.63309714925922,0.701838730514401,25.26619429851844,12,63.453522920846
ray_2.0.0,rllib/algorithms/ddpg/ddpg_torch_model.py,235,79,141,5,17,10,18,22,28,81.0965087756926,2.6470588235294117,330.5225787931173,18.362365488506516,124.86408532184433,17,70.10628961758286
ray_2.0.0,rllib/algorithms/ddpg/ddpg.py,317,119,182,6,35,26,52,41,78,195.03468059740075,4.457142857142857,1862.5912226340813,103.47729014633785,417.88905636021053,34,60.98202693331194
ray_2.0.0,rllib/algorithms/ddpg/utils.py,85,25,77,4,12,8,15,16,23,51.01955000865388,2.5,230.0,12.777777777777779,92.0,7,64.39741311523136
ray_2.0.0,rllib/algorithms/ddpg/__init__.py,8,2,6,0,0,0,0,0,0,0,0,0,0.0,0,1,100.0
ray_2.0.0,rllib/algorithms/ddpg/ddpg_tf_model.py,210,70,116,5,21,11,22,26,33,103.84830635279079,2.619047619047619,406.25228992505157,22.569571662502867,155.11451069865606,17,71.06265577863942
ray_2.0.0,rllib/algorithms/ddpg/noop_model.py,27,16,14,0,0,0,0,0,0,0,0,0,0.0,0,3,100.0
ray_2.0.0,rllib/algorithms/ddpg/ddpg_torch_policy.py,387,168,279,10,52,34,66,62,100,329.64214629221044,6.346153846153846,3778.6245815916714,209.92358786620397,595.4196310386876,34,49.77267290326572
ray_2.0.0,rllib/algorithms/ddpg/ddpg_tf_policy.py,453,209,355,10,67,43,84,77,127,439.64725670954437,6.268656716417911,4989.110359412927,277.1727977451626,795.8818906682526,6,46.60823724579179
ray_2.0.0,rllib/algorithms/ddpg/tests/test_ddpg.py,583,260,471,11,65,66,115,76,181,429.5076556518598,9.73076923076923,11004.282485504697,611.3490269724831,1130.874879933289,64,37.80480332436034
ray_2.0.0,rllib/algorithms/crr/crr.py,226,104,136,10,38,25,50,48,75,232.64052645972987,6.578947368421052,2755.738076013729,153.0965597785405,418.8721875540868,27,62.818654503859776
ray_2.0.0,rllib/algorithms/crr/__init__.py,6,2,5,0,0,0,0,0,0,0,0,0,0.0,0,1,100.0
ray_2.0.0,rllib/algorithms/crr/tests/test_crr.py,99,45,75,3,8,4,8,11,12,28.75488750216347,1.5,62.26976913547136,3.4594316186372978,41.51317942364757,8,67.7026113482949
ray_2.0.0,rllib/algorithms/crr/torch/crr_torch_policy.py,413,160,289,10,42,37,59,52,96,259.6966127055816,7.023809523809524,3843.7250670894227,213.54028150496794,547.242212941545,27,53.914548238346754
ray_2.0.0,rllib/algorithms/crr/torch/__init__.py,4,3,3,0,0,0,0,0,0,0,0,0,0.0,0,1,100.0
ray_2.0.0,rllib/algorithms/crr/torch/crr_torch_model.py,198,72,128,3,7,5,8,10,13,24.406371956566698,1.7142857142857142,74.03154040034694,4.11286335557483,43.18506523353572,21,71.25292599779964
ray_2.0.0,rllib/algorithms/apex_dqn/__init__.py,11,2,10,0,0,0,0,0,0,0,0,0,0.0,0,1,100.0
ray_2.0.0,rllib/algorithms/apex_dqn/apex_dqn.py,758,260,469,13,72,47,92,85,139,492.34031643968063,8.305555555555555,7399.463797133863,411.0813220629924,890.9053401231407,63,47.36543604411645
ray_2.0.0,rllib/algorithms/apex_dqn/tests/test_apex_dqn.py,162,58,129,2,5,3,6,7,9,13.60964047443681,1.2,30.319433158222125,1.6844129532345624,25.26619429851844,13,69.94157509784716
ray_2.0.0,rllib/algorithms/alpha_star/league_builder.py,390,154,243,15,52,38,74,67,112,355.0262242774646,10.673076923076923,7251.309693824137,402.8505385457854,679.4019893312704,26,57.390421237460735
ray_2.0.0,rllib/algorithms/alpha_star/distributed_learners.py,259,107,179,10,26,18,34,36,52,155.43071362054204,6.538461538461538,1757.774500490386,97.65413891613255,268.8361000750002,39,58.67481180994818
ray_2.0.0,rllib/algorithms/alpha_star/__init__.py,11,2,10,0,0,0,0,0,0,0,0,0,0.0,0,1,100.0
ray_2.0.0,rllib/algorithms/alpha_star/alpha_star.py,640,227,424,13,77,46,87,90,133,530.6482799693416,7.3441558441558445,6341.0650539558355,352.2813918864353,863.4164618118467,67,47.49088142071934
ray_2.0.0,rllib/algorithms/alpha_star/tests/test_alpha_star.py,68,33,55,1,2,1,2,3,3,2.0,0.5,2.3774437510817346,0.1320802083934297,4.754887502163469,7,69.25601130342051
ray_2.0.0,rllib/algorithms/bc/__init__.py,8,2,7,0,0,0,0,0,0,0,0,0,0.0,0,1,100.0
ray_2.0.0,rllib/algorithms/bc/bc.py,93,29,31,2,4,2,4,6,6,10.0,1.0,15.509775004326936,0.861654166907052,15.509775004326936,8,76.26770012272199
ray_2.0.0,rllib/algorithms/bc/tests/test_bc.py,84,47,62,3,5,3,5,8,8,16.36452797660028,1.5,36.0,2.0,24.0,10,70.08503647183612
ray_2.0.0,rllib/algorithms/dreamer/utils.py,99,68,68,7,22,17,30,29,47,117.75898006442377,4.7727272727272725,1089.7334641342986,60.54074800746103,228.32510677099592,28,56.62706002605605
ray_2.0.0,rllib/algorithms/dreamer/dreamer_torch_policy.py,285,172,221,9,73,51,86,82,137,480.38651781122206,5.301369863013699,4617.411640175977,256.52286889866537,870.9846246326777,19,46.21483412665173
ray_2.0.0,rllib/algorithms/dreamer/__init__.py,11,2,10,0,0,0,0,0,0,0,0,0,0.0,0,1,100.0
ray_2.0.0,rllib/algorithms/dreamer/dreamer_model.py,558,276,346,9,62,64,112,71,176,397.6894962569671,8.129032258064516,8798.50271755715,488.8057065309528,1082.3554930328241,65,44.6062693228075
ray_2.0.0,rllib/algorithms/dreamer/dreamer.py,431,220,274,12,61,40,80,73,120,404.79452759999,7.868852459016393,5844.81794412277,324.7121080068206,742.7789470656021,50,49.403520303907
ray_2.0.0,rllib/algorithms/dreamer/tests/test_dreamer.py,50,29,32,2,3,3,4,5,7,6.754887502163469,1.3333333333333333,21.67132888561538,1.2039627158675212,16.253496664211536,7,80.0385093002511
ray_2.0.0,rllib/algorithms/cql/cql.py,232,106,152,11,43,25,50,54,75,271.3831322572005,6.395348837209302,2760.3384821423615,153.35213789679787,431.6165626622602,30,59.58655496243687
ray_2.0.0,rllib/algorithms/cql/cql_tf_policy.py,426,215,325,11,92,67,121,103,188,638.2214477622555,7.233695652173913,9093.20464084784,505.17803560265776,1257.0620991104452,30,43.57845377262105
ray_2.0.0,rllib/algorithms/cql/__init__.py,9,3,8,0,0,0,0,0,0,0,0,0,0.0,0,1,100.0
ray_2.0.0,rllib/algorithms/cql/cql_torch_policy.py,406,217,313,9,92,68,122,101,190,628.697024970226,5.967391304347826,7549.109127889564,419.3949515494202,1265.0601817228412,26,42.266655566304415
ray_2.0.0,rllib/algorithms/cql/tests/test_cql.py,150,70,111,1,5,7,14,6,21,11.60964047443681,1.4,75.99789752120198,4.2221054178445545,54.284212515144276,13,68.38416170994752
ray_2.0.0,rllib/algorithms/marwil/marwil_tf_policy.py,257,98,178,8,38,26,49,46,75,223.42124551085624,5.157894736842105,2136.7463356325816,118.70812975736564,414.267146704276,9,61.346994805703645
ray_2.0.0,rllib/algorithms/marwil/__init__.py,20,4,19,0,0,0,0,0,0,0,0,0,0.0,0,1,100.0
ray_2.0.0,rllib/algorithms/marwil/marwil.py,355,120,193,10,33,22,43,43,65,199.6842868877026,6.515151515151516,2297.9409074836917,127.66338374909398,352.7072090556364,31,61.679216929617475
ray_2.0.0,rllib/algorithms/marwil/marwil_torch_policy.py,126,64,89,7,30,17,33,37,50,166.8582023226588,3.85,1002.8197728835729,55.712209604642936,260.4726682814475,9,65.48002324224619
ray_2.0.0,rllib/algorithms/marwil/tests/test_marwil.py,238,123,180,9,29,25,48,38,73,169.41077387168042,7.448275862068965,2853.4248631716705,158.52360350953725,383.0987084813817,25,55.874286083367856
ray_2.0.0,rllib/algorithms/ppo/ppo_torch_policy.py,217,84,161,7,31,19,35,38,54,173.2315700763964,3.9516129032258065,1119.8400161751392,62.21333423195218,283.3880857259536,10,61.137021022376146
ray_2.0.0,rllib/algorithms/ppo/__init__.py,12,4,11,0,0,0,0,0,0,0,0,0,0.0,0,1,100.0
ray_2.0.0,rllib/algorithms/ppo/ppo.py,491,188,309,15,91,56,111,106,167,650.8126711922091,9.148351648351648,10278.746824140497,571.0414902300276,1123.5627159120543,56,49.76976803327443
ray_2.0.0,rllib/algorithms/ppo/ppo_tf_policy.py,237,93,166,7,31,19,35,38,54,173.2315700763964,3.9516129032258065,1119.8400161751392,62.21333423195218,283.3880857259536,2,63.42769497079387
ray_2.0.0,rllib/algorithms/ppo/tests/test_ppo.py,469,211,389,7,78,64,113,85,177,509.9128575256586,5.07051282051282,5752.305107665585,319.5725059814214,1134.4621956963733,65,37.19579221937169
ray_2.0.0,rllib/algorithms/maddpg/maddpg.py,320,127,155,5,27,22,44,32,66,139.9916030328505,4.074074074074074,1344.4444444444446,74.69135802469137,330.0,34,59.45240244482015
ray_2.0.0,rllib/algorithms/maddpg/__init__.py,7,2,6,0,0,0,0,0,0,0,0,0,0.0,0,1,100.0
ray_2.0.0,rllib/algorithms/maddpg/maddpg_tf_policy.py,401,171,322,10,71,39,76,81,115,469.85132643370605,5.352112676056338,3902.1330299444803,216.7851683302489,729.0827503317319,34,41.7448696454066
ray_2.0.0,rllib/algorithms/maddpg/tests/test_maddpg.py,61,29,49,1,2,1,2,3,3,2.0,0.5,2.3774437510817346,0.1320802083934297,4.754887502163469,8,70.81138625669865
ray_2.0.0,rllib/algorithms/impala/impala.py,1004,415,694,14,114,78,153,128,231,832.252430523587,9.394736842105264,15191.289473684212,843.9605263157896,1617.0,118,31.37380489267823
ray_2.0.0,rllib/algorithms/impala/impala_torch_policy.py,356,123,250,9,37,25,44,46,69,221.27909954125198,5.351351351351352,2039.5379309094844,113.30766282830469,381.1257749679339,22,58.34847082149165
ray_2.0.0,rllib/algorithms/impala/impala_tf_policy.py,434,170,300,11,43,28,47,54,75,271.3831322572005,6.011627906976744,2594.71817321382,144.15100962299002,431.6165626622602,25,54.58530569720138
ray_2.0.0,rllib/algorithms/impala/__init__.py,15,4,14,0,0,0,0,0,0,0,0,0,0.0,0,1,100.0
ray_2.0.0,rllib/algorithms/impala/vtrace_tf.py,425,92,210,8,33,24,46,41,70,190.46500593882897,5.575757575757576,2091.0687824085126,116.17048791158403,375.02864032326585,11,66.03599425445273
ray_2.0.0,rllib/algorithms/impala/vtrace_torch.py,358,87,159,9,49,33,63,58,96,303.650107374626,5.785714285714286,3253.6900155794283,180.76055642107934,562.3661755322469,16,62.631820185398254
ray_2.0.0,rllib/algorithms/impala/tests/test_impala.py,121,63,98,4,8,6,11,12,17,32.0,2.75,167.59699690871406,9.310944272706337,60.94436251225966,18,61.207595569750524
ray_2.0.0,rllib/algorithms/impala/tests/test_vtrace.py,367,145,285,7,65,54,90,72,144,411.1053923012527,4.846153846153846,4305.658431775742,239.20324620976348,888.4692002076929,32,50.84109770903119
ray_2.0.0,rllib/algorithms/maml/maml.py,387,204,246,12,57,38,76,69,114,375.4942808160442,8.0,5570.974304581691,309.4985724767606,696.3717880727114,40,51.21764902763988
ray_2.0.0,rllib/algorithms/maml/__init__.py,7,2,6,0,0,0,0,0,0,0,0,0,0.0,0,1,100.0
ray_2.0.0,rllib/algorithms/maml/maml_torch_policy.py,449,177,377,10,57,38,73,67,111,365.69401175626393,6.4035087719298245,4311.712343006959,239.5395746114977,673.3359001408127,25,42.93418085379764
ray_2.0.0,rllib/algorithms/maml/maml_tf_policy.py,523,214,439,13,63,43,82,76,125,424.67435151632895,8.46031746031746,6607.4312790980775,367.07951550544874,780.9909391804482,24,40.05493977442714
ray_2.0.0,rllib/algorithms/maml/tests/test_maml.py,50,32,38,2,6,3,6,8,9,17.509775004326936,1.0,27.0,1.5,27.0,10,65.44374008600363
ray_2.0.0,rllib/algorithms/slateq/slateq_torch_policy.py,439,154,291,10,46,39,60,56,99,287.3031309274962,6.521739130434782,3749.5313301111055,208.30729611728364,574.9281372837029,10,58.253686438371815
ray_2.0.0,rllib/algorithms/slateq/__init__.py,15,4,14,0,0,0,0,0,0,0,0,0,0.0,0,1,100.0
ray_2.0.0,rllib/algorithms/slateq/slateq_tf_model.py,77,31,43,3,6,5,10,9,15,20.264662506490406,2.5,118.87218755408671,6.604010419671484,47.548875021634686,6,83.38576871652018
ray_2.0.0,rllib/algorithms/slateq/slateq_torch_model.py,185,60,78,2,5,3,6,7,9,13.60964047443681,1.2,30.319433158222125,1.6844129532345624,25.26619429851844,12,76.63826319399628
ray_2.0.0,rllib/algorithms/slateq/slateq_tf_policy.py,382,139,239,6,35,23,40,41,63,195.03468059740075,3.4285714285714284,1157.2312329975061,64.29062405541701,337.5257762909393,7,62.22110499671511
ray_2.0.0,rllib/algorithms/slateq/slateq.py,249,97,135,4,20,16,31,24,47,94.43856189774725,3.1,668.0290363550727,37.112724241948484,215.4932375338944,21,66.32832540252015
ray_2.0.0,rllib/algorithms/slateq/tests/test_slateq.py,48,28,35,1,2,1,2,3,3,2.0,0.5,2.3774437510817346,0.1320802083934297,4.754887502163469,7,62.74888137044211
ray_2.0.0,rllib/algorithms/alpha_zero/mcts.py,157,102,120,8,37,21,40,45,61,216.74977452827116,4.324324324324325,1448.6617897345304,80.48121054080724,335.00303887611017,23,55.972166326433964
ray_2.0.0,rllib/algorithms/alpha_zero/__init__.py,13,3,12,0,0,0,0,0,0,0,0,0,0.0,0,1,100.0
ray_2.0.0,rllib/algorithms/alpha_zero/ranked_rewards.py,78,61,62,6,12,7,12,18,19,58.52932501298082,3.0,237.6857250822118,13.204762504567322,79.22857502740393,9,54.15442464779867
ray_2.0.0,rllib/algorithms/alpha_zero/alpha_zero.py,437,162,258,9,32,23,43,41,66,188.52932501298082,6.046875,2138.1655203430482,118.78697335239157,353.5984323047935,29,59.1152598038967
ray_2.0.0,rllib/algorithms/alpha_zero/alpha_zero_policy.py,158,70,125,4,12,8,15,16,23,51.01955000865388,2.5,230.0,12.777777777777779,92.0,13,63.99680008657944
ray_2.0.0,rllib/algorithms/alpha_zero/tests/test_alpha_zero.py,45,29,34,1,2,1,2,3,3,2.0,0.5,2.3774437510817346,0.1320802083934297,4.754887502163469,7,72.589728033073
ray_2.0.0,rllib/algorithms/alpha_zero/models/custom_torch_models.py,115,60,85,2,4,3,4,6,7,10.0,1.0,18.094737505048094,1.0052631947248942,18.094737505048094,9,60.33349359111342
ray_2.0.0,rllib/algorithms/alpha_zero/models/__init__.py,0,0,0,0,0,0,0,0,0,0,0,0,0.0,0,1,100.0
ray_2.0.0,rllib/algorithms/es/utils.py,50,31,34,6,17,10,19,23,29,84.99664330558272,3.3529411764705883,439.8498772566025,24.436104292033473,131.18329672565338,8,73.91928064087111
ray_2.0.0,rllib/algorithms/es/__init__.py,5,4,4,0,0,0,0,0,0,0,0,0,0.0,0,1,100.0
ray_2.0.0,rllib/algorithms/es/es.py,584,284,387,14,107,64,125,121,189,774.6399364537291,8.177570093457945,10693.523437983984,594.0846354435547,1307.6651518448984,71,40.74674188376527
ray_2.0.0,rllib/algorithms/es/optimizers.py,53,38,40,6,37,28,54,43,82,208.2595495325981,4.378378378378378,1948.175702742234,108.23198348567968,444.95370988557204,8,58.98723548908435
ray_2.0.0,rllib/algorithms/es/es_torch_policy.py,133,74,105,5,14,8,16,19,24,64.91260938324326,2.857142857142857,291.28645806470297,16.18258100359461,101.95026032264605,4,61.2938229224314
ray_2.0.0,rllib/algorithms/es/es_tf_policy.py,203,109,151,10,33,19,35,43,54,199.6842868877026,5.303030303030303,1553.884907028328,86.32693927935155,293.01829675391326,30,57.01046723561883
ray_2.0.0,rllib/algorithms/es/tests/test_es.py,46,27,33,1,2,1,2,3,3,2.0,0.5,2.3774437510817346,0.1320802083934297,4.754887502163469,6,80.33022248436598
ray_2.0.0,rllib/algorithms/a2c/a2c.py,239,92,136,8,32,18,36,40,54,184.0,4.5,1293.228527057629,71.8460292809794,287.3841171239176,21,66.12633383609764
ray_2.0.0,rllib/algorithms/a2c/__init__.py,3,2,2,0,0,0,0,0,0,0,0,0,0.0,0,1,100.0
ray_2.0.0,rllib/algorithms/a2c/tests/test_a2c.py,74,45,56,1,2,1,2,3,3,2.0,0.5,2.3774437510817346,0.1320802083934297,4.754887502163469,12,65.57473185042285
ray_2.0.0,rllib/algorithms/apex_ddpg/__init__.py,11,2,10,0,0,0,0,0,0,0,0,0,0.0,0,1,100.0
ray_2.0.0,rllib/algorithms/apex_ddpg/apex_ddpg.py,230,79,127,2,8,6,12,10,18,26.0,1.5,89.69205856195879,4.9828921423310435,59.794705707972525,17,72.67913414609357
ray_2.0.0,rllib/algorithms/apex_ddpg/tests/test_apex_ddpg.py,70,35,52,6,15,9,18,21,27,74.11313393845472,3.6,426.93325349409554,23.718514083005307,118.59257041502654,10,64.40931099903275
ray_2.0.0,rllib/algorithms/r2d2/r2d2.py,240,68,105,6,16,11,19,22,30,79.50977500432694,3.5625,476.60175424186116,26.477875235658953,133.78294855911892,15,66.976283354497
ray_2.0.0,rllib/algorithms/r2d2/r2d2_torch_policy.py,333,123,220,14,86,63,120,100,183,605.9617378131868,9.767441860465116,11875.506668513612,659.7503704729784,1215.8256827287746,11,56.34660034175133
ray_2.0.0,rllib/algorithms/r2d2/__init__.py,11,4,10,0,0,0,0,0,0,0,0,0,0.0,0,1,100.0
ray_2.0.0,rllib/algorithms/r2d2/r2d2_tf_policy.py,347,127,232,15,88,65,122,103,187,627.03334137421,10.397727272727273,13001.06446254187,722.2813590301039,1250.3755985832618,13,54.973281946693255
ray_2.0.0,rllib/algorithms/r2d2/tests/test_r2d2.py,95,43,73,6,17,10,20,23,30,84.99664330558272,3.5294117647058822,478.9653835825073,26.60918797680596,135.7068586817104,11,64.3215881077572
ray_2.0.0,rllib/algorithms/ddppo/ddppo.py,383,127,207,13,48,27,52,61,79,316.1839163704497,7.041666666666667,3299.2197580750876,183.28998655972708,468.52824966746806,32,60.29266140521716
ray_2.0.0,rllib/algorithms/ddppo/__init__.py,7,2,6,0,0,0,0,0,0,0,0,0,0.0,0,1,100.0
ray_2.0.0,rllib/algorithms/ddppo/tests/test_ddppo.py,80,58,61,2,5,3,5,7,8,13.60964047443681,1.0,22.458839376460833,1.2477132986922685,22.458839376460833,14,57.8538737872679
ray_2.0.0,rllib/algorithms/ars/ars_torch_policy.py,20,5,16,0,0,0,0,0,0,0,0,0,0.0,0,1,100.0
ray_2.0.0,rllib/algorithms/ars/ars.py,582,295,386,15,101,64,123,116,187,731.0827186920591,9.133663366336634,11713.397589276927,650.7443105153848,1282.4424460888558,72,40.182991757444086
ray_2.0.0,rllib/algorithms/ars/__init__.py,11,4,10,0,0,0,0,0,0,0,0,0,0.0,0,1,100.0
ray_2.0.0,rllib/algorithms/ars/ars_tf_policy.py,128,78,97,6,21,12,22,27,34,107.74844088268091,3.142857142857143,508.093693088325,28.227427393795832,161.66617507355795,20,60.044125350072825
ray_2.0.0,rllib/algorithms/ars/tests/test_ars.py,49,29,33,1,2,1,2,3,3,2.0,0.5,2.3774437510817346,0.1320802083934297,4.754887502163469,7,79.51873990161114
ray_2.0.0,rllib/algorithms/dqn/dqn_tf_policy.py,486,159,375,14,102,72,132,116,204,733.8903537898989,9.058823529411764,12673.548878995754,704.0860488330975,1399.0281230060248,23,47.089691669823736
ray_2.0.0,rllib/algorithms/dqn/learner_thread.py,82,49,55,5,8,5,9,13,14,35.60964047443681,2.8125,145.70481390180552,8.09471188343364,51.80615605397529,10,76.87587509912498
ray_2.0.0,rllib/algorithms/dqn/dqn_torch_policy.py,490,153,376,12,91,67,122,103,189,635.2288622667352,8.043956043956044,10165.538186096088,564.7521214497826,1263.7485996376283,18,48.87691814964378
ray_2.0.0,rllib/algorithms/dqn/distributional_q_tf_model.py,188,73,119,7,18,16,28,25,44,94.71013448036484,5.444444444444445,1112.4615494615896,61.803419414532755,204.32967235008786,5,70.58470434543747
ray_2.0.0,rllib/algorithms/dqn/__init__.py,11,4,10,0,0,0,0,0,0,0,0,0,0.0,0,1,100.0
ray_2.0.0,rllib/algorithms/dqn/dqn_torch_model.py,173,63,116,6,12,13,22,18,35,58.52932501298082,5.5,802.7105627776451,44.59503126542473,145.94737505048093,13,70.94811744754537
ray_2.0.0,rllib/algorithms/dqn/dqn.py,453,140,225,14,53,35,68,67,103,356.88275300065607,8.981132075471699,5611.475864712522,311.74865915069563,624.8071866171505,34,56.80723742138548
ray_2.0.0,rllib/algorithms/dqn/tests/test_dqn.py,128,83,91,1,2,1,2,3,3,2.0,0.5,2.3774437510817346,0.1320802083934297,4.754887502163469,16,73.04170704970733
ray_2.0.0,rllib/offline/json_reader.py,385,229,305,14,100,68,127,114,195,717.6885878862789,8.89,11845.15648405529,658.0642491141828,1332.4135527621247,88,35.699390183480666
ray_2.0.0,rllib/offline/io_context.py,64,29,32,1,4,2,4,5,6,8.0,0.5,6.965784284662087,0.3869880158145604,13.931568569324174,8,88.18649897829285
ray_2.0.0,rllib/offline/off_policy_estimator.py,10,3,9,0,0,0,0,0,0,0,0,0,0.0,0,1,100.0
ray_2.0.0,rllib/offline/json_writer.py,144,97,116,9,27,15,29,36,44,156.9112875713945,4.833333333333333,1099.4707169733983,61.08170649852213,227.47670006346175,23,55.13978178572539
ray_2.0.0,rllib/offline/resource.py,18,10,14,1,2,1,2,3,3,2.0,0.5,2.3774437510817346,0.1320802083934297,4.754887502163469,2,93.80524597806723
ray_2.0.0,rllib/offline/__init__.py,27,12,26,0,0,0,0,0,0,0,0,0,0.0,0,1,100.0
ray_2.0.0,rllib/offline/wis_estimator.py,13,5,11,0,0,0,0,0,0,0,0,0,0.0,0,1,100.0
ray_2.0.0,rllib/offline/output_writer.py,26,15,12,0,0,0,0,0,0,0,0,0,0.0,0,3,100.0
ray_2.0.0,rllib/offline/input_reader.py,124,63,69,2,3,2,3,5,5,6.754887502163469,1.0,11.60964047443681,0.6449800263576005,11.60964047443681,18,79.3588567601782
ray_2.0.0,rllib/offline/d4rl_reader.py,51,34,32,2,5,4,8,7,12,13.60964047443681,1.6,53.901214503506004,2.9945119168614447,33.68825906469125,5,78.07841168668483
ray_2.0.0,rllib/offline/shuffled_input.py,42,27,25,3,5,4,8,8,12,16.36452797660028,2.4,86.39999999999999,4.8,36.0,6,84.75720975684848
ray_2.0.0,rllib/offline/dataset_writer.py,82,42,51,5,13,8,16,18,24,59.715356810271004,3.076923076923077,307.9329231834323,17.107384621301794,100.07820003461549,10,76.45244394306228
ray_2.0.0,rllib/offline/is_estimator.py,10,5,8,0,0,0,0,0,0,0,0,0,0.0,0,1,100.0
ray_2.0.0,rllib/offline/dataset_reader.py,276,143,169,11,44,32,58,55,90,278.26873902505133,7.25,3772.3372130748403,209.5742896152689,520.3223742172194,42,56.91878603881063
ray_2.0.0,rllib/offline/mixed_input.py,56,34,32,3,6,3,6,9,9,20.264662506490406,1.5,42.793987519471216,2.377443751081734,28.529325012980813,9,84.37810773583541
ray_2.0.0,rllib/offline/tests/test_dataset_reader.py,271,140,188,5,50,27,54,55,81,293.802449963173,2.7,1264.3833693478432,70.24352051932462,468.29013679549746,34,52.70808697137162
ray_2.0.0,rllib/offline/tests/test_json_reader.py,36,27,25,1,4,2,4,5,6,8.0,0.5,6.965784284662087,0.3869880158145604,13.931568569324174,6,59.958961618724175
ray_2.0.0,rllib/offline/estimators/fqe_torch_model.py,244,121,172,9,34,26,44,43,70,201.50306161549238,5.823529411764706,2212.0008676520906,122.88893709178281,379.83853282914686,18,60.06969350993912
ray_2.0.0,rllib/offline/estimators/doubly_robust.py,148,64,75,6,20,12,23,26,35,101.94833690207419,3.45,567.5780959655369,31.53211644252983,164.51539013493823,10,72.81876203134787
ray_2.0.0,rllib/offline/estimators/direct_method.py,125,58,64,6,12,6,12,18,18,58.52932501298082,3.0,225.17595007788483,12.509775004326935,75.05865002596161,9,76.31799246930497
ray_2.0.0,rllib/offline/estimators/off_policy_estimator.py,113,45,57,4,8,4,8,12,12,32.0,2.0,86.03910001730776,4.779950000961542,43.01955000865388,11,80.21727427632169
ray_2.0.0,rllib/offline/estimators/feature_importance.py,104,32,36,2,3,2,3,5,5,6.754887502163469,1.0,11.60964047443681,0.6449800263576005,11.60964047443681,6,78.8125663892148
ray_2.0.0,rllib/offline/estimators/importance_sampling.py,78,43,42,6,19,12,24,25,36,96.22039775975506,3.789473684210526,633.5197496787413,35.19554164881896,167.17882283189007,6,77.23329217366097
ray_2.0.0,rllib/offline/estimators/__init__.py,17,7,16,0,0,0,0,0,0,0,0,0,0.0,0,1,100.0
ray_2.0.0,rllib/offline/estimators/weighted_importance_sampling.py,96,57,56,7,27,17,34,34,51,148.0334470128169,4.407407407407407,1143.5485919832709,63.53047733240393,259.4606049037673,9,72.45486567657336
ray_2.0.0,rllib/offline/estimators/tests/test_feature_importance.py,35,23,23,2,4,2,4,6,6,10.0,1.0,15.509775004326936,0.861654166907052,15.509775004326936,7,73.26104553752943
ray_2.0.0,rllib/offline/estimators/tests/test_ope.py,220,132,180,8,18,11,19,26,30,99.05865002596161,4.222222222222222,595.3890309645384,33.0771683869188,141.01319154423277,20,51.97475859283546
ray_2.0.0,scripts/clang-tidy-diff.py,306,169,232,10,57,41,77,67,118,365.69401175626393,6.754385964912281,4834.7795074122205,268.59886152290113,715.7985244740171,43,47.794511140100134
ray_2.0.0,scripts/bazel-sharding.py,114,60,72,4,7,4,8,11,12,27.651484454403228,2.2857142857142856,94.88726725405158,5.27151484744731,41.51317942364757,13,73.29005025611016
ray_2.0.0,scripts/get_build_info.py,87,45,57,2,10,5,10,12,15,35.219280948873624,1.0,53.77443751081735,2.987468750600964,53.77443751081735,9,75.04692261795068
ray_2.0.0,scripts/py_dep_analysis.py,384,207,225,11,62,38,69,73,107,407.2139190489966,6.120967741935484,4053.985660486475,225.22142558258193,662.3112278001619,69,47.65906858577402
ray_2.0.0,scripts/bazel.py,265,179,174,13,74,46,90,87,136,507.60526539237657,7.905405405405405,6927.034926077363,384.8352736709646,876.2403154354271,51,50.0042785581174
ray_2.0.0,scripts/build-multinode-image.py,35,21,22,1,2,1,2,3,3,2.0,0.5,2.3774437510817346,0.1320802083934297,4.754887502163469,2,88.74878907595489
ray_2.0.0,scripts/check-test-run.py,37,22,29,3,6,3,6,9,9,20.264662506490406,1.5,42.793987519471216,2.377443751081734,28.529325012980813,9,79.66134126130527
ray_2.0.0,scripts/check_minimal_install.py,50,13,33,3,5,4,7,8,11,16.36452797660028,2.1,69.3,3.8499999999999996,33.0,5,89.31413127206633
ray_2.0.0,scripts/determine_tests_to_run.py,289,200,232,5,23,11,23,28,34,115.65156546374811,2.5,408.6251683748963,22.701398243049795,163.45006734995852,45,47.53155992645023
ray_2.0.0,scripts/check-bazel-team-owner.py,45,20,22,1,4,2,4,5,6,8.0,0.5,6.965784284662087,0.3869880158145604,13.931568569324174,8,91.4860570178434
ray_2.0.0,scripts/pytest_checker.py,126,54,59,4,15,8,15,19,23,66.60335893412778,2.0,195.40466561840492,10.85581475657805,97.70233280920246,17,73.5876242887223
ray_2.0.0,scripts/check_import_order.py,85,49,53,9,21,18,29,30,47,120.76799089133479,6.214285714285714,1433.162546103088,79.62014145017156,230.62385799360038,18,71.82454134178077
ray_2.0.0,scripts/py_dep_analysis_test.py,153,80,119,1,2,1,2,3,3,2.0,0.5,2.3774437510817346,0.1320802083934297,4.754887502163469,10,69.62575178990667
ray_2.0.0,scripts/build-docker-images.py,744,365,570,17,158,105,208,175,313,1223.4842265132381,11.189873417721518,26097.348163988743,1449.8526757771524,2332.229078003519,124,23.031963231832282
ray_2.0.0,docker/retag-lambda/lambda_function.py,96,67,71,6,17,17,34,23,51,84.99664330558272,6.0,1384.2099585534459,76.90055325296922,230.70165975890765,13,61.53840654091816
ray_2.0.0,release/__init__.py,0,0,0,0,0,0,0,0,0,0,0,0,0.0,0,1,100.0
ray_2.0.0,release/setup.py,11,2,10,0,0,0,0,0,0,0,0,0,0.0,0,1,100.0
ray_2.0.0,release/util/microbenchmark_analysis.py,63,38,39,7,14,10,16,21,26,72.95445336320968,4.0,456.80101196899113,25.377833998277286,114.20025299224778,8,72.55103952940075
ray_2.0.0,release/util/sanity_check.py,35,21,29,2,10,5,10,12,15,35.219280948873624,1.0,53.77443751081735,2.987468750600964,53.77443751081735,7,58.098120345394555
ray_2.0.0,release/util/get_contributors.py,97,53,80,3,10,6,12,13,18,37.974168451037094,1.8,119.8942468677714,6.660791492653967,66.60791492653966,8,61.610469617847926
ray_2.0.0,release/serve_tests/workloads/serve_handle_wide_ensemble.py,206,84,162,5,17,9,18,22,27,81.0965087756926,2.6470588235294117,318.71820097907744,17.706566721059858,120.40465370320703,14,59.75783453444492
ray_2.0.0,release/serve_tests/workloads/serve_micro_benchmark.py,33,17,23,1,2,1,2,3,3,2.0,0.5,2.3774437510817346,0.1320802083934297,4.754887502163469,3,87.90974073808711
ray_2.0.0,release/serve_tests/workloads/serve_test_cluster_utils.py,90,39,58,1,2,1,2,3,3,2.0,0.5,2.3774437510817346,0.1320802083934297,4.754887502163469,6,87.17062267593964
ray_2.0.0,release/serve_tests/workloads/benchmark_utils.py,90,47,70,5,18,11,22,23,33,86.66829050039843,3.0555555555555554,456.12583056908215,25.340323920504563,149.27754454988144,12,56.721531223604515
ray_2.0.0,release/serve_tests/workloads/serve_test_utils.py,341,129,201,7,81,46,91,88,137,533.1793346880578,3.932098765432099,3479.6798637460392,193.31554798589107,884.9421317533098,39,57.03830636961181
ray_2.0.0,release/serve_tests/workloads/deployment_graph_long_chain.py,173,68,136,4,9,6,11,13,17,36.52932501298081,2.4444444444444446,153.7738282871965,8.542990460399805,62.907475208398566,10,65.16151404401879
ray_2.0.0,release/serve_tests/workloads/single_deployment_1k_noop_replica.py,158,71,98,3,9,6,12,12,18,33.28421251514428,2.0,129.05865002596164,7.169925001442313,64.52932501298082,9,72.81434293549297
ray_2.0.0,release/serve_tests/workloads/autoscaling_single_deployment.py,177,76,117,3,12,8,16,15,24,47.77443751081735,2.0,187.53074858920888,10.418374921622716,93.76537429460444,11,69.74885949801096
ray_2.0.0,release/serve_tests/workloads/multi_deployment_1k_noop_replica.py,187,81,114,7,21,13,26,28,39,111.8901503327572,4.333333333333333,812.442981827735,45.135721212651944,187.48684196024655,13,68.7770884406802
ray_2.0.0,release/serve_tests/workloads/autoscaling_multi_deployment.py,215,92,142,7,24,15,30,31,45,129.690584471711,4.375,975.3573986074161,54.186522144856454,222.9388339674094,17,65.31535806443276
ray_2.0.0,release/serve_tests/workloads/serve_handle_long_chain.py,186,75,152,2,10,6,12,12,18,35.219280948873624,1.2,77.43519001557698,4.301955000865387,64.52932501298082,11,61.02395994677151
ray_2.0.0,release/serve_tests/workloads/deployment_graph_wide_ensemble.py,189,70,138,5,13,7,14,18,21,59.715356810271004,2.6923076923076925,235.76114431231534,13.097841350684185,87.56842503028855,8,67.6469675106135
ray_2.0.0,release/rllib_tests/multi_gpu_learning_tests/run.py,29,16,18,1,2,1,2,3,3,2.0,0.5,2.3774437510817346,0.1320802083934297,4.754887502163469,2,92.9541160627605
ray_2.0.0,release/rllib_tests/stress_tests/run_stress_tests.py,46,20,31,1,2,1,2,3,3,2.0,0.5,2.3774437510817346,0.1320802083934297,4.754887502163469,2,88.22867589085885
ray_2.0.0,release/rllib_tests/learning_tests/run.py,57,22,41,1,2,1,2,3,3,2.0,0.5,2.3774437510817346,0.1320802083934297,4.754887502163469,3,88.75112261972207
ray_2.0.0,release/rllib_tests/multi_gpu_with_attention_learning_tests/run.py,29,16,18,1,2,1,2,3,3,2.0,0.5,2.3774437510817346,0.1320802083934297,4.754887502163469,2,92.9541160627605
ray_2.0.0,release/rllib_tests/multi_gpu_with_lstm_learning_tests/run.py,29,16,18,1,2,1,2,3,3,2.0,0.5,2.3774437510817346,0.1320802083934297,4.754887502163469,2,92.9541160627605
ray_2.0.0,release/nightly_tests/setup_chaos.py,44,16,33,0,0,0,0,0,0,0,0,0,0.0,0,1,100.0
ray_2.0.0,release/nightly_tests/decision_tree/cart_with_tree.py,370,245,257,15,214,173,333,229,506,1715.2772940239731,11.67056074766355,46292.879435283605,2571.8266352935334,3966.637116777054,62,37.6645416490047
ray_2.0.0,release/nightly_tests/dataset/sort.py,165,82,134,11,29,20,39,40,59,178.93519666370986,7.396551724137931,2322.471069132656,129.02617050736978,313.9937575983544,12,52.49042619583109
ray_2.0.0,release/nightly_tests/dataset/dataset_shuffle_data_loader.py,125,53,108,3,8,4,8,11,12,28.75488750216347,1.5,62.26976913547136,3.4594316186372978,41.51317942364757,7,50.114628095514725
ray_2.0.0,release/nightly_tests/dataset/inference.py,119,77,92,4,8,7,12,12,19,32.0,3.0,204.3428625411059,11.35238125228366,68.11428751370197,10,53.461534004988536
ray_2.0.0,release/nightly_tests/dataset/ray_sgd_runner.py,328,198,254,9,72,40,80,81,120,472.76392511682724,5.0,3803.9100017307746,211.3283334294875,760.782000346155,21,39.12271803427824
ray_2.0.0,release/nightly_tests/dataset/parquet_metadata_resolution.py,31,20,23,2,4,2,4,6,6,10.0,1.0,15.509775004326936,0.861654166907052,15.509775004326936,3,75.1231177401479
ray_2.0.0,release/nightly_tests/dataset/dataset_random_access.py,96,58,75,6,21,13,26,27,39,107.74844088268091,3.7142857142857144,688.7794181705368,38.26552323169649,185.4406125843753,5,61.15044302605677
ray_2.0.0,release/nightly_tests/dataset/ray_sgd_training.py,686,339,491,14,94,56,111,108,167,669.4343209665043,8.26595744680851,9324.547312693932,518.030406260774,1128.0662128612994,61,36.618869281020224
ray_2.0.0,release/nightly_tests/dataset/pipelined_training.py,341,208,286,11,47,30,57,58,87,299.11942383385923,6.670212765957447,3399.4362266299354,188.85756814610752,509.64434657609877,23,41.147489256803205
ray_2.0.0,release/nightly_tests/many_nodes_tests/actor_test.py,70,47,55,7,14,9,16,21,25,72.95445336320968,4.0,439.2317422778761,24.401763459882005,109.80793556946902,7,48.294852804307496
ray_2.0.0,release/nightly_tests/chaos_test/test_chaos_basic.py,235,137,159,6,29,18,34,35,52,156.39122386302654,3.5172413793103448,938.1281766164172,52.1182320342454,266.72271688113824,18,57.903708407696826
ray_2.0.0,release/nightly_tests/shuffle/shuffle_test.py,52,23,46,2,4,2,4,6,6,10.0,1.0,15.509775004326936,0.861654166907052,15.509775004326936,3,61.55517383325579
ray_2.0.0,release/nightly_tests/stress_tests/test_dead_actors.py,123,84,92,8,24,14,27,32,41,134.03910001730776,4.5,922.5,51.25,205.0,20,56.79780788411241
ray_2.0.0,release/nightly_tests/stress_tests/test_threaded_actors.py,163,107,113,11,32,22,39,43,61,198.0537478050103,6.703125,2218.7487869656125,123.26382149808958,331.00215003682797,29,56.967847689793246
ray_2.0.0,release/nightly_tests/stress_tests/test_placement_group.py,181,109,125,8,38,31,62,46,93,223.42124551085624,6.526315789473684,3352.511393539446,186.25063297441366,513.6912619133022,24,57.64193528675767
ray_2.0.0,release/nightly_tests/stress_tests/test_many_tasks.py,276,155,194,9,53,33,65,62,98,332.1091091048304,5.518867924528302,3220.321457306411,178.90674762813396,583.5112384179138,25,51.79035884455498
ray_2.0.0,release/nightly_tests/dask_on_ray/large_scale_test.py,479,206,327,11,68,44,84,79,128,452.0012210100334,6.794117647058823,5482.064387120606,304.55913261781143,806.8839357666692,30,50.12674335913772
ray_2.0.0,release/nightly_tests/dask_on_ray/dask_on_ray_sort.py,272,151,220,11,42,28,48,53,76,264.53107956171823,6.285714285714286,2736.3094285799057,152.01719047666143,435.32195454680317,23,45.494635273000746
ray_2.0.0,release/nightly_tests/placement_group_tests/long_running_performance_test.py,153,95,111,6,35,20,40,41,60,195.03468059740075,3.4285714285714284,1102.1249838071485,61.229165767063805,321.453120277085,15,56.912550692161275
ray_2.0.0,release/nightly_tests/placement_group_tests/cluster.py,13,9,9,0,0,0,0,0,0,0,0,0,0.0,0,1,100.0
ray_2.0.0,release/nightly_tests/placement_group_tests/pg_run.py,64,44,44,5,10,5,10,15,15,44.82892142331043,2.5,146.50839733531944,8.139355407517748,58.60335893412778,12,59.142755551433055
ray_2.0.0,release/nightly_tests/placement_group_tests/placement_group_performance_test.py,171,91,131,8,34,25,46,42,71,196.97373660251156,5.411764705882353,2071.91867091711,115.10659282872832,382.854537017292,14,56.15873483846831
ray_2.0.0,release/benchmarks/distributed/test_many_pgs.py,105,73,84,5,10,8,15,15,23,44.82892142331043,3.75,336.9693138712347,18.720517437290816,89.85848369899593,11,55.35466346324127
ray_2.0.0,release/benchmarks/distributed/test_scheduling.py,130,62,104,7,19,11,22,26,33,100.36210720983135,4.052631578947368,628.6219644103429,34.92344246724127,155.11451069865606,14,53.757922912090876
ray_2.0.0,release/benchmarks/distributed/test_many_tasks.py,107,65,85,9,27,17,33,36,50,156.9112875713945,5.5,1421.729375396636,78.98496529981311,258.49625007211563,11,54.78664940790969
ray_2.0.0,release/benchmarks/distributed/test_many_actors.py,79,47,64,5,10,8,15,15,23,44.82892142331043,3.75,336.9693138712347,18.720517437290816,89.85848369899593,8,56.2590399903028
ray_2.0.0,release/benchmarks/single_node/test_single_node.py,236,153,189,7,40,21,41,47,62,232.52860824989773,3.5875,1235.4794253343985,68.63774585191102,344.38450880401354,16,36.81715598876525
ray_2.0.0,release/benchmarks/object_store/test_object_store.py,73,48,56,5,12,8,16,17,24,54.62919048309069,3.3333333333333335,326.99702730002724,18.16650151666818,98.09910819000817,10,48.03476993545575
ray_2.0.0,release/xgboost_tests/create_test_data.py,50,17,45,2,4,2,4,6,6,10.0,1.0,15.509775004326936,0.861654166907052,15.509775004326936,3,64.41888735626253
ray_2.0.0,release/xgboost_tests/workloads/train_moderate.py,49,20,34,2,4,2,4,6,6,10.0,1.0,15.509775004326936,0.861654166907052,15.509775004326936,2,83.87887064513922
ray_2.0.0,release/xgboost_tests/workloads/tune_32x4.py,72,26,49,2,4,2,4,6,6,10.0,1.0,15.509775004326936,0.861654166907052,15.509775004326936,3,82.11304210073985
ray_2.0.0,release/xgboost_tests/workloads/ft_small_non_elastic.py,71,14,44,3,8,4,8,11,12,28.75488750216347,1.5,62.26976913547136,3.4594316186372978,41.51317942364757,3,89.66271489020103
ray_2.0.0,release/xgboost_tests/workloads/tune_small.py,72,26,49,2,4,2,4,6,6,10.0,1.0,15.509775004326936,0.861654166907052,15.509775004326936,3,82.11304210073985
ray_2.0.0,release/xgboost_tests/workloads/tune_4x32.py,72,26,49,2,4,2,4,6,6,10.0,1.0,15.509775004326936,0.861654166907052,15.509775004326936,3,82.11304210073985
ray_2.0.0,release/xgboost_tests/workloads/train_gpu.py,73,21,40,2,4,2,4,6,6,10.0,1.0,15.509775004326936,0.861654166907052,15.509775004326936,2,91.72082804946695
ray_2.0.0,release/xgboost_tests/workloads/train_small.py,64,31,45,2,4,2,4,6,6,10.0,1.0,15.509775004326936,0.861654166907052,15.509775004326936,3,77.35516466201268
ray_2.0.0,release/xgboost_tests/workloads/release_test_util.py,169,88,139,8,28,20,31,36,51,158.6059378176129,4.428571428571429,1167.6644896114708,64.87024942285949,263.6661750735579,27,47.066809879103275
ray_2.0.0,release/xgboost_tests/workloads/ft_small_elastic.py,94,28,61,3,9,5,11,12,16,33.28421251514428,1.8333333333333333,105.15890002115393,5.8421611122863295,57.359400011538504,7,79.6644230215573
ray_2.0.0,release/xgboost_tests/workloads/distributed_api_test.py,34,16,15,2,4,3,4,6,7,10.0,1.0,18.094737505048094,1.0052631947248942,18.094737505048094,6,93.00883832850374
ray_2.0.0,release/long_running_tests/workloads/many_ppo.py,53,18,41,5,13,7,14,18,21,59.715356810271004,2.6923076923076925,235.76114431231534,13.097841350684185,87.56842503028855,2,76.37864655373315
ray_2.0.0,release/long_running_tests/workloads/apex.py,58,12,37,5,13,7,14,18,21,59.715356810271004,2.6923076923076925,235.76114431231534,13.097841350684185,87.56842503028855,2,90.55579764931484
ray_2.0.0,release/long_running_tests/workloads/impala.py,62,15,37,6,14,8,16,20,24,68.81274391313339,3.4285714285714284,355.63294037930297,19.757385576627943,103.72627427729671,3,88.43428444073062
ray_2.0.0,release/long_running_tests/workloads/many_tasks.py,91,42,72,8,21,16,32,29,48,116.23866587835397,6.095238095238095,1421.306439717324,78.96146887318467,233.1830877661235,9,58.80315592223454
ray_2.0.0,release/long_running_tests/workloads/actor_deaths.py,134,73,102,9,26,18,35,35,53,150.74075768464922,6.0576923076923075,1646.7957686133884,91.48865381185492,271.8519998980832,21,56.36580155900066
ray_2.0.0,release/long_running_tests/workloads/many_actor_tasks.py,96,44,75,8,22,17,34,30,51,122.10749561002054,6.181818181818182,1547.0087805063947,85.94493225035527,250.25142037603445,11,57.65032960996017
ray_2.0.0,release/long_running_tests/workloads/serve.py,136,73,95,3,16,10,20,19,30,68.75488750216347,1.875,238.94592263120165,13.274773479511204,127.43782540330756,14,66.52574635870617
ray_2.0.0,release/long_running_tests/workloads/many_drivers.py,153,53,119,11,25,19,38,36,57,154.1501525493784,8.36,2463.5726616872903,136.86514787151611,294.6857250822118,11,56.735618232300986
ray_2.0.0,release/long_running_tests/workloads/pbt.py,65,20,54,6,14,9,18,20,27,68.81274391313339,3.857142857142857,450.09794016755535,25.005441120419743,116.69205856195879,5,70.19294336815446
ray_2.0.0,release/long_running_tests/workloads/many_tasks_serialized_ids.py,119,59,91,8,23,19,38,31,57,128.0419249893113,6.608695652173913,1866.2242101387778,103.67912278548766,282.3891896920519,14,57.160419238409006
ray_2.0.0,release/long_running_tests/workloads/serve_failure.py,163,96,126,6,20,15,30,26,45,101.94833690207419,4.5,951.8390429235714,52.879946829087295,211.51978731634918,23,51.965388840848114
ray_2.0.0,release/long_running_tests/workloads/node_failures.py,94,44,73,7,19,14,28,26,42,100.36210720983135,5.157894736842105,1018.2636778878283,56.57020432710157,197.4184681619259,11,60.23069341191767
ray_2.0.0,release/air_tests/air_benchmarks/workloads/tune_torch_benchmark.py,152,78,108,4,8,5,10,12,15,32.0,2.5,134.43609377704337,7.468671876502409,53.77443751081735,4,58.67905129668078
ray_2.0.0,release/air_tests/air_benchmarks/workloads/xgboost_benchmark.py,144,93,121,3,8,4,8,11,12,28.75488750216347,1.5,62.26976913547136,3.4594316186372978,41.51317942364757,4,45.19101242911803
ray_2.0.0,release/air_tests/air_benchmarks/workloads/benchmark_util.py,159,92,110,4,13,7,13,17,20,56.105716335834195,2.0,163.4985136500136,9.083250758334088,81.7492568250068,18,49.413398672387714
ray_2.0.0,release/air_tests/air_benchmarks/workloads/_torch_prepare.py,3,2,2,0,0,0,0,0,0,0,0,0,0.0,0,1,100.0
ray_2.0.0,release/air_tests/air_benchmarks/workloads/pytorch_training_e2e.py,134,74,103,6,18,11,22,24,33,90.56842503028855,3.6666666666666665,554.78046258726,30.82113681040333,151.30376252379818,6,61.47514859431969
ray_2.0.0,release/air_tests/air_benchmarks/workloads/data_benchmark.py,66,40,54,4,14,8,16,18,24,61.30296890880645,2.2857142857142856,228.75017150769253,12.708342861538474,100.07820003461549,2,58.913347248223815
ray_2.0.0,release/air_tests/air_benchmarks/workloads/_tensorflow_prepare.py,3,2,2,0,0,0,0,0,0,0,0,0,0.0,0,1,100.0
ray_2.0.0,release/air_tests/air_benchmarks/workloads/gpu_batch_prediction.py,77,41,59,4,8,4,8,12,12,32.0,2.0,86.03910001730776,4.779950000961542,43.01955000865388,3,67.99759217985603
ray_2.0.0,release/air_tests/air_benchmarks/workloads/tensorflow_benchmark.py,423,183,337,10,32,18,33,42,51,193.21928094887363,5.15625,1418.010972271352,78.77838734840844,275.0081885617168,16,43.79369178752613
ray_2.0.0,release/air_tests/air_benchmarks/workloads/torch_benchmark.py,576,252,456,11,47,27,53,58,80,299.11942383385923,6.202127659574468,2906.5556767313824,161.47531537396569,468.63847961020576,33,38.602120909124174
ray_2.0.0,release/air_tests/horovod/workloads/horovod_tune_test.py,175,83,140,7,19,15,29,26,44,100.36210720983135,5.342105263157895,1104.8507253272694,61.38059585151497,206.81934759820808,17,55.68099379980886
ray_2.0.0,release/microbenchmark/run_microbenchmark.py,36,19,27,3,6,4,8,9,12,20.264662506490406,2.0,76.0782000346155,4.226566668589751,38.03910001730775,9,59.82999574798998
ray_2.0.0,release/tune_tests/cloud_tests/workloads/run_cloud_test.py,1302,536,859,14,100,73,138,114,211,717.6885878862789,9.66,13927.206400271429,773.7336889039683,1441.7397929887607,89,28.96920778865504
ray_2.0.0,release/tune_tests/cloud_tests/workloads/_tune_script.py,142,67,114,5,23,15,28,28,43,115.65156546374811,3.0434782608695654,629.1364484953648,34.95202491640916,206.71626164847697,17,41.6672365246239
ray_2.0.0,release/tune_tests/scalability_tests/create_test_data.py,53,19,47,2,4,2,4,6,6,10.0,1.0,15.509775004326936,0.861654166907052,15.509775004326936,4,63.230667889136434
ray_2.0.0,release/tune_tests/scalability_tests/workloads/test_result_throughput_cluster.py,51,19,25,1,2,1,2,3,3,2.0,0.5,2.3774437510817346,0.1320802083934297,4.754887502163469,3,95.93332530346339
ray_2.0.0,release/tune_tests/scalability_tests/workloads/test_long_running_large_checkpoints.py,58,19,34,4,8,4,8,12,12,32.0,2.0,86.03910001730776,4.779950000961542,43.01955000865388,4,87.14789644663516
ray_2.0.0,release/tune_tests/scalability_tests/workloads/test_result_throughput_single_node.py,44,15,20,1,2,1,2,3,3,2.0,0.5,2.3774437510817346,0.1320802083934297,4.754887502163469,2,98.41127511870555
ray_2.0.0,release/tune_tests/scalability_tests/workloads/test_bookkeeping_overhead.py,43,14,19,1,2,1,2,3,3,2.0,0.5,2.3774437510817346,0.1320802083934297,4.754887502163469,2,99.16112949143219
ray_2.0.0,release/tune_tests/scalability_tests/workloads/test_xgboost_sweep.py,114,39,76,4,7,4,7,11,11,27.651484454403228,2.0,76.10749561002055,4.228194200556697,38.053747805010275,4,76.96145629373878
ray_2.0.0,release/tune_tests/scalability_tests/workloads/test_durable_trainable.py,91,42,60,5,9,5,10,14,15,40.13896548741762,2.7777777777777777,158.6397884190668,8.813321578837044,57.110323830864054,8,73.88391692798412
ray_2.0.0,release/tune_tests/scalability_tests/workloads/test_network_overhead.py,52,18,29,2,3,2,3,5,5,6.754887502163469,1.0,11.60964047443681,0.6449800263576005,11.60964047443681,3,92.18455815763853
ray_2.0.0,release/release_logs/fetch_release_logs.py,214,113,140,4,9,7,9,13,16,36.52932501298081,2.0,118.41407098051495,6.578559498917497,59.207035490257475,14,61.55055923637577
ray_2.0.0,release/ml_user_tests/tune_rllib/run_connect_tests.py,35,23,24,4,8,4,8,12,12,32.0,2.0,86.03910001730776,4.779950000961542,43.01955000865388,5,77.73934239789442
ray_2.0.0,release/ml_user_tests/train/train_tensorflow_mnist_test.py,32,21,24,4,8,4,8,12,12,32.0,2.0,86.03910001730776,4.779950000961542,43.01955000865388,4,59.18019430260737
ray_2.0.0,release/ml_user_tests/train/train_torch_linear_test.py,38,23,23,4,8,4,8,12,12,32.0,2.0,86.03910001730776,4.779950000961542,43.01955000865388,4,82.37336820516192
ray_2.0.0,release/ml_user_tests/xgboost/train_gpu_connect.py,76,30,52,2,4,2,4,6,6,10.0,1.0,15.509775004326936,0.861654166907052,15.509775004326936,3,82.09894121895815
ray_2.0.0,release/ml_user_tests/xgboost/release_test_util.py,169,88,139,8,28,20,31,36,51,158.6059378176129,4.428571428571429,1167.6644896114708,64.87024942285949,263.6661750735579,27,47.066809879103275
ray_2.0.0,release/ml_user_tests/horovod/horovod_user_test.py,36,24,28,2,4,2,4,6,6,10.0,1.0,15.509775004326936,0.861654166907052,15.509775004326936,3,61.151977486130356
ray_2.0.0,release/ml_user_tests/horovod/horovod_example.py,242,95,201,9,21,13,24,30,37,120.76799089133479,5.142857142857143,933.7111819072211,51.87284343929006,181.5549520375152,22,53.28612038410503
ray_2.0.0,release/ml_user_tests/ray-lightning/simple_example.py,99,51,79,4,6,5,9,10,14,23.509775004326936,3.0,139.52097998526924,7.75116555473718,46.50699332842308,8,64.56044608264303
ray_2.0.0,release/ml_user_tests/ray-lightning/ray_lightning_user_test.py,41,23,28,2,4,2,4,6,6,10.0,1.0,15.509775004326936,0.861654166907052,15.509775004326936,3,84.00945216170645
ray_2.0.0,release/lightgbm_tests/create_test_data.py,50,17,45,2,4,2,4,6,6,10.0,1.0,15.509775004326936,0.861654166907052,15.509775004326936,3,64.41888735626253
ray_2.0.0,release/lightgbm_tests/workloads/tune_16x4.py,72,26,49,2,4,2,4,6,6,10.0,1.0,15.509775004326936,0.861654166907052,15.509775004326936,3,82.11304210073985
ray_2.0.0,release/lightgbm_tests/workloads/train_moderate.py,49,20,34,2,4,2,4,6,6,10.0,1.0,15.509775004326936,0.861654166907052,15.509775004326936,2,83.87887064513922
ray_2.0.0,release/lightgbm_tests/workloads/ft_small_non_elastic.py,61,12,35,1,2,1,2,3,3,2.0,0.5,2.3774437510817346,0.1320802083934297,4.754887502163469,2,99.31249586632582
ray_2.0.0,release/lightgbm_tests/workloads/tune_small.py,72,26,49,2,4,2,4,6,6,10.0,1.0,15.509775004326936,0.861654166907052,15.509775004326936,3,82.11304210073985
ray_2.0.0,release/lightgbm_tests/workloads/train_small.py,64,31,45,2,4,2,4,6,6,10.0,1.0,15.509775004326936,0.861654166907052,15.509775004326936,3,77.35516466201268
ray_2.0.0,release/lightgbm_tests/workloads/release_test_util.py,170,85,140,8,25,19,29,33,48,140.0964047443681,4.64,1123.4874582635146,62.415969903528584,242.13091772920575,29,47.35097576649572
ray_2.0.0,release/lightgbm_tests/workloads/tune_4x16.py,72,26,49,2,4,2,4,6,6,10.0,1.0,15.509775004326936,0.861654166907052,15.509775004326936,3,82.11304210073985
ray_2.0.0,release/lightgbm_tests/workloads/distributed_api_test.py,27,11,10,2,3,2,3,5,5,6.754887502163469,1.0,11.60964047443681,0.6449800263576005,11.60964047443681,4,98.14221106612581
ray_2.0.0,release/cluster_tests/workloads/tune_scale_up_down.py,57,32,39,3,9,6,11,12,17,33.28421251514428,1.8333333333333333,111.73133127247604,6.2072961818042245,60.94436251225966,12,66.27685017375197
ray_2.0.0,release/golden_notebook_tests/workloads/torch_tune_serve_test.py,281,167,215,8,20,12,22,28,34,110.43856189774725,4.4,719.1802963398176,39.95446090776764,163.45006734995852,19,46.66809684594324
ray_2.0.0,release/golden_notebook_tests/workloads/util.py,17,11,12,0,0,0,0,0,0,0,0,0,0.0,0,2,100.0
ray_2.0.0,release/long_running_distributed_tests/workloads/pytorch_pbt_failure.py,79,25,69,3,4,4,5,7,9,12.75488750216347,1.875,47.374114309722074,2.6318952394290043,25.26619429851844,5,73.00227217617312
ray_2.0.0,release/jobs_tests/workloads/run_simple_tune_job.py,35,16,21,5,12,7,13,17,20,54.62919048309069,2.7083333333333335,221.4042372343934,12.300235401910745,81.7492568250068,2,84.85093159413749
ray_2.0.0,release/jobs_tests/workloads/jobs_basic.py,82,46,59,7,21,11,22,28,33,111.8901503327572,3.6666666666666665,581.6899455689701,32.316108087165006,158.64271242790093,9,63.69804750613094
ray_2.0.0,release/runtime_env_tests/workloads/wheel_urls.py,91,51,64,7,13,9,18,20,27,67.75720079023742,4.846153846153846,565.5076684156464,31.417092689758135,116.69205856195879,12,70.17034980529364
ray_2.0.0,release/runtime_env_tests/workloads/rte_many_tasks_actors.py,128,68,102,3,14,13,26,17,39,58.05785641096992,2.7857142857142856,444.07364153869764,24.67075786326098,159.41105080876326,15,57.68996831602911
ray_2.0.0,release/runtime_env_tests/workloads/rte_ray_client.py,92,55,53,5,14,7,14,19,21,64.91260938324326,2.5,223.01619445578822,12.389788580877124,89.20647778231529,8,74.26565681152074
ray_2.0.0,release/train_tests/horovod/train_horovod_multi_node_test.py,37,25,32,4,10,6,11,14,17,41.219280948873624,2.2,142.3950740849544,7.9108374491641325,64.72503367497926,5,56.15172034992741
ray_2.0.0,release/ray_release/job_manager.py,104,71,85,7,19,14,26,26,40,100.36210720983135,4.7894736842105265,900.5052933701883,50.02807185389935,188.0175887256437,16,56.83689296329385
ray_2.0.0,release/ray_release/result.py,85,73,63,3,9,9,14,12,23,33.28421251514428,2.3333333333333335,192.39298753870207,10.688499307705671,82.4541375165866,7,65.62423764838849
ray_2.0.0,release/ray_release/__init__.py,0,0,0,0,0,0,0,0,0,0,0,0,0.0,0,1,100.0
ray_2.0.0,release/ray_release/util.py,150,78,102,5,13,7,14,18,21,59.715356810271004,2.6923076923076925,235.76114431231534,13.097841350684185,87.56842503028855,13,55.04120052837928
ray_2.0.0,release/ray_release/template.py,162,81,119,3,12,8,12,15,20,47.77443751081735,1.5,117.20671786825557,6.511484326014198,78.13781191217038,10,43.76950786049932
ray_2.0.0,release/ray_release/config.py,136,84,103,7,16,12,21,23,33,83.65148445440323,4.59375,685.7437202760178,38.09687334866766,149.27754454988144,19,46.174382666440444
ray_2.0.0,release/ray_release/logger.py,18,11,13,1,1,1,1,2,2,0.0,0.5,1.0,0.05555555555555555,2.0,2,74.9062755799735
ray_2.0.0,release/ray_release/glue.py,335,197,268,8,24,14,24,32,38,134.03910001730776,4.0,760.0,42.22222222222222,190.0,36,41.564229811057814
ray_2.0.0,release/ray_release/env.py,31,20,22,1,2,2,2,3,4,2.0,0.5,3.1699250014423126,0.17610694452457293,6.339850002884625,5,65.33069625729264
ray_2.0.0,release/ray_release/anyscale_util.py,52,30,34,3,13,8,14,16,22,52.860603837997665,1.6153846153846154,142.15384615384616,7.897435897435898,88.0,11,52.68330466771136
ray_2.0.0,release/ray_release/aws.py,50,23,41,1,1,1,1,2,2,0.0,0.5,1.0,0.05555555555555555,2.0,3,83.32811644325106
ray_2.0.0,release/ray_release/exception.py,137,69,69,0,0,0,0,0,0,0,0,0,0.0,0,1,100.0
ray_2.0.0,release/ray_release/wheels.py,398,190,301,11,43,32,52,54,84,271.3831322572005,6.651162790697675,3215.242263999423,178.62457022219016,483.4105501817314,39,44.04229633662056
ray_2.0.0,release/ray_release/reporter/rds.py,8,6,6,0,0,0,0,0,0,0,0,0,0.0,0,2,100.0
ray_2.0.0,release/ray_release/reporter/__init__.py,0,0,0,0,0,0,0,0,0,0,0,0,0.0,0,1,100.0
ray_2.0.0,release/ray_release/reporter/legacy_rds.py,122,48,103,3,16,10,19,19,29,68.75488750216347,1.78125,219.4320056163202,12.190666978684455,123.18989788986397,15,56.79555774048588
ray_2.0.0,release/ray_release/reporter/reporter.py,9,6,5,0,0,0,0,0,0,0,0,0,0.0,0,2,100.0
ray_2.0.0,release/ray_release/reporter/db.py,47,23,40,3,12,8,15,15,23,47.77443751081735,1.875,168.48465693561735,9.360258718645408,89.85848369899593,11,55.13693938523058
ray_2.0.0,release/ray_release/reporter/log.py,36,17,31,1,2,1,2,3,3,2.0,0.5,2.3774437510817346,0.1320802083934297,4.754887502163469,4,67.87967487402553
ray_2.0.0,release/ray_release/reporter/artifacts.py,35,22,24,1,1,1,1,2,2,0.0,0.5,1.0,0.05555555555555555,2.0,4,84.53613577922161
ray_2.0.0,release/ray_release/tests/test_glue.py,614,341,430,4,25,18,35,29,53,124.09640474436812,2.8,720.9243796769317,40.051354426496204,257.47299274176135,45,39.275825431599586
ray_2.0.0,release/ray_release/tests/test_run_script.py,111,54,89,1,4,2,4,5,6,8.0,0.5,6.965784284662087,0.3869880158145604,13.931568569324174,12,52.585286574822945
ray_2.0.0,release/ray_release/tests/utils.py,52,37,36,2,3,2,3,5,5,6.754887502163469,1.0,11.60964047443681,0.6449800263576005,11.60964047443681,5,57.66291433203544
ray_2.0.0,release/ray_release/tests/test_wheels.py,249,129,197,6,30,16,30,36,46,162.7164928725825,3.0,713.4496501990391,39.636091677724394,237.81655006634637,26,43.30209115364528
ray_2.0.0,release/ray_release/tests/test_alerts.py,48,21,35,1,2,1,2,3,3,2.0,0.5,2.3774437510817346,0.1320802083934297,4.754887502163469,5,89.1239909593345
ray_2.0.0,release/ray_release/tests/test_buildkite.py,654,304,547,3,14,11,22,17,33,58.05785641096992,2.357142857142857,317.94621672297285,17.663678706831824,134.8862737612612,20,41.22484752377451
ray_2.0.0,release/ray_release/tests/_test_run_release_test_sh.py,43,28,33,3,7,6,11,10,17,24.406371956566698,2.357142857142857,133.11440437370075,7.3952446874278195,56.472777613085164,6,55.35832844664056
ray_2.0.0,release/ray_release/tests/__init__.py,0,0,0,0,0,0,0,0,0,0,0,0,0.0,0,1,100.0
ray_2.0.0,release/ray_release/tests/test_config.py,99,43,74,1,2,1,2,3,3,2.0,0.5,2.3774437510817346,0.1320802083934297,4.754887502163469,5,76.35203050783602
ray_2.0.0,release/ray_release/tests/_test_catch_args.py,14,9,9,1,2,1,2,3,3,2.0,0.5,2.3774437510817346,0.1320802083934297,4.754887502163469,2,74.17383745932607
ray_2.0.0,release/ray_release/tests/test_cluster_manager.py,755,333,648,3,8,4,8,11,12,28.75488750216347,1.5,62.26976913547136,3.4594316186372978,41.51317942364757,31,41.68375110160238
ray_2.0.0,release/ray_release/tests/test_env.py,44,25,28,3,9,5,10,12,15,33.28421251514428,1.6666666666666667,89.62406251802892,4.9791145843349405,53.77443751081735,7,56.4463514145493
ray_2.0.0,release/ray_release/tests/test_template.py,66,35,45,1,10,5,10,11,15,33.219280948873624,0.5,25.945737139779734,1.4414298410988742,51.89147427955947,11,61.71795020552781
ray_2.0.0,release/ray_release/command_runner/sdk_runner.py,178,84,143,8,21,16,29,29,45,116.23866587835397,5.523809523809524,1207.5552759317109,67.08640421842838,218.60914478074076,22,50.723567762000435
ray_2.0.0,release/ray_release/command_runner/_wait_cluster.py,54,25,42,4,10,8,15,14,23,41.219280948873624,3.0,262.7074896219747,14.59486053455415,87.56916320732489,6,55.098000739553584
ray_2.0.0,release/ray_release/command_runner/__init__.py,0,0,0,0,0,0,0,0,0,0,0,0,0.0,0,1,100.0
ray_2.0.0,release/ray_release/command_runner/command_runner.py,77,38,41,0,0,0,0,0,0,0,0,0,0.0,0,12,100.0
ray_2.0.0,release/ray_release/command_runner/client_runner.py,193,105,162,9,27,18,36,36,54,156.9112875713945,6.0,1675.0557004673092,93.05865002596163,279.17595007788486,27,39.891373454238014
ray_2.0.0,release/ray_release/command_runner/job_runner.py,130,69,105,3,10,5,10,13,15,37.974168451037094,1.5,83.25989365817458,4.625549647676365,55.506595772116384,20,57.75868276013432
ray_2.0.0,release/ray_release/buildkite/step.py,130,63,106,6,18,12,22,24,34,90.56842503028855,3.6666666666666665,571.5919917565709,31.75511065314283,155.88872502451935,13,49.491687128169424
ray_2.0.0,release/ray_release/buildkite/__init__.py,0,0,0,0,0,0,0,0,0,0,0,0,0.0,0,1,100.0
ray_2.0.0,release/ray_release/buildkite/concurrency.py,137,65,98,8,28,20,32,36,52,158.6059378176129,4.571428571428571,1228.9650289142867,68.2758349396826,268.8361000750002,12,61.2194332997763
ray_2.0.0,release/ray_release/buildkite/settings.py,220,128,168,6,28,20,38,34,58,150.11571282193984,4.071428571428571,1201.3680109409731,66.7426672744985,295.07284479251973,29,43.99783556034746
ray_2.0.0,release/ray_release/buildkite/filter.py,58,38,45,6,14,10,19,20,29,68.81274391313339,4.071428571428571,510.29622434634354,28.34979024146353,125.33591475173351,14,65.90119251335364
ray_2.0.0,release/ray_release/buildkite/output.py,22,14,16,2,5,3,6,7,9,13.60964047443681,1.2,30.319433158222125,1.6844129532345624,25.26619429851844,4,79.1181700696192
ray_2.0.0,release/ray_release/cluster_manager/cluster_manager.py,90,52,70,2,6,4,6,8,10,17.509775004326936,1.0,30.0,1.6666666666666667,30.0,15,57.374540411460835
ray_2.0.0,release/ray_release/cluster_manager/__init__.py,0,0,0,0,0,0,0,0,0,0,0,0,0.0,0,1,100.0
ray_2.0.0,release/ray_release/cluster_manager/full.py,127,59,98,5,13,11,19,18,30,59.715356810271004,3.6538461538461537,457.0879328504073,25.39377404724485,125.09775004326937,13,62.90846949710155
ray_2.0.0,release/ray_release/cluster_manager/minimal.py,307,160,250,9,32,28,46,41,74,188.52932501298082,6.46875,2564.593175210619,142.47739862281216,396.4588483417382,57,37.26185658396734
ray_2.0.0,release/ray_release/scripts/build_pipeline.py,180,98,144,4,19,11,22,23,33,88.71062275542812,2.3157894736842106,345.69536632604127,19.205298129224516,149.27754454988144,18,51.818429337386604
ray_2.0.0,release/ray_release/scripts/run_release_test.py,170,63,152,4,11,7,12,15,19,46.053747805010275,2.1818181818181817,161.9583737815895,8.997687432310528,74.23092131656186,11,46.17185807626887
ray_2.0.0,release/ray_release/scripts/__init__.py,0,0,0,0,0,0,0,0,0,0,0,0,0.0,0,1,100.0
ray_2.0.0,release/ray_release/scripts/convert_legacy_config.py,89,62,65,7,23,15,27,30,42,123.69340944371453,4.108695652173913,846.7586423465309,47.042146797029496,206.0894050155578,17,42.41123423890253
ray_2.0.0,release/ray_release/scripts/get_aws_instance_information.py,45,27,33,3,6,3,6,9,9,20.264662506490406,1.5,42.793987519471216,2.377443751081734,28.529325012980813,7,57.64479166025633
ray_2.0.0,release/ray_release/alerts/xgboost_tests.py,66,41,53,7,19,15,29,26,44,100.36210720983135,5.342105263157895,1104.8507253272694,61.38059585151497,206.81934759820808,14,60.559750702912595
ray_2.0.0,release/ray_release/alerts/rllib_tests.py,22,7,17,2,5,3,5,7,8,13.60964047443681,1.0,22.458839376460833,1.2477132986922685,22.458839376460833,3,71.69912126698075
ray_2.0.0,release/ray_release/alerts/__init__.py,0,0,0,0,0,0,0,0,0,0,0,0,0.0,0,1,100.0
ray_2.0.0,release/ray_release/alerts/tune_tests.py,68,46,58,6,25,20,37,31,57,131.60617974869504,4.44,1253.8080022327106,69.65600012403948,282.3891896920519,16,44.415743279607824
ray_2.0.0,release/ray_release/alerts/default.py,15,7,10,1,2,1,2,3,3,2.0,0.5,2.3774437510817346,0.1320802083934297,4.754887502163469,2,76.55471099040834
ray_2.0.0,release/ray_release/alerts/long_running_tests.py,43,17,31,2,6,4,8,8,12,17.509775004326936,1.3333333333333333,48.0,2.6666666666666665,36.0,5,81.39822447100812
ray_2.0.0,release/ray_release/alerts/handle.py,41,17,31,1,2,1,2,3,3,2.0,0.5,2.3774437510817346,0.1320802083934297,4.754887502163469,3,68.01417779800212
ray_2.0.0,release/ray_release/file_manager/remote_task.py,82,44,58,0,0,0,0,0,0,0,0,0,0.0,0,5,100.0
ray_2.0.0,release/ray_release/file_manager/session_controller.py,56,23,44,2,9,6,13,11,19,30.529325012980813,1.4444444444444444,94.94217886704584,5.274565492613657,65.72920075410866,13,68.3199521431931
ray_2.0.0,release/ray_release/file_manager/__init__.py,0,0,0,0,0,0,0,0,0,0,0,0,0.0,0,1,100.0
ray_2.0.0,release/ray_release/file_manager/file_manager.py,20,12,10,0,0,0,0,0,0,0,0,0,0.0,0,4,100.0
ray_2.0.0,release/ray_release/file_manager/job_file_manager.py,157,76,127,4,13,7,14,17,21,56.105716335834195,2.1538461538461537,184.87908851193845,10.27106047288547,85.83671966625714,18,58.33450312414712
ray_2.0.0,dashboard/utils.py,509,324,332,11,45,28,52,56,80,285.1871371398456,6.355555555555555,2952.7173470372886,164.0398526131827,464.5883937646084,92,37.00699110631348
ray_2.0.0,dashboard/optional_utils.py,289,182,215,11,29,18,32,40,50,178.93519666370986,6.068965517241379,1614.9299046554756,89.71832803641531,266.09640474436816,22,50.05235423544348
ray_2.0.0,dashboard/consts.py,54,30,38,1,2,2,4,3,6,2.0,1.0,9.509775004326938,0.5283208335737188,9.509775004326938,1,88.61276128440788
ray_2.0.0,dashboard/http_server_head.py,146,77,111,8,16,9,17,24,26,88.0,4.25,506.63835632968784,28.146575351649325,119.20902501875008,20,63.2835674483215
ray_2.0.0,dashboard/k8s_utils.py,111,58,77,9,31,16,32,40,48,182.10941063497398,4.645161290322581,1186.618290060047,65.92323833666927,255.45254855459342,11,66.887973952988
ray_2.0.0,dashboard/http_server_agent.py,83,44,63,3,6,3,6,9,9,20.264662506490406,1.5,42.793987519471216,2.377443751081734,28.529325012980813,12,70.97359627521291
ray_2.0.0,dashboard/memory_utils.py,522,292,407,13,132,96,187,145,283,977.9657400911501,9.208333333333334,18710.54392570017,1039.4746625388984,2031.9142724742264,95,29.209613244666542
ray_2.0.0,dashboard/__init__.py,0,0,0,0,0,0,0,0,0,0,0,0,0.0,0,1,100.0
ray_2.0.0,dashboard/datacenter.py,344,217,255,9,32,19,37,41,56,188.52932501298082,5.203125,1561.056715345594,86.72537307475523,300.0229122586127,49,48.316253843573904
ray_2.0.0,dashboard/head.py,227,132,175,7,13,9,16,20,25,67.75720079023742,4.3076923076923075,465.43841021863904,25.857689456591057,108.04820237218406,24,53.41893908149132
ray_2.0.0,dashboard/state_aggregator.py,679,301,522,9,51,34,65,60,99,317.8230174535271,5.735294117647059,3353.897733771249,186.3276518761805,584.7821689652434,76,39.116367030699735
ray_2.0.0,dashboard/agent.py,474,190,395,14,40,24,45,54,69,266.18009270430093,7.875,3127.061996488075,173.72566647155972,397.08723764927936,28,46.24097116225408
ray_2.0.0,dashboard/dashboard.py,215,61,177,2,4,2,4,6,6,10.0,1.0,15.509775004326936,0.861654166907052,15.509775004326936,7,70.91859707123989
ray_2.0.0,dashboard/optional_deps.py,18,9,9,0,0,0,0,0,0,0,0,0,0.0,0,1,100.0
ray_2.0.0,dashboard/tests/test_dashboard.py,972,603,757,15,226,138,273,241,411,1825.9638044399603,9.059734513274336,29464.046090476008,1636.8914494708893,3252.197517190514,141,9.65317837126598
ray_2.0.0,dashboard/tests/__init__.py,0,0,0,0,0,0,0,0,0,0,0,0,0.0,0,1,100.0
ray_2.0.0,dashboard/tests/conftest.py,49,37,37,1,4,3,6,5,9,8.0,0.75,15.673014640489694,0.8707230355827608,20.89735285398626,4,69.55763855314036
ray_2.0.0,dashboard/tests/test_state_head.py,92,50,66,3,17,11,22,20,33,74.24175580341925,1.9411764705882353,276.85762913719634,15.380979396510908,142.62362713128297,18,55.75364018908988
ray_2.0.0,dashboard/tests/test_memory_utils.py,272,101,224,6,41,32,62,47,94,235.16940719366838,4.536585365853658,2368.6934507983365,131.59408059990758,522.1313520576979,38,41.8636834130471
ray_2.0.0,dashboard/modules/dashboard_sdk.py,383,156,299,11,43,27,52,54,79,271.3831322572005,6.651162790697675,3023.8587959042193,167.9921553280122,454.6361126709141,42,47.588863973864136
ray_2.0.0,dashboard/modules/__init__.py,0,0,0,0,0,0,0,0,0,0,0,0,0.0,0,1,100.0
ray_2.0.0,dashboard/modules/version.py,14,10,7,0,0,0,0,0,0,0,0,0,0.0,0,1,100.0
ray_2.0.0,dashboard/modules/actor/actor_head.py,276,166,227,6,22,12,23,28,35,113.61727061434748,3.1363636363636362,527.7164607622324,29.317581153457354,168.25742227201613,34,49.97024584138014
ray_2.0.0,dashboard/modules/actor/actor_utils.py,78,49,63,10,23,18,33,33,51,137.26120593818493,7.173913043478261,1845.590283234843,102.53279351304683,257.2641000872811,10,59.489875262708814
ray_2.0.0,dashboard/modules/actor/__init__.py,0,0,0,0,0,0,0,0,0,0,0,0,0.0,0,1,100.0
ray_2.0.0,dashboard/modules/actor/actor_consts.py,5,4,4,0,0,0,0,0,0,0,0,0,0.0,0,1,100.0
ray_2.0.0,dashboard/modules/actor/tests/test_actor.py,439,289,366,11,116,66,132,127,198,833.5795432398086,6.258620689655173,8660.426261673494,481.1347923151941,1383.759567980889,78,29.172914582812986
ray_2.0.0,dashboard/modules/reporter/reporter_head.py,182,99,147,3,7,4,7,10,11,24.406371956566698,1.5,54.81181356564148,3.0451007536467487,36.541209043760986,25,60.1333642017
ray_2.0.0,dashboard/modules/reporter/__init__.py,0,0,0,0,0,0,0,0,0,0,0,0,0.0,0,1,100.0
ray_2.0.0,dashboard/modules/reporter/reporter_agent.py,820,363,699,14,101,63,121,115,184,725.7823286667377,8.386138613861386,10562.930034253257,586.8294463474032,1259.570169373765,88,26.27355083744352
ray_2.0.0,dashboard/modules/reporter/reporter_consts.py,7,3,5,0,0,0,0,0,0,0,0,0,0.0,0,1,100.0
ray_2.0.0,dashboard/modules/reporter/tests/test_reporter.py,308,148,260,8,67,48,96,75,144,430.42797576067073,5.731343283582089,5140.727735965077,285.5959853313932,896.9498914314067,19,40.984883041690956
ray_2.0.0,dashboard/modules/tests/test_dashboard_sdk.py,95,48,71,1,14,7,14,15,21,53.30296890880645,0.5,41.02235125388945,2.279019514104969,82.0447025077789,16,64.33801620287292
ray_2.0.0,dashboard/modules/usage_stats/__init__.py,0,0,0,0,0,0,0,0,0,0,0,0,0.0,0,1,100.0
ray_2.0.0,dashboard/modules/usage_stats/usage_stats_head.py,115,72,87,2,7,6,9,9,15,21.651484454403228,1.2857142857142858,61.13426788495889,3.396348215831049,47.548875021634686,15,66.06871165473304
ray_2.0.0,dashboard/modules/runtime_env/runtime_env_consts.py,7,3,5,0,0,0,0,0,0,0,0,0,0.0,0,1,100.0
ray_2.0.0,dashboard/modules/runtime_env/__init__.py,0,0,0,0,0,0,0,0,0,0,0,0,0.0,0,1,100.0
ray_2.0.0,dashboard/modules/runtime_env/runtime_env_agent.py,550,273,422,14,49,31,56,63,87,328.42375127045165,8.0,4160.186826755942,231.12149037533013,520.0233533444928,54,42.54261241011742
ray_2.0.0,dashboard/modules/runtime_env/tests/test_runtime_env_agent.py,82,48,66,3,8,8,11,11,19,28.75488750216347,2.0625,135.5664765553491,7.531470919741618,65.72920075410866,6,65.57709184559528
ray_2.0.0,dashboard/modules/snapshot/__init__.py,0,0,0,0,0,0,0,0,0,0,0,0,0.0,0,1,100.0
ray_2.0.0,dashboard/modules/snapshot/snapshot_head.py,439,200,365,10,38,24,44,48,68,232.64052645972987,5.7894736842105265,2198.711552915487,122.15064182863817,379.7774500490387,54,41.083548757750755
ray_2.0.0,dashboard/modules/snapshot/tests/test_snapshot.py,358,192,265,8,105,78,151,113,229,728.9957793549429,5.752380952380952,8984.18927014685,499.1216261192694,1561.820982393078,77,36.75476952030949
ray_2.0.0,dashboard/modules/snapshot/tests/conftest.py,1,1,1,0,0,0,0,0,0,0,0,0,0.0,0,1,100.0
ray_2.0.0,dashboard/modules/snapshot/tests/test_actors.py,94,62,66,5,9,5,9,14,14,40.13896548741762,2.5,133.25742227201613,7.403190126223119,53.30296890880645,11,67.58367979354695
ray_2.0.0,dashboard/modules/snapshot/tests/test_job_submission.py,188,114,157,10,76,45,90,86,135,508.06177197058616,5.921052631578948,5136.783998002006,285.37688877788923,867.5457418847832,4,47.93713487905852
ray_2.0.0,dashboard/modules/test/test_consts.py,1,1,1,0,0,0,0,0,0,0,0,0,0.0,0,1,100.0
ray_2.0.0,dashboard/modules/test/test_head.py,113,75,95,2,3,2,3,5,5,6.754887502163469,1.0,11.60964047443681,0.6449800263576005,11.60964047443681,20,48.95154751656656
ray_2.0.0,dashboard/modules/test/__init__.py,0,0,0,0,0,0,0,0,0,0,0,0,0.0,0,1,100.0
ray_2.0.0,dashboard/modules/test/test_agent.py,45,32,34,0,0,0,0,0,0,0,0,0,0.0,0,8,100.0
ray_2.0.0,dashboard/modules/test/test_utils.py,11,7,7,0,0,0,0,0,0,0,0,0,0.0,0,1,100.0
ray_2.0.0,dashboard/modules/job/common.py,264,162,177,9,39,28,48,48,76,234.6600115486085,5.538461538461538,2350.8396003035514,130.60220001686397,424.4571500548079,46,50.95375355823265
ray_2.0.0,dashboard/modules/job/utils.py,66,45,42,7,11,11,20,18,31,57.705232259413506,6.363636363636363,822.612477557256,45.700693197625334,129.26767504471167,11,75.67571387510661
ray_2.0.0,dashboard/modules/job/job_manager.py,589,270,363,12,50,31,60,62,91,325.2123594973901,7.2,3901.189422565481,216.73274569808228,541.8318642452057,72,46.63464737555793
ray_2.0.0,dashboard/modules/job/pydantic_models.py,81,44,60,0,0,0,0,0,0,0,0,0,0.0,0,1,100.0
ray_2.0.0,dashboard/modules/job/__init__.py,0,0,0,0,0,0,0,0,0,0,0,0,0.0,0,1,100.0
ray_2.0.0,dashboard/modules/job/job_head.py,389,174,325,5,20,14,20,25,34,98.04820237218406,2.5,394.72777613085157,21.92932089615842,157.89111045234063,48,43.65231425405058
ray_2.0.0,dashboard/modules/job/sdk.py,359,96,143,3,22,12,24,25,36,102.862383112184,1.6363636363636365,273.56534645218375,15.198074802899097,167.17882283189007,25,62.070234396631655
ray_2.0.0,dashboard/modules/job/cli.py,359,148,286,9,29,18,35,38,53,169.41077387168042,5.431034482758621,1510.5887902920804,83.92159946067113,278.14015821251,19,50.64449094706027
ray_2.0.0,dashboard/modules/job/tests/test_backwards_compatibility.py,60,33,36,1,2,1,2,3,3,2.0,0.5,2.3774437510817346,0.1320802083934297,4.754887502163469,4,89.70792914813973
ray_2.0.0,dashboard/modules/job/tests/test_common.py,111,77,84,2,31,20,40,33,60,155.58008562199316,1.2903225806451613,390.5337382729125,21.696318792939582,302.6636471615072,28,37.71036092136693
ray_2.0.0,dashboard/modules/job/tests/test_cli.py,236,128,182,4,24,24,48,28,72,118.03910001730776,4.0,1384.51821755259,76.91767875292166,346.1295543881475,42,43.60581254197182
ray_2.0.0,dashboard/modules/job/tests/test_job_manager.py,821,388,567,9,121,69,136,130,205,865.7117767232069,5.0578512396694215,7281.208808450825,404.5116004694903,1439.585401670833,91,30.662166612298577
ray_2.0.0,dashboard/modules/job/tests/test_http_job_server.py,643,325,500,7,93,58,116,100,174,627.7932538874502,4.365591397849462,5046.758888929523,280.37549382941796,1156.030977020802,54,29.318463655834258
ray_2.0.0,dashboard/modules/job/tests/test_sdk.py,146,69,118,7,24,17,32,31,49,129.690584471711,4.666666666666667,1132.8595563084657,62.93664201713698,242.75561920895692,10,57.67548144620018
ray_2.0.0,dashboard/modules/job/tests/test_cli_integration.py,186,124,127,5,38,25,49,43,74,211.03088598529305,3.223684210526316,1294.449736878277,71.91387427101539,401.54359184795527,37,49.69253764200075
ray_2.0.0,dashboard/modules/job/tests/test_utils.py,142,98,98,6,62,42,82,68,124,384.66994624831324,3.967741935483871,2995.0317178951673,166.39065099417596,754.8453923150422,48,46.27349793608035
ray_2.0.0,dashboard/modules/job/tests/backwards_compatibility_scripts/script.py,25,16,16,1,2,1,2,3,3,2.0,0.5,2.3774437510817346,0.1320802083934297,4.754887502163469,5,68.31951047252039
ray_2.0.0,dashboard/modules/job/tests/subprocess_driver_scripts/consume_one_cpu.py,13,8,8,0,0,0,0,0,0,0,0,0,0.0,0,1,100.0
ray_2.0.0,dashboard/modules/job/tests/subprocess_driver_scripts/ray_tune_basic.py,14,6,5,0,0,0,0,0,0,0,0,0,0.0,0,1,100.0
ray_2.0.0,dashboard/modules/job/tests/subprocess_driver_scripts/ray_tune_dependency.py,5,3,2,0,0,0,0,0,0,0,0,0,0.0,0,1,100.0
ray_2.0.0,dashboard/modules/job/tests/subprocess_driver_scripts/check_cuda_devices.py,15,8,8,2,4,2,4,6,6,10.0,1.0,15.509775004326936,0.861654166907052,15.509775004326936,3,91.11537229683036
ray_2.0.0,dashboard/modules/job/tests/subprocess_driver_scripts/per_task_runtime_env.py,25,14,16,1,4,2,4,5,6,8.0,0.5,6.965784284662087,0.3869880158145604,13.931568569324174,3,86.14008123239469
ray_2.0.0,dashboard/modules/job/tests/subprocess_driver_scripts/script_with_exception.py,6,4,4,1,2,1,2,3,3,2.0,0.5,2.3774437510817346,0.1320802083934297,4.754887502163469,2,81.85633424453339
ray_2.0.0,dashboard/modules/job/tests/subprocess_driver_scripts/__init__.py,0,0,0,0,0,0,0,0,0,0,0,0,0.0,0,1,100.0
ray_2.0.0,dashboard/modules/job/tests/subprocess_driver_scripts/print_namespace.py,22,11,10,1,2,1,2,3,3,2.0,0.5,2.3774437510817346,0.1320802083934297,4.754887502163469,2,100.0
ray_2.0.0,dashboard/modules/job/tests/subprocess_driver_scripts/print_runtime_env.py,22,11,10,1,2,1,2,3,3,2.0,0.5,2.3774437510817346,0.1320802083934297,4.754887502163469,2,100.0
ray_2.0.0,dashboard/modules/job/tests/subprocess_driver_scripts/override_env_var.py,26,13,15,1,2,1,2,3,3,2.0,0.5,2.3774437510817346,0.1320802083934297,4.754887502163469,2,96.3395026576888
ray_2.0.0,dashboard/modules/healthz/utils.py,23,14,18,1,2,1,2,3,3,2.0,0.5,2.3774437510817346,0.1320802083934297,4.754887502163469,5,69.58454471843692
ray_2.0.0,dashboard/modules/healthz/healthz_head.py,40,25,27,1,2,1,2,3,3,2.0,0.5,2.3774437510817346,0.1320802083934297,4.754887502163469,7,84.74773882960385
ray_2.0.0,dashboard/modules/healthz/__init__.py,0,0,0,0,0,0,0,0,0,0,0,0,0.0,0,1,100.0
ray_2.0.0,dashboard/modules/healthz/healthz_agent.py,53,26,35,2,4,2,4,6,6,10.0,1.0,15.509775004326936,0.861654166907052,15.509775004326936,8,85.09511182988508
ray_2.0.0,dashboard/modules/healthz/tests/test_healthz.py,58,41,38,3,11,9,18,14,27,42.808635307173745,2.4545454545454546,252.32379437999938,14.017988576666632,102.7985828955553,6,69.88944491630826
ray_2.0.0,dashboard/modules/event/event_consts.py,23,15,19,3,8,5,9,11,14,28.75488750216347,1.6875,81.72907199030617,4.540503999461453,48.43204266092217,1,86.20753461935159
ray_2.0.0,dashboard/modules/event/event_utils.py,195,111,145,12,35,23,44,47,67,222.5444556017277,7.542857142857143,2807.1305030992585,155.95169461662547,372.1574530624017,19,56.6592328476669
ray_2.0.0,dashboard/modules/event/__init__.py,0,0,0,0,0,0,0,0,0,0,0,0,0.0,0,1,100.0
ray_2.0.0,dashboard/modules/event/event_agent.py,97,65,74,2,4,2,4,6,6,10.0,1.0,15.509775004326936,0.861654166907052,15.509775004326936,13,72.03181050837436
ray_2.0.0,dashboard/modules/event/event_head.py,95,65,81,2,6,3,6,8,9,17.509775004326936,1.0,27.0,1.5,27.0,15,57.76622167785273
ray_2.0.0,dashboard/modules/event/tests/test_event.py,261,167,221,11,64,46,91,75,137,422.0537478050103,7.8203125,6673.449287176043,370.7471826208913,853.3481605979356,23,35.942287968476194
ray_2.0.0,dashboard/modules/state/__init__.py,0,0,0,0,0,0,0,0,0,0,0,0,0.0,0,1,100.0
ray_2.0.0,dashboard/modules/state/state_head.py,443,206,306,9,17,13,23,26,36,98.0161933142366,6.088235294117647,1030.225787634924,57.234765979718,169.21582985307933,46,51.84717026383855
ray_2.0.0,dashboard/modules/serve/__init__.py,0,0,0,0,0,0,0,0,0,0,0,0,0.0,0,1,100.0
ray_2.0.0,dashboard/modules/serve/sdk.py,71,38,60,3,10,5,10,13,15,37.974168451037094,1.5,83.25989365817458,4.625549647676365,55.506595772116384,12,51.710698572506566
ray_2.0.0,dashboard/modules/serve/serve_agent.py,173,89,125,2,8,4,8,10,12,26.0,1.0,39.863137138648355,2.2146187299249087,39.863137138648355,17,65.11679585655007
ray_2.0.0,dashboard/modules/serve/tests/test_serve_agent.py,253,134,200,7,59,35,69,66,104,366.72742436675185,4.093220338983051,2573.0678424035073,142.94821346686152,628.6169884132792,25,45.881371955691435
ray_2.0.0,dashboard/modules/serve/tests/test_serve_agent_fault_tolerane.py,68,31,55,1,7,5,10,8,15,19.651484454403228,0.7142857142857143,32.142857142857146,1.7857142857142858,45.0,6,68.68887926281192
ray_2.0.0,dashboard/modules/node/node_head.py,392,236,336,12,50,30,58,62,88,325.2123594973901,6.96,3646.8261561857535,202.60145312143075,523.969275314045,56,36.14298390264017
ray_2.0.0,dashboard/modules/node/node_consts.py,12,7,7,0,0,0,0,0,0,0,0,0,0.0,0,1,100.0
ray_2.0.0,dashboard/modules/node/__init__.py,0,0,0,0,0,0,0,0,0,0,0,0,0.0,0,1,100.0
ray_2.0.0,dashboard/modules/node/tests/test_node.py,352,275,299,10,119,74,148,129,222,853.7025947825189,6.218487394957983,9679.028685049849,537.7238158361027,1556.4924507039623,59,28.293429619278005
ray_2.0.0,dashboard/modules/tune/tune_head.py,248,154,187,9,30,18,32,39,50,175.7360428812364,4.8,1268.4965325269397,70.47202958482998,264.27011094311246,40,50.035724032124456
ray_2.0.0,dashboard/modules/tune/__init__.py,0,0,0,0,0,0,0,0,0,0,0,0,0.0,0,1,100.0
ray_2.0.0,dashboard/modules/tune/tune_consts.py,1,1,1,0,0,0,0,0,0,0,0,0,0.0,0,1,100.0
ray_2.0.0,dashboard/modules/log/__init__.py,0,0,0,0,0,0,0,0,0,0,0,0,0.0,0,1,100.0
ray_2.0.0,dashboard/modules/log/log_agent.py,154,92,95,12,27,24,40,39,64,171.40151256706756,8.88888888888889,3006.8065956194127,167.04481086774516,338.2657420071839,25,63.165329114404464
ray_2.0.0,dashboard/modules/log/log_consts.py,9,5,6,0,0,0,0,0,0,0,0,0,0.0,0,1,100.0
ray_2.0.0,dashboard/modules/log/log_head.py,102,71,83,3,6,4,7,9,11,20.264662506490406,1.75,61.021056277764515,3.3900586820980285,34.86917501586544,15,56.04258469839008
ray_2.0.0,dashboard/modules/log/log_manager.py,216,95,148,8,34,25,47,42,72,196.97373660251156,5.529411764705882,2146.7767245509795,119.26537358616552,388.24685444007076,40,58.71139764162641
ray_2.0.0,dashboard/modules/log/log_utils.py,8,6,6,0,0,0,0,0,0,0,0,0,0.0,0,3,100.0
ray_2.0.0,dashboard/modules/log/tests/test_log.py,164,116,135,5,36,20,40,41,60,197.72694052636004,2.7777777777777777,892.9253341030139,49.606963005722996,321.453120277085,29,46.8005855776155
ray_2.0.0,ci/repro-ci.py,685,356,520,12,60,43,77,72,120,397.432985745165,7.7,5701.010701332697,316.7228167407054,740.3910001730775,90,25.4439837573681
ray_2.0.0,ci/remote-watch.py,295,177,212,11,77,43,84,88,127,520.5963114385177,6.0,4922.086893401622,273.44927185564563,820.3478155669369,46,47.27707213593987
ray_2.0.0,ci/build/get_build_info.py,87,45,57,2,10,5,10,12,15,35.219280948873624,1.0,53.77443751081735,2.987468750600964,53.77443751081735,9,75.04692261795068
ray_2.0.0,ci/build/build-multinode-image.py,35,21,22,1,2,1,2,3,3,2.0,0.5,2.3774437510817346,0.1320802083934297,4.754887502163469,2,88.74878907595489
ray_2.0.0,ci/build/build-docker-images.py,744,365,570,17,158,105,208,175,313,1223.4842265132381,11.189873417721518,26097.348163988743,1449.8526757771524,2332.229078003519,124,23.031963231832282
ray_2.0.0,ci/run/bazel-sharding.py,114,60,72,4,7,4,8,11,12,27.651484454403228,2.2857142857142856,94.88726725405158,5.27151484744731,41.51317942364757,13,73.29005025611016
ray_2.0.0,ci/run/bazel.py,265,179,174,13,74,46,90,87,136,507.60526539237657,7.905405405405405,6927.034926077363,384.8352736709646,876.2403154354271,51,50.0042785581174
ray_2.0.0,ci/lint/clang-tidy-diff.py,306,169,232,10,57,41,77,67,118,365.69401175626393,6.754385964912281,4834.7795074122205,268.59886152290113,715.7985244740171,43,47.794511140100134
ray_2.0.0,ci/lint/check-bazel-team-owner.py,45,20,22,1,4,2,4,5,6,8.0,0.5,6.965784284662087,0.3869880158145604,13.931568569324174,8,91.4860570178434
ray_2.0.0,ci/lint/check_import_order.py,85,49,53,9,21,18,29,30,47,120.76799089133479,6.214285714285714,1433.162546103088,79.62014145017156,230.62385799360038,18,71.82454134178077
ray_2.0.0,ci/lint/check_api_annotations.py,115,83,93,8,29,20,38,37,58,164.8814488586996,5.241379310344827,1583.6738231512008,87.9818790639556,302.14829520647913,30,50.249707354668026
ray_2.0.0,ci/env/cleanup_test_state.py,51,27,29,3,6,3,6,9,9,20.264662506490406,1.5,42.793987519471216,2.377443751081734,28.529325012980813,8,82.39537715624812
ray_2.0.0,ci/env/setup_credentials.py,52,27,34,3,6,3,6,9,9,20.264662506490406,1.5,42.793987519471216,2.377443751081734,28.529325012980813,6,78.64442796542774
ray_2.0.0,ci/env/check_minimal_install.py,50,13,33,3,5,4,7,8,11,16.36452797660028,2.1,69.3,3.8499999999999996,33.0,5,89.31413127206633
ray_2.0.0,ci/pipeline/py_dep_analysis.py,384,207,225,11,62,38,69,73,107,407.2139190489966,6.120967741935484,4053.985660486475,225.22142558258193,662.3112278001619,69,47.65906858577402
ray_2.0.0,ci/pipeline/check-test-run.py,37,22,29,3,6,3,6,9,9,20.264662506490406,1.5,42.793987519471216,2.377443751081734,28.529325012980813,9,79.66134126130527
ray_2.0.0,ci/pipeline/determine_tests_to_run.py,289,200,232,5,23,11,23,28,34,115.65156546374811,2.5,408.6251683748963,22.701398243049795,163.45006734995852,45,47.53155992645023
ray_2.0.0,ci/pipeline/py_dep_analysis_test.py,153,80,119,1,2,1,2,3,3,2.0,0.5,2.3774437510817346,0.1320802083934297,4.754887502163469,10,69.62575178990667
