Project,Files,LOC,LLOC,SLOC,h1,h2,N1,N2,N,Length,Calculated_length,Difficulty,Effort,Time,Halstead_Volume,Cyclomatic_Complexity,Maintainabilty_Index
lightning_1.8.0,./setup.py,105,38,36,3,5,3,5,8,8,16.36452797660028,1.5,36.0,2.0,24.0,8,73.62675317360309
lightning_1.8.0,src/lightning/__init__.py,59,33,44,0,0,0,0,0,0,0,0,0,0.0,0,2,100.0
lightning_1.8.0,src/lightning/__main__.py,4,3,3,1,2,1,2,3,3,2.0,0.5,2.3774437510817346,0.1320802083934297,4.754887502163469,2,84.58174335197131
lightning_1.8.0,src/lightning/__setup__.py,109,34,93,1,4,2,4,5,6,8.0,0.5,6.965784284662087,0.3869880158145604,13.931568569324174,6,79.39470145915536
lightning_1.8.0,src/lightning/__about__.py,42,10,24,0,0,0,0,0,0,0,0,0,0.0,0,1,100.0
lightning_1.8.0,src/lightning/__version__.py,1,1,1,0,0,0,0,0,0,0,0,0,0.0,0,1,100.0
lightning_1.8.0,src/lightning_app/__init__.py,43,29,28,1,2,2,2,3,4,2.0,0.5,3.1699250014423126,0.17610694452457293,6.339850002884625,4,90.51602927988559
lightning_1.8.0,src/lightning_app/__main__.py,4,3,3,1,2,1,2,3,3,2.0,0.5,2.3774437510817346,0.1320802083934297,4.754887502163469,2,84.58174335197131
lightning_1.8.0,src/lightning_app/__setup__.py,129,45,109,1,14,10,20,15,30,53.30296890880645,0.7142857142857143,83.71908419161112,4.651060232867284,117.20671786825557,6,69.9878064963515
lightning_1.8.0,src/lightning_app/__about__.py,39,8,21,0,0,0,0,0,0,0,0,0,0.0,0,1,100.0
lightning_1.8.0,src/lightning_app/__version__.py,1,1,1,0,0,0,0,0,0,0,0,0,0.0,0,1,100.0
lightning_1.8.0,src/lightning_app/components/__init__.py,21,9,20,0,0,0,0,0,0,0,0,0,0.0,0,1,100.0
lightning_1.8.0,src/lightning_app/components/training.py,193,99,142,4,8,5,8,12,13,32.0,2.0,93.20902501875007,5.178279167708337,46.604512509375034,30,62.040255094008174
lightning_1.8.0,src/lightning_app/components/python/tracer.py,174,84,84,4,7,4,7,11,11,27.651484454403228,2.0,76.10749561002055,4.228194200556697,38.053747805010275,29,72.29676873378013
lightning_1.8.0,src/lightning_app/components/python/__init__.py,4,3,3,0,0,0,0,0,0,0,0,0,0.0,0,1,100.0
lightning_1.8.0,src/lightning_app/components/python/popen.py,99,50,54,3,7,4,7,10,11,24.406371956566698,1.5,54.81181356564148,3.0451007536467487,36.541209043760986,15,78.09065328770764
lightning_1.8.0,src/lightning_app/components/serve/streamlit.py,150,85,93,4,8,4,8,12,12,32.0,2.0,86.03910001730776,4.779950000961542,43.01955000865388,19,68.2759669802282
lightning_1.8.0,src/lightning_app/components/serve/serve.py,154,89,114,5,13,8,16,18,24,59.715356810271004,3.076923076923077,307.9329231834323,17.107384621301794,100.07820003461549,24,59.07215807974779
lightning_1.8.0,src/lightning_app/components/serve/gradio.py,65,40,37,1,2,1,2,3,3,2.0,0.5,2.3774437510817346,0.1320802083934297,4.754887502163469,10,85.40865684618221
lightning_1.8.0,src/lightning_app/components/serve/__init__.py,4,3,3,0,0,0,0,0,0,0,0,0,0.0,0,1,100.0
lightning_1.8.0,src/lightning_app/components/serve/types/image.py,31,25,25,1,2,1,2,3,3,2.0,0.5,2.3774437510817346,0.1320802083934297,4.754887502163469,5,64.09152739498799
lightning_1.8.0,src/lightning_app/components/serve/types/__init__.py,4,5,3,0,0,0,0,0,0,0,0,0,0.0,0,1,100.0
lightning_1.8.0,src/lightning_app/components/serve/types/type.py,16,9,6,0,0,0,0,0,0,0,0,0,0.0,0,3,100.0
lightning_1.8.0,src/lightning_app/components/database/server.py,177,61,61,2,6,3,6,8,9,17.509775004326936,1.0,27.0,1.5,27.0,14,72.72465068533712
lightning_1.8.0,src/lightning_app/components/database/__init__.py,4,3,3,0,0,0,0,0,0,0,0,0,0.0,0,1,100.0
lightning_1.8.0,src/lightning_app/components/database/client.py,78,45,59,4,20,10,20,24,30,94.43856189774725,2.0,275.0977500432694,15.28320833573719,137.5488750216347,17,61.69808749726578
lightning_1.8.0,src/lightning_app/components/database/utilities.py,248,169,173,6,22,17,34,28,51,113.61727061434748,4.636363636363637,1136.7209229338025,63.15116238521125,245.1751010249378,26,50.110580271583025
lightning_1.8.0,src/lightning_app/api/__init__.py,8,2,7,0,0,0,0,0,0,0,0,0,0.0,0,1,100.0
lightning_1.8.0,src/lightning_app/api/http_methods.py,134,80,86,6,14,9,14,20,23,68.81274391313339,3.0,298.21303854722805,16.56739103040156,99.40434618240934,12,63.97559190953119
lightning_1.8.0,src/lightning_app/api/request_types.py,42,43,30,0,0,0,0,0,0,0,0,0,0.0,0,3,100.0
lightning_1.8.0,src/lightning_app/source_code/uploader.py,90,48,46,3,5,3,6,8,9,16.36452797660028,1.8,48.6,2.7,27.0,8,81.31313917564513
lightning_1.8.0,src/lightning_app/source_code/local.py,104,69,65,5,19,10,19,24,29,92.32026322986493,2.5,332.4097813022838,18.4672100723491,132.96391252091354,16,66.2456480190311
lightning_1.8.0,src/lightning_app/source_code/__init__.py,7,3,6,0,0,0,0,0,0,0,0,0,0.0,0,1,100.0
lightning_1.8.0,src/lightning_app/source_code/tar.py,181,72,73,7,17,12,23,24,35,89.13835275565901,4.735294117647059,759.8901085754036,42.21611714307798,160.4736875252405,14,66.97437909085646
lightning_1.8.0,src/lightning_app/source_code/copytree.py,165,70,90,8,23,16,29,31,45,128.0419249893113,5.043478260869565,1124.3871626182388,62.46595347879104,222.9388339674094,25,69.13783203781597
lightning_1.8.0,src/lightning_app/source_code/hashing.py,36,15,14,2,5,3,6,7,9,13.60964047443681,1.2,30.319433158222125,1.6844129532345624,25.26619429851844,5,85.97783414245187
lightning_1.8.0,src/lightning_app/storage/drive.py,324,189,240,11,46,31,52,57,83,292.1375977836329,6.217391304347826,3010.0248512226663,167.22360284570368,484.1298711756736,72,42.88343898610877
lightning_1.8.0,src/lightning_app/storage/__init__.py,5,5,5,0,0,0,0,0,0,0,0,0,0.0,0,1,100.0
lightning_1.8.0,src/lightning_app/storage/path.py,434,267,272,10,79,49,94,89,143,531.2179600548648,5.949367088607595,5509.291694876602,306.0717608264779,926.0298806281949,79,41.263940025032355
lightning_1.8.0,src/lightning_app/storage/orchestrator.py,177,88,134,4,11,8,13,15,21,46.053747805010275,2.3636363636363638,193.92384229111377,10.773546793950764,82.0447025077789,24,65.24331963349572
lightning_1.8.0,src/lightning_app/storage/copier.py,132,78,77,5,8,5,9,13,14,35.60964047443681,2.8125,145.70481390180552,8.09471188343364,51.80615605397529,20,71.3271170073241
lightning_1.8.0,src/lightning_app/storage/mount.py,61,35,38,3,8,5,8,11,13,28.75488750216347,1.5,67.4589165634273,3.747717586857072,44.97261104228487,12,79.382339319966
lightning_1.8.0,src/lightning_app/storage/payload.py,256,152,164,6,30,18,34,36,52,162.7164928725825,3.4,914.0427402550007,50.78015223638893,268.8361000750002,40,54.577423293959846
lightning_1.8.0,src/lightning_app/storage/requests.py,42,58,34,0,0,0,0,0,0,0,0,0,0.0,0,1,100.0
lightning_1.8.0,src/lightning_app/runners/multiprocess.py,109,64,77,1,2,1,2,3,3,2.0,0.5,2.3774437510817346,0.1320802083934297,4.754887502163469,8,75.41224747284903
lightning_1.8.0,src/lightning_app/runners/runtime.py,158,101,107,6,16,10,18,22,28,79.50977500432694,3.375,421.4162879612246,23.412015997845813,124.86408532184433,25,60.644116087880235
lightning_1.8.0,src/lightning_app/runners/cloud.py,516,228,418,13,58,44,78,71,122,387.86861405323333,8.741379310344827,6558.387212583493,364.3548451435274,750.2691485795713,75,34.844109566885066
lightning_1.8.0,src/lightning_app/runners/__init__.py,7,6,6,0,0,0,0,0,0,0,0,0,0.0,0,1,100.0
lightning_1.8.0,src/lightning_app/runners/runtime_type.py,23,18,18,1,4,3,6,5,9,8.0,0.75,15.673014640489694,0.8707230355827608,20.89735285398626,6,62.567216700121726
lightning_1.8.0,src/lightning_app/runners/singleprocess.py,55,35,41,0,0,0,0,0,0,0,0,0,0.0,0,6,100.0
lightning_1.8.0,src/lightning_app/runners/backends/cloud.py,29,20,20,0,0,0,0,0,0,0,0,0,0.0,0,8,100.0
lightning_1.8.0,src/lightning_app/runners/backends/mp_process.py,83,54,68,4,8,4,8,12,12,32.0,2.0,86.03910001730776,4.779950000961542,43.01955000865388,21,55.2163042605469
lightning_1.8.0,src/lightning_app/runners/backends/__init__.py,22,18,18,1,4,3,6,5,9,8.0,0.75,15.673014640489694,0.8707230355827608,20.89735285398626,5,62.70171962409834
lightning_1.8.0,src/lightning_app/runners/backends/backend.py,127,84,91,2,3,2,3,5,5,6.754887502163469,1.0,11.60964047443681,0.6449800263576005,11.60964047443681,19,62.846042929271746
lightning_1.8.0,src/lightning_app/runners/backends/docker.py,26,18,18,0,0,0,0,0,0,0,0,0,0.0,0,7,100.0
lightning_1.8.0,src/lightning_app/core/queues.py,395,231,278,11,34,30,57,45,87,211.02748440752185,9.220588235294118,4405.516096348345,244.7508942415747,477.7912193806817,84,41.37206180985424
lightning_1.8.0,src/lightning_app/core/flow.py,781,316,353,9,74,50,89,83,139,488.02887406952317,5.412162162162162,4795.881859775239,266.43788109862436,886.1304809572226,140,34.806525676922845
lightning_1.8.0,src/lightning_app/core/constants.py,70,44,49,3,9,5,10,12,15,33.28421251514428,1.6666666666666667,89.62406251802892,4.9791145843349405,53.77443751081735,2,76.07540908939383
lightning_1.8.0,src/lightning_app/core/__init__.py,5,4,4,0,0,0,0,0,0,0,0,0,0.0,0,1,100.0
lightning_1.8.0,src/lightning_app/core/work.py,597,369,391,12,123,71,133,135,204,896.9488341653803,6.487804878048781,9366.251745326008,520.3473191847783,1443.6703817983696,130,29.248560315849897
lightning_1.8.0,src/lightning_app/core/app.py,598,412,396,15,73,50,83,88,133,510.460551732369,8.527397260273972,7325.924551863403,406.9958084368557,859.1044052787606,124,29.29940320960788
lightning_1.8.0,src/lightning_app/core/api.py,457,284,330,8,40,29,46,48,75,236.8771237954945,4.6,1926.812062748799,107.0451145971555,418.8721875540868,53,40.502006910955046
lightning_1.8.0,src/lightning_app/cli/lightning_cli_create.py,79,23,71,2,3,2,3,5,5,6.754887502163469,1.0,11.60964047443681,0.6449800263576005,11.60964047443681,2,62.570437072844925
lightning_1.8.0,src/lightning_app/cli/cmd_clusters.py,221,98,167,7,21,12,23,28,35,111.8901503327572,3.8333333333333335,644.9867853760619,35.832599187559,168.25742227201613,29,57.754600611310906
lightning_1.8.0,src/lightning_app/cli/lightning_cli_list.py,42,25,28,0,0,0,0,0,0,0,0,0,0.0,0,1,100.0
lightning_1.8.0,src/lightning_app/cli/cmd_init.py,152,60,103,5,13,7,13,18,20,59.715356810271004,2.5,208.4962500721156,11.583125004006423,83.39850002884624,12,61.18313449494702
lightning_1.8.0,src/lightning_app/cli/cmd_install.py,492,221,326,8,58,36,61,66,97,363.76289771739914,4.206896551724138,2466.5296554651013,137.02942530361673,586.30622957777,46,45.854119451603424
lightning_1.8.0,src/lightning_app/cli/lightning_cli_add.py,40,25,30,1,2,1,2,3,3,2.0,0.5,2.3774437510817346,0.1320802083934297,4.754887502163469,5,74.89119719575169
lightning_1.8.0,src/lightning_app/cli/core.py,13,9,9,0,0,0,0,0,0,0,0,0,0.0,0,3,100.0
lightning_1.8.0,src/lightning_app/cli/lightning_cli.py,483,237,368,10,56,34,62,66,96,358.4311565840995,5.535714285714286,3212.163732001921,178.4535406667734,580.2618354584115,36,37.26806882447463
lightning_1.8.0,src/lightning_app/cli/__init__.py,0,0,0,0,0,0,0,0,0,0,0,0,0.0,0,1,100.0
lightning_1.8.0,src/lightning_app/cli/cmd_pl_init.py,173,105,135,7,32,23,42,39,65,179.65148445440323,4.59375,1578.1880687883997,87.67711493268888,343.5511442260462,17,44.755106456281005
lightning_1.8.0,src/lightning_app/cli/lightning_cli_delete.py,49,14,30,0,0,0,0,0,0,0,0,0,0.0,0,1,100.0
lightning_1.8.0,src/lightning_app/cli/cmd_ssh_keys.py,58,35,44,1,3,2,4,4,6,4.754887502163469,0.6666666666666666,8.0,0.4444444444444444,12.0,13,57.01277592103735
lightning_1.8.0,src/lightning_app/cli/lightning_cli_remove.py,17,12,10,0,0,0,0,0,0,0,0,0,0.0,0,1,100.0
lightning_1.8.0,src/lightning_app/cli/cmd_react_ui_init.py,116,55,78,3,11,8,13,14,21,42.808635307173745,1.7727272727272727,141.73744005296263,7.87430222516459,79.95445336320968,9,63.395559748158036
lightning_1.8.0,src/lightning_app/cli/cmd_apps.py,106,53,83,6,21,14,28,27,42,107.74844088268091,4.0,798.8211003634628,44.37895002019238,199.7052750908657,20,52.832900400051194
lightning_1.8.0,src/lightning_app/cli/react-ui-template/example_app.py,34,23,22,2,4,2,4,6,6,10.0,1.0,15.509775004326936,0.861654166907052,15.509775004326936,7,73.51830221501353
lightning_1.8.0,src/lightning_app/cli/commands/connection.py,286,199,224,9,34,27,44,43,71,201.50306161549238,5.823529411764706,2243.6008800471204,124.64449333595114,385.264797583849,49,25.156737569406406
lightning_1.8.0,src/lightning_app/cli/commands/__init__.py,0,0,0,0,0,0,0,0,0,0,0,0,0.0,0,1,100.0
lightning_1.8.0,src/lightning_app/cli/commands/app_commands.py,120,76,87,9,34,21,38,43,59,201.50306161549238,5.029411764705882,1610.164267946749,89.45357044148606,320.1496205274238,28,51.59804005338904
lightning_1.8.0,src/lightning_app/cli/commands/logs.py,108,50,66,4,15,11,18,19,29,66.60335893412778,2.4,295.65575493567354,16.42531971864853,123.18989788986397,13,69.15394108438765
lightning_1.8.0,src/lightning_app/cli/component-template/setup.py,15,2,12,0,0,0,0,0,0,0,0,0,0.0,0,1,100.0
lightning_1.8.0,src/lightning_app/cli/component-template/app.py,16,10,10,0,0,0,0,0,0,0,0,0,0.0,0,3,100.0
lightning_1.8.0,src/lightning_app/cli/component-template/tests/__init__.py,0,0,0,0,0,0,0,0,0,0,0,0,0.0,0,1,100.0
lightning_1.8.0,src/lightning_app/cli/component-template/tests/test_placeholdername_component.py,13,6,5,1,2,1,2,3,3,2.0,0.5,2.3774437510817346,0.1320802083934297,4.754887502163469,2,100.0
lightning_1.8.0,src/lightning_app/cli/component-template/placeholdername/component.py,12,9,9,1,2,1,2,3,3,2.0,0.5,2.3774437510817346,0.1320802083934297,4.754887502163469,3,74.03933453534945
lightning_1.8.0,src/lightning_app/cli/component-template/placeholdername/__init__.py,3,2,2,0,0,0,0,0,0,0,0,0,0.0,0,1,100.0
lightning_1.8.0,src/lightning_app/cli/app-template/setup.py,15,2,12,0,0,0,0,0,0,0,0,0,0.0,0,1,100.0
lightning_1.8.0,src/lightning_app/cli/app-template/app.py,17,11,11,0,0,0,0,0,0,0,0,0,0.0,0,3,100.0
lightning_1.8.0,src/lightning_app/cli/app-template/tests/__init__.py,0,0,0,0,0,0,0,0,0,0,0,0,0.0,0,1,100.0
lightning_1.8.0,src/lightning_app/cli/app-template/tests/test_placeholdername_app.py,43,22,27,1,4,2,4,5,6,8.0,0.5,6.965784284662087,0.3869880158145604,13.931568569324174,4,88.58662860700747
lightning_1.8.0,src/lightning_app/cli/app-template/placeholdername/__init__.py,4,3,3,0,0,0,0,0,0,0,0,0,0.0,0,1,100.0
lightning_1.8.0,src/lightning_app/cli/app-template/placeholdername/components/component_b/component_a.py,6,4,4,0,0,0,0,0,0,0,0,0,0.0,0,2,100.0
lightning_1.8.0,src/lightning_app/cli/app-template/placeholdername/components/component_b/__init__.py,3,2,2,0,0,0,0,0,0,0,0,0,0.0,0,1,100.0
lightning_1.8.0,src/lightning_app/cli/app-template/placeholdername/components/component_a/component_a.py,6,4,4,0,0,0,0,0,0,0,0,0,0.0,0,2,100.0
lightning_1.8.0,src/lightning_app/cli/app-template/placeholdername/components/component_a/__init__.py,3,2,2,0,0,0,0,0,0,0,0,0,0.0,0,1,100.0
lightning_1.8.0,src/lightning_app/cli/pl-app-template/setup.py,34,21,24,1,2,1,2,3,3,2.0,0.5,2.3774437510817346,0.1320802083934297,4.754887502163469,7,87.36268614767688
lightning_1.8.0,src/lightning_app/cli/pl-app-template/app.py,105,77,81,7,25,19,35,32,54,135.74788919877133,4.9,1323.0,73.5,270.0,24,52.99246946223127
lightning_1.8.0,src/lightning_app/cli/pl-app-template/tests/__init__.py,0,0,0,0,0,0,0,0,0,0,0,0,0.0,0,1,100.0
lightning_1.8.0,src/lightning_app/cli/pl-app-template/tests/test_app.py,14,10,10,1,1,1,1,2,2,0.0,0.5,1.0,0.05555555555555555,2.0,3,75.67471120151156
lightning_1.8.0,src/lightning_app/cli/pl-app-template/tests/core/test_callbacks.py,69,52,55,4,27,16,30,31,46,136.38196255841368,2.2222222222222223,506.4289561728807,28.134942009604483,227.8930302777963,14,55.430467069381955
lightning_1.8.0,src/lightning_app/cli/pl-app-template/tests/core/__init__.py,0,0,0,0,0,0,0,0,0,0,0,0,0.0,0,1,100.0
lightning_1.8.0,src/lightning_app/cli/pl-app-template/core/__init__.py,0,0,0,0,0,0,0,0,0,0,0,0,0.0,0,1,100.0
lightning_1.8.0,src/lightning_app/cli/pl-app-template/core/callbacks.py,322,207,257,7,32,19,36,39,55,179.65148445440323,3.9375,1144.6199180223557,63.58999544568643,290.6971220374237,80,28.944962608158075
lightning_1.8.0,src/lightning_app/cli/pl-app-template/core/state.py,45,56,32,0,0,0,0,0,0,0,0,0,0.0,0,1,100.0
lightning_1.8.0,src/lightning_app/cli/pl-app-template/core/components/__init__.py,2,2,2,0,0,0,0,0,0,0,0,0,0.0,0,1,100.0
lightning_1.8.0,src/lightning_app/cli/pl-app-template/core/components/logger/weights_and_biases.py,33,26,24,1,4,2,4,5,6,8.0,0.5,6.965784284662087,0.3869880158145604,13.931568569324174,8,60.04749572008214
lightning_1.8.0,src/lightning_app/cli/pl-app-template/core/components/logger/__init__.py,0,0,0,0,0,0,0,0,0,0,0,0,0.0,0,1,100.0
lightning_1.8.0,src/lightning_app/cli/pl-app-template/core/components/logger/tensorboard.py,50,26,34,0,0,0,0,0,0,0,0,0,0.0,0,8,100.0
lightning_1.8.0,src/lightning_app/cli/pl-app-template/core/components/script_runner/script_runner.py,78,56,58,0,0,0,0,0,0,0,0,0,0.0,0,7,100.0
lightning_1.8.0,src/lightning_app/cli/pl-app-template/core/components/script_runner/__init__.py,1,1,1,0,0,0,0,0,0,0,0,0,0.0,0,1,100.0
lightning_1.8.0,src/lightning_app/structures/list.py,161,97,98,7,17,11,21,24,32,89.13835275565901,4.323529411764706,634.3430471585976,35.24128039769987,146.71880002307702,58,59.8480841735229
lightning_1.8.0,src/lightning_app/structures/__init__.py,4,3,3,0,0,0,0,0,0,0,0,0,0.0,0,1,100.0
lightning_1.8.0,src/lightning_app/structures/dict.py,140,80,84,9,16,11,20,25,31,92.52932501298082,5.625,809.7724230919675,44.98735683844264,143.95954188301644,45,64.53478204207767
lightning_1.8.0,src/lightning_app/utilities/scheduler.py,48,36,38,2,3,2,3,5,5,6.754887502163469,1.0,11.60964047443681,0.6449800263576005,11.60964047443681,9,70.76649476205954
lightning_1.8.0,src/lightning_app/utilities/login.py,187,120,139,2,7,6,9,9,15,21.651484454403228,1.2857142857142858,61.13426788495889,3.396348215831049,47.548875021634686,26,59.67682575958913
lightning_1.8.0,src/lightning_app/utilities/introspection.py,397,138,238,7,19,10,19,26,29,100.36210720983135,3.5,477.09463139132095,26.50525729951783,136.3127518260917,29,62.43721720411903
lightning_1.8.0,src/lightning_app/utilities/network.py,217,132,148,11,32,19,37,43,56,198.0537478050103,6.359375,1932.4285357682847,107.35714087601582,303.8708262633175,17,58.32954898889111
lightning_1.8.0,src/lightning_app/utilities/redis.py,20,14,16,2,7,4,7,9,11,21.651484454403228,1.0,34.86917501586544,1.937176389770302,34.86917501586544,6,63.391189831659695
lightning_1.8.0,src/lightning_app/utilities/tree.py,71,41,38,1,6,4,8,7,12,15.509775004326936,0.6666666666666666,22.458839376460833,1.2477132986922685,33.68825906469125,16,77.5209029089616
lightning_1.8.0,src/lightning_app/utilities/cloud.py,42,27,31,4,8,5,10,12,15,32.0,2.5,134.43609377704337,7.468671876502409,53.77443751081735,7,55.7172468143123
lightning_1.8.0,src/lightning_app/utilities/secrets.py,26,17,15,2,4,2,4,6,6,10.0,1.0,15.509775004326936,0.861654166907052,15.509775004326936,5,87.53057614181056
lightning_1.8.0,src/lightning_app/utilities/layout.py,119,62,88,5,13,7,13,18,20,59.715356810271004,2.5,208.4962500721156,11.583125004006423,83.39850002884624,20,63.56195164789892
lightning_1.8.0,src/lightning_app/utilities/dependency_caching.py,13,11,10,2,3,2,3,5,5,6.754887502163469,1.0,11.60964047443681,0.6449800263576005,11.60964047443681,3,69.42371361010727
lightning_1.8.0,src/lightning_app/utilities/tracer.py,179,114,113,5,17,9,17,22,26,81.0965087756926,2.5,289.86305521142435,16.103503067301354,115.94522208456974,19,61.28273883825881
lightning_1.8.0,src/lightning_app/utilities/enum.py,80,61,57,4,7,4,8,11,12,27.651484454403228,2.2857142857142856,94.88726725405158,5.27151484744731,41.51317942364757,5,64.30780336977016
lightning_1.8.0,src/lightning_app/utilities/warnings.py,17,2,1,0,0,0,0,0,0,0,0,0,0.0,0,1,100.0
lightning_1.8.0,src/lightning_app/utilities/component.py,136,86,82,3,9,5,9,12,14,33.28421251514428,1.5,75.28421251514428,4.182456250841349,50.18947501009619,7,65.77703328259344
lightning_1.8.0,src/lightning_app/utilities/exceptions.py,99,45,33,2,3,2,3,5,5,6.754887502163469,1.0,11.60964047443681,0.6449800263576005,11.60964047443681,6,83.86660944167421
lightning_1.8.0,src/lightning_app/utilities/imports.py,115,54,55,2,5,4,5,7,9,13.60964047443681,1.0,25.26619429851844,1.403677461028802,25.26619429851844,2,77.4163024207447
lightning_1.8.0,src/lightning_app/utilities/proxies.py,611,371,374,10,47,30,53,57,83,294.2849569777226,5.638297872340425,2729.6684225862446,151.64824569923582,484.1298711756736,76,42.210475316093444
lightning_1.8.0,src/lightning_app/utilities/log_helpers.py,35,21,23,2,2,2,4,4,6,4.0,2.0,24.0,1.3333333333333333,12.0,3,83.09276874709255
lightning_1.8.0,src/lightning_app/utilities/git.py,74,41,36,7,17,11,19,24,30,89.13835275565901,3.911764705882353,538.0588346434533,29.89215748019185,137.5488750216347,9,77.35158446257567
lightning_1.8.0,src/lightning_app/utilities/openapi.py,61,40,38,2,5,4,5,7,9,13.60964047443681,1.0,25.26619429851844,1.403677461028802,25.26619429851844,10,77.6836612797359
lightning_1.8.0,src/lightning_app/utilities/__init__.py,0,0,0,0,0,0,0,0,0,0,0,0,0.0,0,1,100.0
lightning_1.8.0,src/lightning_app/utilities/app_helpers.py,483,352,329,12,63,41,77,75,118,419.58818518914865,7.333333333333333,5390.004440175769,299.44469112087603,735.0006054785139,106,25.93063924548085
lightning_1.8.0,src/lightning_app/utilities/app_logs.py,122,73,82,6,11,7,14,17,21,53.563522809337215,3.8181818181818183,327.74020236207275,18.207789020115154,85.83671966625714,16,65.74792787179786
lightning_1.8.0,src/lightning_app/utilities/types.py,15,10,10,0,0,0,0,0,0,0,0,0,0.0,0,2,100.0
lightning_1.8.0,src/lightning_app/utilities/frontend.py,74,55,47,3,9,5,9,12,14,33.28421251514428,1.5,75.28421251514428,4.182456250841349,50.18947501009619,13,70.44060726329556
lightning_1.8.0,src/lightning_app/utilities/log.py,10,7,7,1,2,1,2,3,3,2.0,0.5,2.3774437510817346,0.1320802083934297,4.754887502163469,1,76.68921391438496
lightning_1.8.0,src/lightning_app/utilities/cli_helpers.py,216,151,156,8,36,26,47,44,73,210.11730005192322,5.222222222222222,2081.256653727174,115.62536965150967,398.5385081605227,51,45.41004684404981
lightning_1.8.0,src/lightning_app/utilities/cluster_logs.py,134,78,88,5,13,8,16,18,24,59.715356810271004,3.076923076923077,307.9329231834323,17.107384621301794,100.07820003461549,9,65.5816966161229
lightning_1.8.0,src/lightning_app/utilities/logs_socket_api.py,187,44,83,0,0,0,0,0,0,0,0,0,0.0,0,9,100.0
lightning_1.8.0,src/lightning_app/utilities/data_structures.py,36,18,17,2,7,4,7,9,11,21.651484454403228,1.0,34.86917501586544,1.937176389770302,34.86917501586544,8,89.13475721796294
lightning_1.8.0,src/lightning_app/utilities/state.py,283,156,210,7,40,24,48,47,72,232.52860824989773,4.2,1679.7076687473177,93.31709270818432,399.9303973207899,49,47.7044990785617
lightning_1.8.0,src/lightning_app/utilities/load_app.py,199,96,114,10,22,13,24,32,37,131.32677655889415,5.454545454545454,1009.090909090909,56.060606060606055,185.0,21,66.45885450600235
lightning_1.8.0,src/lightning_app/utilities/name_generator.py,1343,7,1320,0,0,0,0,0,0,0,0,0,0.0,0,1,100.0
lightning_1.8.0,src/lightning_app/utilities/packaging/build_config.py,176,103,97,7,32,18,34,39,52,179.65148445440323,3.71875,1022.0646540724873,56.78136967069374,274.8409153808369,42,61.8759212011683
lightning_1.8.0,src/lightning_app/utilities/packaging/tarfile.py,39,31,29,3,7,5,7,10,12,24.406371956566698,1.5,59.79470570797253,3.321928094887363,39.863137138648355,11,54.780734974344455
lightning_1.8.0,src/lightning_app/utilities/packaging/app_config.py,68,41,33,1,2,1,2,3,3,2.0,0.5,2.3774437510817346,0.1320802083934297,4.754887502163469,8,87.52894540214996
lightning_1.8.0,src/lightning_app/utilities/packaging/lightning_utils.py,207,121,134,8,27,19,32,35,51,152.38196255841368,4.7407407407407405,1240.1466494302497,68.89703607945832,261.5934338641933,23,54.67627752448144
lightning_1.8.0,src/lightning_app/utilities/packaging/__init__.py,0,0,0,0,0,0,0,0,0,0,0,0,0.0,0,1,100.0
lightning_1.8.0,src/lightning_app/utilities/packaging/cloud_compute.py,133,88,86,6,30,15,30,36,45,162.7164928725825,3.0,697.9398751947122,38.77443751081734,232.64662506490404,29,60.39637693485741
lightning_1.8.0,src/lightning_app/utilities/packaging/docker.py,113,65,76,3,6,4,7,9,11,20.264662506490406,1.75,61.021056277764515,3.3900586820980285,34.86917501586544,18,69.33336540831945
lightning_1.8.0,src/lightning_app/utilities/commands/__init__.py,3,2,2,0,0,0,0,0,0,0,0,0,0.0,0,1,100.0
lightning_1.8.0,src/lightning_app/utilities/commands/base.py,284,206,224,11,43,28,47,54,75,271.3831322572005,6.011627906976744,2594.71817321382,144.15100962299002,431.6165626622602,58,33.74570462397471
lightning_1.8.0,src/lightning_app/testing/helpers.py,156,82,100,6,16,12,19,22,31,79.50977500432694,3.5625,492.4884793832565,27.360471076847585,138.24238017775622,24,64.87552993173712
lightning_1.8.0,src/lightning_app/testing/testing.py,518,319,406,12,65,43,78,77,121,434.4734578555034,7.2,5459.624434253399,303.31246856963327,758.2811714240831,66,29.012785635635982
lightning_1.8.0,src/lightning_app/testing/__init__.py,20,3,19,0,0,0,0,0,0,0,0,0,0.0,0,1,100.0
lightning_1.8.0,src/lightning_app/testing/config.py,14,12,12,0,0,0,0,0,0,0,0,0,0.0,0,1,100.0
lightning_1.8.0,src/lightning_app/frontend/utils.py,57,34,29,0,0,0,0,0,0,0,0,0,0.0,0,4,100.0
lightning_1.8.0,src/lightning_app/frontend/__init__.py,7,6,6,0,0,0,0,0,0,0,0,0,0.0,0,1,100.0
lightning_1.8.0,src/lightning_app/frontend/web.py,126,51,85,3,8,5,8,11,13,28.75488750216347,1.5,67.4589165634273,3.747717586857072,44.97261104228487,8,73.4818324772662
lightning_1.8.0,src/lightning_app/frontend/streamlit_base.py,35,20,18,1,2,1,2,3,3,2.0,0.5,2.3774437510817346,0.1320802083934297,4.754887502163469,2,93.82240591540905
lightning_1.8.0,src/lightning_app/frontend/frontend.py,51,15,11,0,0,0,0,0,0,0,0,0,0.0,0,5,100.0
lightning_1.8.0,src/lightning_app/frontend/stream_lit.py,95,32,51,1,2,1,2,3,3,2.0,0.5,2.3774437510817346,0.1320802083934297,4.754887502163469,6,90.64766345739213
lightning_1.8.0,src/lightning_app/frontend/just_py/just_py_base.py,52,33,32,2,3,2,3,5,5,6.754887502163469,1.0,11.60964047443681,0.6449800263576005,11.60964047443681,3,78.57129663551679
lightning_1.8.0,src/lightning_app/frontend/just_py/__init__.py,0,0,0,0,0,0,0,0,0,0,0,0,0.0,0,1,100.0
lightning_1.8.0,src/lightning_app/frontend/just_py/just_py.py,99,33,33,0,0,0,0,0,0,0,0,0,0.0,0,6,100.0
lightning_1.8.0,src/lightning_app/frontend/panel/panel_serve_render_fn.py,56,27,25,1,2,1,2,3,3,2.0,0.5,2.3774437510817346,0.1320802083934297,4.754887502163469,4,92.17494175824712
lightning_1.8.0,src/lightning_app/frontend/panel/__init__.py,6,4,3,0,0,0,0,0,0,0,0,0,0.0,0,1,100.0
lightning_1.8.0,src/lightning_app/frontend/panel/app_state_comm.py,86,45,42,2,3,2,3,5,5,6.754887502163469,1.0,11.60964047443681,0.6449800263576005,11.60964047443681,4,85.10881099660351
lightning_1.8.0,src/lightning_app/frontend/panel/panel_frontend.py,171,70,84,5,9,5,9,14,14,40.13896548741762,2.5,133.25742227201613,7.403190126223119,53.30296890880645,14,74.85415907466786
lightning_1.8.0,src/lightning_app/frontend/panel/app_state_watcher.py,106,43,44,1,4,4,4,5,8,8.0,0.5,9.287712379549449,0.5159840210860804,18.575424759098897,11,82.6812584025688
lightning_1.8.0,src/lightning_lite/lite.py,498,216,247,9,38,23,41,47,64,227.95057052383706,4.855263157894737,1726.015398963409,95.88974438685607,355.4936865073688,73,50.41635744232421
lightning_1.8.0,src/lightning_lite/__init__.py,29,16,15,1,1,1,1,2,2,0.0,0.5,1.0,0.05555555555555555,2.0,2,100.0
lightning_1.8.0,src/lightning_lite/connector.py,535,275,396,12,118,81,158,130,239,855.1714298333511,8.033898305084746,13483.660340114262,749.092241117459,1678.3459073138006,135,29.201087371234742
lightning_1.8.0,src/lightning_lite/__setup__.py,118,46,100,2,12,9,17,14,26,45.01955000865388,1.4166666666666667,140.2375729624551,7.79097627569195,98.9912279734977,6,68.81724850857525
lightning_1.8.0,src/lightning_lite/wrappers.py,169,86,94,6,14,7,14,20,21,68.81274391313339,3.0,272.28146997790384,15.12674833210577,90.76048999263462,27,69.48508782678667
lightning_1.8.0,src/lightning_lite/__about__.py,23,10,19,0,0,0,0,0,0,0,0,0,0.0,0,1,100.0
lightning_1.8.0,src/lightning_lite/__version__.py,1,1,1,0,0,0,0,0,0,0,0,0,0.0,0,1,100.0
lightning_1.8.0,src/lightning_lite/accelerators/accelerator.py,56,30,23,0,0,0,0,0,0,0,0,0,0.0,0,8,100.0
lightning_1.8.0,src/lightning_lite/accelerators/__init__.py,22,9,9,0,0,0,0,0,0,0,0,0,0.0,0,1,100.0
lightning_1.8.0,src/lightning_lite/accelerators/cuda.py,181,108,97,12,30,25,42,42,67,190.22626787690945,8.4,3034.7962455398865,168.59979141888257,361.28526732617695,24,63.29673622539983
lightning_1.8.0,src/lightning_lite/accelerators/cpu.py,87,39,36,6,11,6,11,17,17,53.563522809337215,3.0,208.46060490376735,11.581144716875963,69.48686830125578,13,78.92938072821553
lightning_1.8.0,src/lightning_lite/accelerators/registry.py,119,49,50,6,16,10,18,22,28,79.50977500432694,3.375,421.4162879612246,23.412015997845813,124.86408532184433,16,74.18421560179785
lightning_1.8.0,src/lightning_lite/accelerators/mps.py,82,41,40,4,9,4,9,13,13,36.52932501298081,2.0,96.21143267166839,5.345079592870466,48.105716335834195,14,80.37962554040423
lightning_1.8.0,src/lightning_lite/accelerators/tpu.py,179,95,92,7,24,15,25,31,40,129.690584471711,3.6458333333333335,722.4869619314194,40.13816455174552,198.16785241547504,24,66.27318090082953
lightning_1.8.0,src/lightning_lite/strategies/strategy.py,316,162,151,4,11,6,11,15,17,46.053747805010275,2.0,132.83428025068963,7.379682236149424,66.41714012534482,49,61.64643597734015
lightning_1.8.0,src/lightning_lite/strategies/ddp_spawn.py,216,113,163,8,25,14,26,33,40,140.0964047443681,4.16,839.3871814612467,46.63262119229148,201.77576477433814,34,56.03111125963842
lightning_1.8.0,src/lightning_lite/strategies/fairscale.py,198,81,138,6,17,13,23,23,36,84.99664330558272,4.0588235294117645,660.97222934386,36.72067940799222,162.84823041805248,20,66.07985095440974
lightning_1.8.0,src/lightning_lite/strategies/single_device.py,78,36,39,0,0,0,0,0,0,0,0,0,0.0,0,9,100.0
lightning_1.8.0,src/lightning_lite/strategies/__init__.py,29,15,15,0,0,0,0,0,0,0,0,0,0.0,0,1,100.0
lightning_1.8.0,src/lightning_lite/strategies/parallel.py,97,59,64,2,16,8,16,18,24,66.0,1.0,100.07820003461549,5.559900001923083,100.07820003461549,20,68.18094571827822
lightning_1.8.0,src/lightning_lite/strategies/single_tpu.py,58,25,35,1,2,1,2,3,3,2.0,0.5,2.3774437510817346,0.1320802083934297,4.754887502163469,7,91.68658906147247
lightning_1.8.0,src/lightning_lite/strategies/registry.py,118,48,49,6,19,12,22,25,34,96.22039775975506,3.473684210526316,548.4638573607622,30.47021429782012,157.89111045234063,18,73.00274597404633
lightning_1.8.0,src/lightning_lite/strategies/ddp.py,202,117,147,8,28,16,29,36,45,158.6059378176129,4.142857142857143,963.8217324117454,53.54565180065252,232.64662506490404,35,56.290588738528015
lightning_1.8.0,src/lightning_lite/strategies/deepspeed.py,626,205,408,11,61,38,71,72,109,399.8287253963464,6.401639344262295,4305.242175801497,239.18012087786096,672.521825157212,59,48.70272655073621
lightning_1.8.0,src/lightning_lite/strategies/dp.py,84,40,52,1,2,1,2,3,3,2.0,0.5,2.3774437510817346,0.1320802083934297,4.754887502163469,12,85.37896376412651
lightning_1.8.0,src/lightning_lite/strategies/xla.py,211,118,136,9,36,20,36,45,56,214.64662506490404,4.5,1383.946980275078,76.88594334861544,307.54377339446177,37,58.591980073395284
lightning_1.8.0,src/lightning_lite/strategies/launchers/subprocess_script.py,184,78,86,8,24,14,27,32,41,134.03910001730776,4.5,922.5,51.25,205.0,17,68.89363664100446
lightning_1.8.0,src/lightning_lite/strategies/launchers/__init__.py,0,0,0,0,0,0,0,0,0,0,0,0,0.0,0,1,100.0
lightning_1.8.0,src/lightning_lite/strategies/launchers/base.py,36,11,8,0,0,0,0,0,0,0,0,0,0.0,0,3,100.0
lightning_1.8.0,src/lightning_lite/strategies/launchers/multiprocessing.py,194,78,99,6,14,8,15,20,23,68.81274391313339,3.2142857142857144,319.51396987203003,17.75077610400167,99.40434618240934,18,71.51342195876654
lightning_1.8.0,src/lightning_lite/strategies/launchers/xla.py,103,36,47,2,5,3,5,7,8,13.60964047443681,1.0,22.458839376460833,1.2477132986922685,22.458839376460833,9,83.76097915527116
lightning_1.8.0,src/lightning_lite/utilities/apply_func.py,113,41,43,4,9,4,9,13,13,36.52932501298081,2.0,96.21143267166839,5.345079592870466,48.105716335834195,5,76.1916046075972
lightning_1.8.0,src/lightning_lite/utilities/device_parser.py,201,73,79,12,46,28,52,58,80,297.1033999872765,6.782608695652174,3178.5914269213954,176.58841260674419,468.63847961020576,32,61.423512749134
lightning_1.8.0,src/lightning_lite/utilities/optimizer.py,34,14,12,0,0,0,0,0,0,0,0,0,0.0,0,3,100.0
lightning_1.8.0,src/lightning_lite/utilities/warnings.py,24,6,4,0,0,0,0,0,0,0,0,0,0.0,0,1,100.0
lightning_1.8.0,src/lightning_lite/utilities/exceptions.py,17,2,1,0,0,0,0,0,0,0,0,0,0.0,0,1,100.0
lightning_1.8.0,src/lightning_lite/utilities/distributed.py,304,146,173,11,40,23,45,51,68,250.93087160050476,6.1875,2386.672962634507,132.59294236858372,385.7249232540617,44,56.601165947050404
lightning_1.8.0,src/lightning_lite/utilities/imports.py,36,16,15,3,8,4,8,11,12,28.75488750216347,1.5,62.26976913547136,3.4594316186372978,41.51317942364757,2,86.76281924729487
lightning_1.8.0,src/lightning_lite/utilities/__init__.py,23,4,8,0,0,0,0,0,0,0,0,0,0.0,0,1,100.0
lightning_1.8.0,src/lightning_lite/utilities/seed.py,127,72,73,8,19,12,21,27,33,104.71062275542812,4.421052631578948,693.7130608419545,38.539614491219695,156.91128757139447,9,71.28414510912305
lightning_1.8.0,src/lightning_lite/utilities/registry.py,27,10,10,1,1,1,2,2,3,0.0,1.0,3.0,0.16666666666666666,3.0,2,95.12038710491197
lightning_1.8.0,src/lightning_lite/utilities/cloud_io.py,69,27,30,1,1,1,1,2,2,0.0,0.5,1.0,0.05555555555555555,2.0,3,92.83043420033039
lightning_1.8.0,src/lightning_lite/utilities/types.py,124,70,72,0,0,0,0,0,0,0,0,0,0.0,0,14,100.0
lightning_1.8.0,src/lightning_lite/utilities/data.py,408,210,278,12,102,64,122,114,186,723.6069348897463,7.176470588235294,9120.702364789786,506.7056869327659,1270.9175426346421,61,44.27647183008994
lightning_1.8.0,src/lightning_lite/utilities/enums.py,88,50,46,2,4,2,4,6,6,10.0,1.0,15.509775004326936,0.861654166907052,15.509775004326936,8,80.13225308212766
lightning_1.8.0,src/lightning_lite/utilities/rank_zero.py,60,21,27,2,5,3,6,7,9,13.60964047443681,1.2,30.319433158222125,1.6844129532345624,25.26619429851844,5,89.49502593216127
lightning_1.8.0,src/lightning_lite/utilities/device_dtype_mixin.py,111,66,59,5,12,7,13,17,20,54.62919048309069,2.7083333333333335,221.4042372343934,12.300235401910745,81.7492568250068,17,73.84118377931983
lightning_1.8.0,src/lightning_lite/plugins/__init__.py,36,11,22,0,0,0,0,0,0,0,0,0,0.0,0,1,100.0
lightning_1.8.0,src/lightning_lite/plugins/environments/slurm.py,192,106,106,11,33,18,33,44,51,204.51875374383923,5.5,1531.3705690277618,85.07614272376455,278.43101255050215,31,63.682862149419115
lightning_1.8.0,src/lightning_lite/plugins/environments/__init__.py,20,7,7,0,0,0,0,0,0,0,0,0,0.0,0,1,100.0
lightning_1.8.0,src/lightning_lite/plugins/environments/lightning.py,101,53,47,3,8,5,8,11,13,28.75488750216347,1.5,67.4589165634273,3.747717586857072,44.97261104228487,15,77.85168228914675
lightning_1.8.0,src/lightning_lite/plugins/environments/cluster_environment.py,66,40,30,0,0,0,0,0,0,0,0,0,0.0,0,12,100.0
lightning_1.8.0,src/lightning_lite/plugins/environments/xla.py,80,42,41,1,1,1,1,2,2,0.0,0.5,1.0,0.05555555555555555,2.0,13,89.15970719781795
lightning_1.8.0,src/lightning_lite/plugins/environments/torchelastic.py,78,45,45,2,6,3,6,8,9,17.509775004326936,1.0,27.0,1.5,27.0,15,78.65415390303897
lightning_1.8.0,src/lightning_lite/plugins/environments/lsf.py,184,101,95,6,17,10,19,23,29,84.99664330558272,3.3529411764705883,439.8498772566025,24.436104292033473,131.18329672565338,27,67.01614751796387
lightning_1.8.0,src/lightning_lite/plugins/environments/kubeflow.py,67,34,32,1,2,1,2,3,3,2.0,0.5,2.3774437510817346,0.1320802083934297,4.754887502163469,12,89.4726645696479
lightning_1.8.0,src/lightning_lite/plugins/io/__init__.py,18,4,4,0,0,0,0,0,0,0,0,0,0.0,0,1,100.0
lightning_1.8.0,src/lightning_lite/plugins/io/torch_io.py,97,37,39,2,3,2,3,5,5,6.754887502163469,1.0,11.60964047443681,0.6449800263576005,11.60964047443681,8,81.31001410233893
lightning_1.8.0,src/lightning_lite/plugins/io/checkpoint_io.py,66,16,11,0,0,0,0,0,0,0,0,0,0.0,0,5,100.0
lightning_1.8.0,src/lightning_lite/plugins/io/xla.py,61,26,27,3,5,3,5,8,8,16.36452797660028,1.5,36.0,2.0,24.0,8,85.94338307367326
lightning_1.8.0,src/lightning_lite/plugins/precision/utils.py,20,4,4,0,0,0,0,0,0,0,0,0,0.0,0,2,100.0
lightning_1.8.0,src/lightning_lite/plugins/precision/double.py,45,22,19,0,0,0,0,0,0,0,0,0,0.0,0,4,100.0
lightning_1.8.0,src/lightning_lite/plugins/precision/__init__.py,28,7,14,0,0,0,0,0,0,0,0,0,0.0,0,1,100.0
lightning_1.8.0,src/lightning_lite/plugins/precision/native_amp.py,104,62,66,5,22,14,27,27,41,109.71713608445735,3.0681818181818183,598.1432346471546,33.2301797026197,194.95038758870223,23,69.51675748787228
lightning_1.8.0,src/lightning_lite/plugins/precision/precision.py,115,44,35,0,0,0,0,0,0,0,0,0,0.0,0,13,100.0
lightning_1.8.0,src/lightning_lite/plugins/precision/tpu_bf16.py,36,16,14,0,0,0,0,0,0,0,0,0,0.0,0,4,100.0
lightning_1.8.0,src/lightning_lite/plugins/precision/deepspeed.py,86,37,44,5,9,5,9,14,14,40.13896548741762,2.5,133.25742227201613,7.403190126223119,53.30296890880645,12,81.31920830434412
lightning_1.8.0,src/lightning_lite/plugins/precision/tpu.py,31,8,11,0,0,0,0,0,0,0,0,0,0.0,0,2,100.0
lightning_1.8.0,src/lightning_lite/plugins/collectives/collective.py,137,96,97,3,7,4,7,10,11,24.406371956566698,1.5,54.81181356564148,3.0451007536467487,36.541209043760986,29,61.388643180152705
lightning_1.8.0,src/lightning_lite/plugins/collectives/single_device.py,81,51,59,0,0,0,0,0,0,0,0,0,0.0,0,20,100.0
lightning_1.8.0,src/lightning_lite/plugins/collectives/__init__.py,9,4,8,0,0,0,0,0,0,0,0,0,0.0,0,1,100.0
lightning_1.8.0,src/lightning_lite/plugins/collectives/torch_collective.py,191,135,145,8,32,19,35,40,54,184.0,4.375,1257.3055124171394,69.85030624539664,287.3841171239176,49,49.65649744058379
lightning_1.8.0,src/pytorch_lightning/__init__.py,76,33,54,2,6,4,6,8,10,17.509775004326936,1.0,30.0,1.6666666666666667,30.0,4,80.22545419819323
lightning_1.8.0,src/pytorch_lightning/__setup__.py,128,47,114,1,14,9,18,15,27,53.30296890880645,0.6428571428571429,67.81245819520501,3.7673587886225004,105.48604608143,8,67.11301111376301
lightning_1.8.0,src/pytorch_lightning/__about__.py,57,10,36,0,0,0,0,0,0,0,0,0,0.0,0,1,100.0
lightning_1.8.0,src/pytorch_lightning/__version__.py,1,1,1,0,0,0,0,0,0,0,0,0,0.0,0,1,100.0
lightning_1.8.0,src/pytorch_lightning/cli.py,739,381,480,11,95,58,103,106,161,662.1900305964504,5.963157894736842,6459.263967780193,358.8479982100107,1083.195193184675,115,33.58495707313232
lightning_1.8.0,src/pytorch_lightning/accelerators/hpu.py,126,62,57,5,9,5,9,14,14,40.13896548741762,2.5,133.25742227201613,7.403190126223119,53.30296890880645,19,74.98692117369481
lightning_1.8.0,src/pytorch_lightning/accelerators/gpu.py,31,7,9,0,0,0,0,0,0,0,0,0,0.0,0,2,100.0
lightning_1.8.0,src/pytorch_lightning/accelerators/accelerator.py,58,18,17,0,0,0,0,0,0,0,0,0,0.0,0,4,100.0
lightning_1.8.0,src/pytorch_lightning/accelerators/__init__.py,25,12,12,0,0,0,0,0,0,0,0,0,0.0,0,1,100.0
lightning_1.8.0,src/pytorch_lightning/accelerators/cuda.py,161,78,86,3,6,3,6,9,9,20.264662506490406,1.5,42.793987519471216,2.377443751081734,28.529325012980813,19,75.00013762606888
lightning_1.8.0,src/pytorch_lightning/accelerators/cpu.py,93,48,51,3,5,3,5,8,8,16.36452797660028,1.5,36.0,2.0,24.0,11,80.06256103374014
lightning_1.8.0,src/pytorch_lightning/accelerators/mps.py,96,50,53,3,5,3,5,8,8,16.36452797660028,1.5,36.0,2.0,24.0,13,79.18649113781107
lightning_1.8.0,src/pytorch_lightning/accelerators/ipu.py,63,32,31,0,0,0,0,0,0,0,0,0,0.0,0,9,100.0
lightning_1.8.0,src/pytorch_lightning/accelerators/tpu.py,85,45,46,2,3,2,3,5,5,6.754887502163469,1.0,11.60964047443681,0.6449800263576005,11.60964047443681,12,83.27488762487805
lightning_1.8.0,src/pytorch_lightning/demos/boring_classes.py,250,172,166,5,14,12,23,19,35,64.91260938324326,4.107142857142857,610.6395800575153,33.924421114306405,148.67746297052548,52,50.08914863841573
lightning_1.8.0,src/pytorch_lightning/demos/__init__.py,0,0,0,0,0,0,0,0,0,0,0,0,0.0,0,1,100.0
lightning_1.8.0,src/pytorch_lightning/demos/mnist_datamodule.py,255,146,177,6,24,15,25,30,40,125.5488750216347,3.125,613.3613244510649,34.07562913617027,196.27562382434076,45,53.731293598507136
lightning_1.8.0,src/pytorch_lightning/overrides/fairscale.py,48,16,27,1,2,1,2,3,3,2.0,0.5,2.3774437510817346,0.1320802083934297,4.754887502163469,4,97.43553217654573
lightning_1.8.0,src/pytorch_lightning/overrides/distributed.py,149,83,83,5,16,9,16,21,25,75.60964047443682,2.5,274.5198389236726,15.251102162426255,109.80793556946902,27,69.12671731394421
lightning_1.8.0,src/pytorch_lightning/overrides/__init__.py,2,2,2,0,0,0,0,0,0,0,0,0,0.0,0,1,100.0
lightning_1.8.0,src/pytorch_lightning/overrides/base.py,157,77,91,5,17,12,19,22,31,81.0965087756926,2.7941176470588234,386.26547402608355,21.459193001449087,138.24238017775622,32,68.482090756443
lightning_1.8.0,src/pytorch_lightning/overrides/data_parallel.py,130,50,60,6,14,7,14,20,21,68.81274391313339,3.0,272.28146997790384,15.12674833210577,90.76048999263462,9,76.76866634263449
lightning_1.8.0,src/pytorch_lightning/overrides/torch_distributed.py,170,83,82,8,26,18,35,34,53,146.2114326716684,5.384615384615385,1451.883626233751,80.66020145743062,269.63553058626803,21,67.23970180185867
lightning_1.8.0,src/pytorch_lightning/core/optimizer.py,411,190,256,10,67,42,81,77,123,439.64725670954437,6.044776119402985,4659.402560070396,258.85569778168866,770.814744505473,82,46.658155914940046
lightning_1.8.0,src/pytorch_lightning/core/__init__.py,18,3,3,0,0,0,0,0,0,0,0,0,0.0,0,1,100.0
lightning_1.8.0,src/pytorch_lightning/core/hooks.py,746,130,81,0,0,0,0,0,0,0,0,0,0.0,0,50,100.0
lightning_1.8.0,src/pytorch_lightning/core/lightning.py,27,7,11,0,0,0,0,0,0,0,0,0,0.0,0,2,100.0
lightning_1.8.0,src/pytorch_lightning/core/saving.py,423,193,211,8,30,22,35,38,57,171.20671786825557,4.666666666666667,1395.9487185759938,77.5527065875552,299.13186826628436,52,54.92685222312727
lightning_1.8.0,src/pytorch_lightning/core/datamodule.py,282,97,112,5,12,8,15,17,23,54.62919048309069,3.125,293.7863917148682,16.32146620638157,94.01164534875782,18,64.25087925054764
lightning_1.8.0,src/pytorch_lightning/core/module.py,1958,444,578,11,99,67,127,110,194,694.3600531928917,7.055555555555555,9282.174478990031,515.6763599438906,1315.583784423784,163,9.867458207992211
lightning_1.8.0,src/pytorch_lightning/core/mixins/hparams_mixin.py,151,49,52,2,6,5,6,8,11,17.509775004326936,1.0,33.0,1.8333333333333333,33.0,17,65.63059858936599
lightning_1.8.0,src/pytorch_lightning/core/mixins/__init__.py,16,2,2,0,0,0,0,0,0,0,0,0,0.0,0,1,100.0
lightning_1.8.0,src/pytorch_lightning/core/mixins/device_dtype_mixin.py,25,6,9,0,0,0,0,0,0,0,0,0,0.0,0,2,100.0
lightning_1.8.0,src/pytorch_lightning/_graveyard/legacy_import_unpickler.py,46,31,30,2,6,3,6,8,9,17.509775004326936,1.0,27.0,1.5,27.0,8,83.5824165630105
lightning_1.8.0,src/pytorch_lightning/_graveyard/core.py,59,14,26,1,1,1,1,2,2,0.0,0.5,1.0,0.05555555555555555,2.0,2,100.0
lightning_1.8.0,src/pytorch_lightning/_graveyard/__init__.py,20,6,6,0,0,0,0,0,0,0,0,0,0.0,0,1,100.0
lightning_1.8.0,src/pytorch_lightning/_graveyard/trainer.py,246,82,144,0,0,0,0,0,0,0,0,0,0.0,0,3,100.0
lightning_1.8.0,src/pytorch_lightning/_graveyard/loggers.py,50,14,21,0,0,0,0,0,0,0,0,0,0.0,0,2,100.0
lightning_1.8.0,src/pytorch_lightning/_graveyard/callbacks.py,29,5,8,0,0,0,0,0,0,0,0,0,0.0,0,1,100.0
lightning_1.8.0,src/pytorch_lightning/_graveyard/training_type.py,98,39,63,1,2,1,2,3,3,2.0,0.5,2.3774437510817346,0.1320802083934297,4.754887502163469,2,87.1759683617706
lightning_1.8.0,src/pytorch_lightning/strategies/hivemind.py,333,153,218,12,40,26,48,52,74,255.89667380414838,7.2,3037.1942818255743,168.73301565697636,421.83253914244085,61,50.98532563965772
lightning_1.8.0,src/pytorch_lightning/strategies/utils.py,48,24,26,3,7,4,8,10,12,24.406371956566698,1.7142857142857142,68.33680652339717,3.796489251299843,39.863137138648355,7,86.94615366102842
lightning_1.8.0,src/pytorch_lightning/strategies/strategy.py,554,312,293,4,31,16,32,35,48,161.58008562199316,2.064516129032258,508.2954009049979,28.238633383610996,246.20558481335837,100,44.13766716385789
lightning_1.8.0,src/pytorch_lightning/strategies/ddp_spawn.py,366,205,275,9,70,41,79,79,120,457.5791361991285,5.078571428571428,3841.704095960503,213.42800533113905,756.4536897812524,81,39.88521356110718
lightning_1.8.0,src/pytorch_lightning/strategies/sharded_spawn.py,110,58,69,4,9,5,9,13,14,36.52932501298081,2.0,103.61231210795059,5.75623956155281,51.80615605397529,19,74.45250841656087
lightning_1.8.0,src/pytorch_lightning/strategies/single_device.py,92,43,50,1,2,1,2,3,3,2.0,0.5,2.3774437510817346,0.1320802083934297,4.754887502163469,12,86.69021389569414
lightning_1.8.0,src/pytorch_lightning/strategies/__init__.py,39,25,25,0,0,0,0,0,0,0,0,0,0.0,0,1,100.0
lightning_1.8.0,src/pytorch_lightning/strategies/tpu_spawn.py,321,191,220,10,55,31,55,65,86,351.1940651927299,5.0,2589.618159602235,143.86767553345751,517.9236319204471,64,45.62943047991868
lightning_1.8.0,src/pytorch_lightning/strategies/parallel.py,114,71,73,2,16,8,16,18,24,66.0,1.0,100.07820003461549,5.559900001923083,100.07820003461549,23,67.12004312369294
lightning_1.8.0,src/pytorch_lightning/strategies/single_tpu.py,88,45,60,2,3,2,3,5,5,6.754887502163469,1.0,11.60964047443681,0.6449800263576005,11.60964047443681,13,78.76066092626081
lightning_1.8.0,src/pytorch_lightning/strategies/single_hpu.py,118,57,78,2,3,2,3,5,5,6.754887502163469,1.0,11.60964047443681,0.6449800263576005,11.60964047443681,17,76.48637749285894
lightning_1.8.0,src/pytorch_lightning/strategies/ddp.py,491,291,352,11,106,62,119,117,181,751.2133159887094,6.1745283018867925,7678.248314368758,426.56935079826434,1243.5360142445963,115,31.457731579039663
lightning_1.8.0,src/pytorch_lightning/strategies/horovod.py,241,133,162,8,32,18,35,40,53,184.0,4.375,1234.022077002007,68.55678205566706,282.0621890290302,52,53.74997443954016
lightning_1.8.0,src/pytorch_lightning/strategies/deepspeed.py,937,386,637,12,140,81,159,152,240,1041.119172380949,6.814285714285714,11853.467739128882,658.5259855071602,1739.5026032264607,133,28.653155142932114
lightning_1.8.0,src/pytorch_lightning/strategies/fully_sharded.py,290,117,176,6,32,18,32,38,50,175.50977500432694,3.0,787.1891270165378,43.732729278696546,262.39637567217926,39,60.9977472341093
lightning_1.8.0,src/pytorch_lightning/strategies/colossalai.py,483,245,321,11,71,41,73,82,114,474.6857932898427,5.654929577464789,4098.472011315132,227.6928895175073,724.7609285264616,70,43.94752495488711
lightning_1.8.0,src/pytorch_lightning/strategies/dp.py,169,89,103,3,16,8,16,19,24,68.75488750216347,1.5,152.92539048396907,8.49585502688717,101.95026032264605,32,65.85700356737084
lightning_1.8.0,src/pytorch_lightning/strategies/fully_sharded_native.py,373,188,255,10,64,36,71,74,107,417.21928094887363,5.546875,3685.40759520962,204.74486640053445,664.4115101222977,68,47.34819603357642
lightning_1.8.0,src/pytorch_lightning/strategies/hpu_parallel.py,180,90,125,6,13,7,13,19,20,63.61549134016113,3.0,254.8756508066151,14.159758378145284,84.9585502688717,26,65.460395077739
lightning_1.8.0,src/pytorch_lightning/strategies/bagua.py,273,126,169,8,36,22,41,44,63,210.11730005192322,4.555555555555555,1566.8568745489042,87.04760414160579,343.9441919741497,41,58.30451969590625
lightning_1.8.0,src/pytorch_lightning/strategies/ipu.py,392,237,263,9,51,31,58,60,89,317.8230174535271,5.117647058823529,2690.4149342233386,149.46749634574104,525.7132630091581,81,42.69227350332077
lightning_1.8.0,src/pytorch_lightning/strategies/sharded.py,140,80,90,8,21,13,25,29,38,116.23866587835397,4.761904761904762,879.0632276897512,48.836845982763954,184.60327781484776,29,65.47448451650939
lightning_1.8.0,src/pytorch_lightning/strategies/launchers/subprocess_script.py,137,52,54,6,11,6,11,17,17,53.563522809337215,3.0,208.46060490376735,11.581144716875963,69.48686830125578,13,73.82997550168577
lightning_1.8.0,src/pytorch_lightning/strategies/launchers/__init__.py,22,4,8,0,0,0,0,0,0,0,0,0,0.0,0,1,100.0
lightning_1.8.0,src/pytorch_lightning/strategies/launchers/multiprocessing.py,291,142,157,7,28,15,30,35,45,154.25742227201613,3.75,865.566509109463,48.087028283859055,230.81773576252348,34,61.046278508674284
lightning_1.8.0,src/pytorch_lightning/strategies/launchers/xla.py,136,53,74,6,13,7,13,19,20,63.61549134016113,3.0,254.8756508066151,14.159758378145284,84.9585502688717,14,76.12716913677389
lightning_1.8.0,src/pytorch_lightning/profilers/advanced.py,91,39,44,2,4,2,4,6,6,10.0,1.0,15.509775004326936,0.861654166907052,15.509775004326936,10,84.2892478407652
lightning_1.8.0,src/pytorch_lightning/profilers/simple.py,147,87,95,8,33,26,52,41,78,190.46500593882897,6.303030303030303,2633.967385543145,146.33152141906362,417.88905636021053,19,63.41011191946908
lightning_1.8.0,src/pytorch_lightning/profilers/__init__.py,28,7,14,0,0,0,0,0,0,0,0,0,0.0,0,1,100.0
lightning_1.8.0,src/pytorch_lightning/profilers/base.py,29,8,6,0,0,0,0,0,0,0,0,0,0.0,0,3,100.0
lightning_1.8.0,src/pytorch_lightning/profilers/pytorch.py,535,342,365,11,108,72,138,119,210,767.581598038665,7.027777777777778,10175.60188234864,565.3112156860356,1447.9117302946681,134,28.059188147600175
lightning_1.8.0,src/pytorch_lightning/profilers/xla.py,76,43,45,4,11,7,12,15,19,46.053747805010275,2.1818181818181817,161.9583737815895,8.997687432310528,74.23092131656186,11,78.29692456779323
lightning_1.8.0,src/pytorch_lightning/profilers/profiler.py,149,100,94,6,30,17,34,36,51,162.7164928725825,3.4,896.4649952500968,49.803610847227596,263.6661750735579,32,61.312428130121006
lightning_1.8.0,src/pytorch_lightning/callbacks/device_stats_monitor.py,114,42,52,6,23,14,26,29,40,119.55169999363824,3.391304347826087,658.9956828173055,36.610871267628085,194.3192398051029,18,74.50088296430405
lightning_1.8.0,src/pytorch_lightning/callbacks/early_stopping.py,271,128,164,15,64,41,75,79,116,442.60335893412775,8.7890625,6426.901465914937,357.0500814397187,731.238566788544,49,55.597631146599625
lightning_1.8.0,src/pytorch_lightning/callbacks/model_checkpoint.py,722,331,396,16,176,113,219,192,332,1376.8599648801644,9.954545454545455,25067.6115228379,1392.6450846021055,2518.2075502394237,132,32.6703834900391
lightning_1.8.0,src/pytorch_lightning/callbacks/finetuning.py,418,187,221,14,36,24,44,50,68,239.4202689607297,8.555555555555555,3283.470112184495,182.41500623247194,383.78222090468125,68,52.39820544720085
lightning_1.8.0,src/pytorch_lightning/callbacks/gradient_accumulation_scheduler.py,103,34,35,6,16,11,19,22,30,79.50977500432694,3.5625,476.60175424186116,26.477875235658953,133.78294855911892,17,68.58733701716375
lightning_1.8.0,src/pytorch_lightning/callbacks/stochastic_weight_avg.py,358,191,217,15,107,86,161,122,247,779.9403264790504,11.285046728971963,19318.782595995093,1073.2656997775052,1711.892122378033,86,43.783732618090454
lightning_1.8.0,src/pytorch_lightning/callbacks/quantization.py,356,172,195,11,60,35,64,71,99,392.4671835415214,5.866666666666666,3571.773127008319,198.43184038935107,608.8249648309635,64,52.331797979370755
lightning_1.8.0,src/pytorch_lightning/callbacks/lr_monitor.py,338,165,203,11,57,38,72,68,110,370.5284786124006,6.947368421052632,4652.103181839733,258.4501767688741,669.6209125375374,63,51.1254472453962
lightning_1.8.0,src/pytorch_lightning/callbacks/batch_size_finder.py,195,54,81,8,21,11,21,29,32,116.23866587835397,4.0,621.8215673763293,34.54564263201829,155.45539184408233,22,71.31685388658941
lightning_1.8.0,src/pytorch_lightning/callbacks/timer.py,177,95,94,10,35,22,44,45,66,212.74418654194744,6.285714285714286,2278.334484534482,126.57413802969343,362.4623043577585,39,62.769240560170964
lightning_1.8.0,src/pytorch_lightning/callbacks/__init__.py,57,20,43,0,0,0,0,0,0,0,0,0,0.0,0,1,100.0
lightning_1.8.0,src/pytorch_lightning/callbacks/base.py,27,7,11,0,0,0,0,0,0,0,0,0,0.0,0,2,100.0
lightning_1.8.0,src/pytorch_lightning/callbacks/pruning.py,483,228,303,13,81,48,88,94,136,561.6335665694888,7.061728395061729,6294.994764811195,349.7219313783997,891.4240838281587,107,40.599885068690135
lightning_1.8.0,src/pytorch_lightning/callbacks/model_summary.py,83,34,36,3,5,3,5,8,8,16.36452797660028,1.5,36.0,2.0,24.0,9,83.4661607107518
lightning_1.8.0,src/pytorch_lightning/callbacks/lambda_function.py,85,11,48,2,4,2,4,6,6,10.0,1.0,15.509775004326936,0.861654166907052,15.509775004326936,5,97.50961803401836
lightning_1.8.0,src/pytorch_lightning/callbacks/callback.py,249,99,95,0,0,0,0,0,0,0,0,0,0.0,0,43,100.0
lightning_1.8.0,src/pytorch_lightning/callbacks/prediction_writer.py,154,39,60,3,8,5,8,11,13,28.75488750216347,1.5,67.4589165634273,3.747717586857072,44.97261104228487,12,77.74688610206638
lightning_1.8.0,src/pytorch_lightning/callbacks/rich_model_summary.py,109,40,46,3,5,3,5,8,8,16.36452797660028,1.5,36.0,2.0,24.0,10,82.46836994830541
lightning_1.8.0,src/pytorch_lightning/callbacks/lr_finder.py,122,30,44,1,2,1,2,3,3,2.0,0.5,2.3774437510817346,0.1320802083934297,4.754887502163469,6,85.32848911506416
lightning_1.8.0,src/pytorch_lightning/callbacks/checkpoint.py,9,3,2,0,0,0,0,0,0,0,0,0,0.0,0,1,100.0
lightning_1.8.0,src/pytorch_lightning/callbacks/fault_tolerance.py,50,22,20,2,3,2,3,5,5,6.754887502163469,1.0,11.60964047443681,0.6449800263576005,11.60964047443681,6,88.09585899828886
lightning_1.8.0,src/pytorch_lightning/callbacks/progress/rich_progress.py,599,369,433,13,139,88,169,152,257,1037.6385254444017,7.902877697841727,14720.827568302657,817.823753794592,1862.7173709550016,149,21.970820389428575
lightning_1.8.0,src/pytorch_lightning/callbacks/progress/__init__.py,23,4,3,0,0,0,0,0,0,0,0,0,0.0,0,1,100.0
lightning_1.8.0,src/pytorch_lightning/callbacks/progress/base.py,293,144,133,13,39,26,50,52,76,254.23640287146188,8.333333333333334,3610.2784881560256,200.5710271197792,433.23341857872305,46,57.08043078730105
lightning_1.8.0,src/pytorch_lightning/callbacks/progress/tqdm_progress.py,385,222,253,14,97,62,111,111,173,693.4945146009578,8.010309278350515,9415.589434748945,523.088301930497,1175.4339448785684,92,39.423910102031606
lightning_1.8.0,src/pytorch_lightning/lite/lite.py,313,111,227,5,36,27,54,41,81,197.72694052636004,3.75,1627.356421402743,90.40869007793017,433.9617123740648,35,55.69574918275488
lightning_1.8.0,src/pytorch_lightning/lite/__init__.py,17,2,2,0,0,0,0,0,0,0,0,0,0.0,0,1,100.0
lightning_1.8.0,src/pytorch_lightning/trainer/states.py,148,88,82,5,18,12,23,23,35,86.66829050039843,3.1944444444444446,505.75935758693,28.097742088162775,158.32466846199546,25,67.10385046244873
lightning_1.8.0,src/pytorch_lightning/trainer/configuration_validator.py,298,136,214,9,51,34,62,60,96,317.8230174535271,5.470588235294118,3102.159955152521,172.3422197306956,567.0614971784178,62,48.247089881490304
lightning_1.8.0,src/pytorch_lightning/trainer/progress.py,289,161,132,3,12,11,20,15,31,47.77443751081735,2.5,302.7840211596602,16.82133450887001,121.11360846386408,36,61.669467420736375
lightning_1.8.0,src/pytorch_lightning/trainer/supporters.py,619,333,311,11,47,29,53,58,82,299.11942383385923,6.202127659574468,2979.219568649667,165.51219825831484,480.3544416004609,99,42.05009582254669
lightning_1.8.0,src/pytorch_lightning/trainer/call.py,66,36,35,4,7,4,7,11,11,27.651484454403228,2.0,76.10749561002055,4.228194200556697,38.053747805010275,10,82.40498740036958
lightning_1.8.0,src/pytorch_lightning/trainer/__init__.py,19,4,3,0,0,0,0,0,0,0,0,0,0.0,0,1,100.0
lightning_1.8.0,src/pytorch_lightning/trainer/trainer.py,2239,1005,1285,15,276,179,341,291,520,2296.5561090049023,9.266304347826088,39438.643907730904,2191.035772651717,4256.135178312308,345,0.0
lightning_1.8.0,src/pytorch_lightning/trainer/setup.py,203,105,157,11,41,35,61,52,96,257.7133799943517,8.182926829268293,4478.042986387521,248.78016591041782,547.242212941545,40,50.655468432471196
lightning_1.8.0,src/pytorch_lightning/trainer/connectors/callback_connector.py,292,157,193,9,25,16,28,34,44,144.62572975734892,5.04,1128.1957596756754,62.67754220420419,223.84836501501496,60,53.442413257152054
lightning_1.8.0,src/pytorch_lightning/trainer/connectors/__init__.py,0,0,0,0,0,0,0,0,0,0,0,0,0.0,0,1,100.0
lightning_1.8.0,src/pytorch_lightning/trainer/connectors/signal_connector.py,168,117,118,8,29,17,29,37,46,164.8814488586996,4.0,958.5394192757268,53.2521899597626,239.6348548189317,42,52.781323665117476
lightning_1.8.0,src/pytorch_lightning/trainer/connectors/data_connector.py,602,272,409,17,140,94,179,157,273,1067.586490673551,10.867857142857142,21642.59266540529,1202.3662591891828,1991.431464447414,120,32.15029092293828
lightning_1.8.0,src/pytorch_lightning/trainer/connectors/checkpoint_connector.py,609,320,379,12,112,83,146,124,229,805.4433012791055,7.821428571428571,12455.710684364722,691.9839269091513,1592.5109550785946,137,31.701277376887568
lightning_1.8.0,src/pytorch_lightning/trainer/connectors/accelerator_connector.py,849,426,671,14,195,139,273,209,412,1536.7323800899806,9.8,31119.233231689774,1728.846290649432,3175.4319624173236,218,10.09457986861593
lightning_1.8.0,src/pytorch_lightning/trainer/connectors/logger_connector/fx_validator.py,212,49,184,3,14,8,16,17,24,58.05785641096992,1.7142857142857142,168.1698997542997,9.342772208572207,98.09910819000817,13,63.25300304792887
lightning_1.8.0,src/pytorch_lightning/trainer/connectors/logger_connector/logger_connector.py,251,169,165,10,45,28,49,55,77,280.35267028370896,5.444444444444445,2423.674466569838,134.6485814761021,445.1646979413988,58,50.35109885662096
lightning_1.8.0,src/pytorch_lightning/trainer/connectors/logger_connector/result.py,716,482,501,13,137,87,160,150,247,1020.5361117014264,7.591240875912408,13554.29887017943,753.0166038988572,1785.5182165524825,163,18.81365362206033
lightning_1.8.0,src/pytorch_lightning/trainer/connectors/logger_connector/__init__.py,1,1,1,0,0,0,0,0,0,0,0,0,0.0,0,1,100.0
lightning_1.8.0,src/pytorch_lightning/loops/fit_loop.py,353,221,221,11,58,34,61,69,95,377.81664552240943,5.7844827586206895,3356.7921680803834,186.4884537822435,580.3098233939262,65,45.29703126944444
lightning_1.8.0,src/pytorch_lightning/loops/__init__.py,19,6,6,0,0,0,0,0,0,0,0,0,0.0,0,1,100.0
lightning_1.8.0,src/pytorch_lightning/loops/base.py,25,6,10,0,0,0,0,0,0,0,0,0,0.0,0,2,100.0
lightning_1.8.0,src/pytorch_lightning/loops/utilities.py,235,98,119,13,48,34,57,61,91,316.1839163704497,7.71875,4165.786973012531,231.4326096118073,539.6970977182227,31,62.44473182841019
lightning_1.8.0,src/pytorch_lightning/loops/loop.py,343,152,139,8,32,20,39,40,59,184.0,4.875,1530.7195682919778,85.03997601622099,313.9937575983544,58,54.29215722547233
lightning_1.8.0,src/pytorch_lightning/loops/batch/__init__.py,16,2,2,0,0,0,0,0,0,0,0,0,0.0,0,1,100.0
lightning_1.8.0,src/pytorch_lightning/loops/batch/training_batch_loop.py,140,82,75,3,13,8,16,16,24,52.860603837997665,1.8461538461538463,177.23076923076923,9.846153846153847,96.0,20,70.83621259168677
lightning_1.8.0,src/pytorch_lightning/loops/dataloader/prediction_loop.py,146,106,94,6,15,9,17,21,26,74.11313393845472,3.4,388.28086017364245,21.571158898535693,114.20025299224778,27,58.74909251176344
lightning_1.8.0,src/pytorch_lightning/loops/dataloader/evaluation_loop.py,410,301,280,13,74,44,84,87,128,507.60526539237657,7.378378378378378,6084.924797809134,338.05137765606304,824.6967674686373,99,33.60331550830263
lightning_1.8.0,src/pytorch_lightning/loops/dataloader/__init__.py,17,3,3,0,0,0,0,0,0,0,0,0,0.0,0,1,100.0
lightning_1.8.0,src/pytorch_lightning/loops/dataloader/dataloader_loop.py,67,40,33,4,7,4,7,11,11,27.651484454403228,2.0,76.10749561002055,4.228194200556697,38.053747805010275,12,80.55109298738003
lightning_1.8.0,src/pytorch_lightning/loops/epoch/training_epoch_loop.py,609,340,376,16,143,87,159,159,246,1087.8616011593097,8.895104895104895,16002.01979932824,889.00109996268,1798.9692069999514,124,32.452911002898844
lightning_1.8.0,src/pytorch_lightning/loops/epoch/__init__.py,17,3,3,0,0,0,0,0,0,0,0,0,0.0,0,1,100.0
lightning_1.8.0,src/pytorch_lightning/loops/epoch/evaluation_epoch_loop.py,305,162,166,10,49,28,51,59,79,308.3400633105188,5.204081632653061,2418.486616926414,134.36036760702302,464.7288008995855,53,55.0457073445198
lightning_1.8.0,src/pytorch_lightning/loops/epoch/prediction_epoch_loop.py,174,95,97,5,12,6,12,17,18,54.62919048309069,2.5,183.93582785626532,10.218657103125851,73.57433114250613,23,68.7035652243844
lightning_1.8.0,src/pytorch_lightning/loops/optimization/__init__.py,16,2,2,0,0,0,0,0,0,0,0,0,0.0,0,1,100.0
lightning_1.8.0,src/pytorch_lightning/loops/optimization/manual_loop.py,159,86,80,4,9,5,10,13,15,36.52932501298081,2.2222222222222223,123.34799060470309,6.852666144705727,55.506595772116384,23,71.72909991335219
lightning_1.8.0,src/pytorch_lightning/loops/optimization/optimizer_loop.py,439,209,225,11,42,29,53,53,82,264.53107956171823,6.940476190476191,3259.8686339386704,181.1038129965928,469.68947727418237,57,52.23796854289781
lightning_1.8.0,src/pytorch_lightning/loops/optimization/closure.py,66,28,28,1,2,1,2,3,3,2.0,0.5,2.3774437510817346,0.1320802083934297,4.754887502163469,7,89.82475541188688
lightning_1.8.0,src/pytorch_lightning/serve/servable_module.py,93,16,11,0,0,0,0,0,0,0,0,0,0.0,0,5,100.0
lightning_1.8.0,src/pytorch_lightning/serve/__init__.py,4,3,3,0,0,0,0,0,0,0,0,0,0.0,0,1,100.0
lightning_1.8.0,src/pytorch_lightning/serve/servable_module_validator.py,178,111,121,8,27,18,27,35,45,152.38196255841368,4.0,923.2709430500939,51.292830169449665,230.81773576252348,25,55.96762973723551
lightning_1.8.0,src/pytorch_lightning/loggers/neptune.py,545,201,210,6,37,25,43,43,68,208.2595495325981,3.4864864864864864,1286.4647142769406,71.47026190427448,368.9860033197427,61,48.652711336295724
lightning_1.8.0,src/pytorch_lightning/loggers/__init__.py,34,15,15,0,0,0,0,0,0,0,0,0,0.0,0,3,100.0
lightning_1.8.0,src/pytorch_lightning/loggers/base.py,70,23,41,0,0,0,0,0,0,0,0,0,0.0,0,4,100.0
lightning_1.8.0,src/pytorch_lightning/loggers/logger.py,243,111,93,2,8,4,8,10,12,26.0,1.0,39.863137138648355,2.2146187299249087,39.863137138648355,31,66.6838807580474
lightning_1.8.0,src/pytorch_lightning/loggers/mlflow.py,294,134,146,9,23,16,30,32,46,132.57125000229212,5.869565217391305,1350.0,75.0,230.0,35,61.51460988492414
lightning_1.8.0,src/pytorch_lightning/loggers/tensorboard.py,326,173,174,9,35,20,37,44,57,208.05423060605463,4.757142857142857,1480.363879333636,82.24243774075757,311.1876022623259,51,56.08020845396227
lightning_1.8.0,src/pytorch_lightning/loggers/wandb.py,598,164,232,8,47,28,54,55,82,285.06567602884894,4.595744680851064,2178.711558424442,121.03953102358011,474.0714965090221,60,50.707853656739225
lightning_1.8.0,src/pytorch_lightning/loggers/csv_logs.py,252,131,125,8,27,16,30,35,46,152.38196255841368,4.444444444444445,1048.6534167976376,58.258523155424314,235.94701877946846,35,61.72564341921485
lightning_1.8.0,src/pytorch_lightning/loggers/comet.py,428,154,161,6,34,25,50,40,75,188.4835116068385,4.411764705882353,1760.9320902200834,97.82956056778241,399.1446071165522,41,52.85845658181301
lightning_1.8.0,src/pytorch_lightning/utilities/fetching.py,402,248,245,8,34,22,39,42,61,196.97373660251156,4.588235294117647,1509.2144880930202,83.84524933850112,328.9313627895044,72,46.81891817267619
lightning_1.8.0,src/pytorch_lightning/utilities/signature_utils.py,34,8,12,6,14,7,14,20,21,68.81274391313339,3.0,272.28146997790384,15.12674833210577,90.76048999263462,5,77.31799639878652
lightning_1.8.0,src/pytorch_lightning/utilities/apply_func.py,92,39,59,0,0,0,0,0,0,0,0,0,0.0,0,4,100.0
lightning_1.8.0,src/pytorch_lightning/utilities/device_parser.py,79,30,51,0,0,0,0,0,0,0,0,0,0.0,0,1,100.0
lightning_1.8.0,src/pytorch_lightning/utilities/xla_device.py,67,24,40,0,0,0,0,0,0,0,0,0,0.0,0,4,100.0
lightning_1.8.0,src/pytorch_lightning/utilities/optimizer.py,35,10,16,0,0,0,0,0,0,0,0,0,0.0,0,1,100.0
lightning_1.8.0,src/pytorch_lightning/utilities/upgrade_checkpoint.py,64,29,38,4,10,5,10,14,15,41.219280948873624,2.0,114.22064766172811,6.345591536762672,57.110323830864054,6,82.36905600227715
lightning_1.8.0,src/pytorch_lightning/utilities/warnings.py,16,2,1,0,0,0,0,0,0,0,0,0,0.0,0,1,100.0
lightning_1.8.0,src/pytorch_lightning/utilities/finite_checks.py,44,16,16,3,5,3,5,8,8,16.36452797660028,1.5,36.0,2.0,24.0,6,86.94063276302403
lightning_1.8.0,src/pytorch_lightning/utilities/exceptions.py,31,7,4,0,0,0,0,0,0,0,0,0,0.0,0,1,100.0
lightning_1.8.0,src/pytorch_lightning/utilities/memory.py,143,51,63,7,32,14,32,39,46,179.65148445440323,3.5,850.949757236822,47.27498651315678,243.12850206766345,15,72.31029962007405
lightning_1.8.0,src/pytorch_lightning/utilities/distributed.py,254,75,110,4,6,4,7,10,11,23.509775004326936,2.3333333333333335,85.26282110210897,4.736823394561609,36.541209043760986,9,73.2266967142456
lightning_1.8.0,src/pytorch_lightning/utilities/model_helpers.py,52,27,27,2,4,4,7,6,11,10.0,1.75,49.76052813888226,2.764473785493459,28.43458750793272,9,86.61550865585261
lightning_1.8.0,src/pytorch_lightning/utilities/imports.py,64,40,39,4,10,5,10,14,15,41.219280948873624,2.0,114.22064766172811,6.345591536762672,57.110323830864054,6,79.6136446540779
lightning_1.8.0,src/pytorch_lightning/utilities/__init__.py,49,14,32,0,0,0,0,0,0,0,0,0,0.0,0,1,100.0
lightning_1.8.0,src/pytorch_lightning/utilities/seed.py,68,24,31,0,0,0,0,0,0,0,0,0,0.0,0,1,100.0
lightning_1.8.0,src/pytorch_lightning/utilities/argparse.py,342,162,166,13,65,42,83,78,125,439.5596241826837,8.3,6521.1048020695835,362.2836001149769,785.675277357781,54,53.224624782055166
lightning_1.8.0,src/pytorch_lightning/utilities/cloud_io.py,45,15,23,0,0,0,0,0,0,0,0,0,0.0,0,1,100.0
lightning_1.8.0,src/pytorch_lightning/utilities/types.py,136,70,78,0,0,0,0,0,0,0,0,0,0.0,0,7,100.0
lightning_1.8.0,src/pytorch_lightning/utilities/logger.py,182,74,68,7,20,10,20,27,30,106.09004635215048,3.5,499.2631877271642,27.736843762620236,142.64662506490407,26,64.44473984583304
lightning_1.8.0,src/pytorch_lightning/utilities/meta.py,106,46,71,4,10,5,10,14,15,41.219280948873624,2.0,114.22064766172811,6.345591536762672,57.110323830864054,9,72.87707979977
lightning_1.8.0,src/pytorch_lightning/utilities/deepspeed.py,107,38,49,3,5,3,5,8,8,16.36452797660028,1.5,36.0,2.0,24.0,8,82.91717632887266
lightning_1.8.0,src/pytorch_lightning/utilities/migration.py,57,21,20,0,0,0,0,0,0,0,0,0,0.0,0,4,100.0
lightning_1.8.0,src/pytorch_lightning/utilities/grads.py,52,17,17,2,4,2,4,6,6,10.0,1.0,15.509775004326936,0.861654166907052,15.509775004326936,6,78.80339274813043
lightning_1.8.0,src/pytorch_lightning/utilities/parameter_tying.py,66,38,36,5,13,11,20,18,31,59.715356810271004,3.8461538461538463,497.18336555658334,27.621298086476852,129.26767504471167,15,77.66129004156971
lightning_1.8.0,src/pytorch_lightning/utilities/parsing.py,396,201,201,10,65,41,71,75,112,424.67318879572315,5.461538461538462,3810.1204789864037,211.6733599436891,697.6276933355387,74,49.12516265346545
lightning_1.8.0,src/pytorch_lightning/utilities/data.py,440,219,323,13,75,50,93,88,143,515.2671181230253,8.06,7445.011695008978,413.6117608338321,923.6987214651336,76,40.736335671985096
lightning_1.8.0,src/pytorch_lightning/utilities/auto_restart.py,823,491,515,15,114,74,136,129,210,837.5528205489084,8.947368421052632,13173.727000979483,731.873722276638,1472.3577236388833,143,24.870810295698647
lightning_1.8.0,src/pytorch_lightning/utilities/enums.py,82,42,40,4,12,7,14,16,21,51.01955000865388,2.3333333333333335,196.0,10.88888888888889,84.0,12,78.72540032466294
lightning_1.8.0,src/pytorch_lightning/utilities/rank_zero.py,29,5,11,0,0,0,0,0,0,0,0,0,0.0,0,1,100.0
lightning_1.8.0,src/pytorch_lightning/utilities/cli.py,165,90,109,6,13,8,14,19,22,63.61549134016113,3.230769230769231,301.9296171093748,16.77386761718749,93.45440529575887,28,63.96333360807745
lightning_1.8.0,src/pytorch_lightning/utilities/metrics.py,40,13,13,1,2,1,2,3,3,2.0,0.5,2.3774437510817346,0.1320802083934297,4.754887502163469,1,89.73698437562943
lightning_1.8.0,src/pytorch_lightning/utilities/model_summary/__init__.py,22,2,9,0,0,0,0,0,0,0,0,0,0.0,0,1,100.0
lightning_1.8.0,src/pytorch_lightning/utilities/model_summary/model_summary.py,431,208,209,14,85,60,113,99,173,598.1011984805111,9.305882352941177,10672.7182113124,592.9287895173555,1146.8786952737723,71,47.514860090328035
lightning_1.8.0,src/pytorch_lightning/utilities/model_summary/model_summary_deepspeed.py,99,48,59,3,11,8,12,14,20,42.808635307173745,1.6363636363636365,124.60434290370341,6.92246349465019,76.14709844115208,29,72.87244797849664
lightning_1.8.0,src/pytorch_lightning/tuner/auto_gpu_select.py,73,36,36,5,11,7,13,16,20,49.663388279447084,2.9545454545454546,236.36363636363637,13.131313131313131,80.0,10,80.09322823067413
lightning_1.8.0,src/pytorch_lightning/tuner/batch_size_scaling.py,342,196,225,13,55,40,75,68,115,366.08050057969047,8.863636363636363,6205.061555229039,344.7256419571688,700.0582267437891,46,48.43112133879887
lightning_1.8.0,src/pytorch_lightning/tuner/__init__.py,0,0,0,0,0,0,0,0,0,0,0,0,0.0,0,1,100.0
lightning_1.8.0,src/pytorch_lightning/tuner/tuning.py,303,95,164,7,40,24,48,47,72,232.52860824989773,4.2,1679.7076687473177,93.31709270818432,399.9303973207899,35,62.83838017145001
lightning_1.8.0,src/pytorch_lightning/tuner/lr_finder.py,468,232,261,17,75,52,101,92,153,536.6482700884468,11.446666666666667,11424.97499612089,634.7208331178273,998.104979276723,57,48.06103108516937
lightning_1.8.0,src/pytorch_lightning/profiler/advanced.py,24,6,9,0,0,0,0,0,0,0,0,0,0.0,0,2,100.0
lightning_1.8.0,src/pytorch_lightning/profiler/simple.py,24,6,9,0,0,0,0,0,0,0,0,0,0.0,0,2,100.0
lightning_1.8.0,src/pytorch_lightning/profiler/__init__.py,31,8,17,0,0,0,0,0,0,0,0,0,0.0,0,1,100.0
lightning_1.8.0,src/pytorch_lightning/profiler/base.py,74,32,29,0,0,0,0,0,0,0,0,0,0.0,0,8,100.0
lightning_1.8.0,src/pytorch_lightning/profiler/pytorch.py,44,16,25,0,0,0,0,0,0,0,0,0,0.0,0,4,100.0
lightning_1.8.0,src/pytorch_lightning/profiler/xla.py,24,6,9,0,0,0,0,0,0,0,0,0,0.0,0,2,100.0
lightning_1.8.0,src/pytorch_lightning/profiler/profiler.py,30,7,9,0,0,0,0,0,0,0,0,0,0.0,0,2,100.0
lightning_1.8.0,src/pytorch_lightning/plugins/__init__.py,45,21,42,0,0,0,0,0,0,0,0,0,0.0,0,1,100.0
lightning_1.8.0,src/pytorch_lightning/plugins/layer_sync.py,95,38,34,0,0,0,0,0,0,0,0,0,0.0,0,10,100.0
lightning_1.8.0,src/pytorch_lightning/plugins/environments/bagua_environment.py,62,33,32,2,4,3,4,6,7,10.0,1.0,18.094737505048094,1.0052631947248942,18.094737505048094,12,84.78580680057351
lightning_1.8.0,src/pytorch_lightning/plugins/environments/__init__.py,23,3,10,0,0,0,0,0,0,0,0,0,0.0,0,1,100.0
lightning_1.8.0,src/pytorch_lightning/plugins/io/checkpoint_plugin.py,16,1,1,0,0,0,0,0,0,0,0,0,0.0,0,1,100.0
lightning_1.8.0,src/pytorch_lightning/plugins/io/async_plugin.py,62,27,23,1,2,1,2,3,3,2.0,0.5,2.3774437510817346,0.1320802083934297,4.754887502163469,6,89.48339023053721
lightning_1.8.0,src/pytorch_lightning/plugins/io/__init__.py,18,4,4,0,0,0,0,0,0,0,0,0,0.0,0,1,100.0
lightning_1.8.0,src/pytorch_lightning/plugins/io/torch_plugin.py,16,1,1,0,0,0,0,0,0,0,0,0,0.0,0,1,100.0
lightning_1.8.0,src/pytorch_lightning/plugins/io/wrapper.py,66,38,33,4,14,8,14,18,22,61.30296890880645,2.0,183.47670006346175,10.193150003525652,91.73835003173087,16,78.78249641590882
lightning_1.8.0,src/pytorch_lightning/plugins/io/hpu_plugin.py,52,17,19,1,2,1,2,3,3,2.0,0.5,2.3774437510817346,0.1320802083934297,4.754887502163469,3,90.2078193261117
lightning_1.8.0,src/pytorch_lightning/plugins/io/xla_plugin.py,16,1,1,0,0,0,0,0,0,0,0,0,0.0,0,1,100.0
lightning_1.8.0,src/pytorch_lightning/plugins/precision/hpu.py,57,19,30,3,4,3,5,7,8,12.75488750216347,1.875,42.11032383086406,2.3394624350480036,22.458839376460833,6,90.68886606346696
lightning_1.8.0,src/pytorch_lightning/plugins/precision/fsdp_native_native_amp.py,64,30,37,5,14,8,15,19,23,64.91260938324326,2.6785714285714284,261.7026771675066,14.539037620417032,97.70233280920246,12,81.43771562489906
lightning_1.8.0,src/pytorch_lightning/plugins/precision/apex_amp.py,109,49,71,3,10,7,10,13,17,37.974168451037094,1.5,94.36121281259784,5.2422896006998805,62.907475208398566,16,75.93731550656493
lightning_1.8.0,src/pytorch_lightning/plugins/precision/fully_sharded_native_amp.py,31,7,8,0,0,0,0,0,0,0,0,0,0.0,0,2,100.0
lightning_1.8.0,src/pytorch_lightning/plugins/precision/double.py,98,41,53,0,0,0,0,0,0,0,0,0,0.0,0,9,100.0
lightning_1.8.0,src/pytorch_lightning/plugins/precision/__init__.py,42,14,28,0,0,0,0,0,0,0,0,0,0.0,0,1,100.0
lightning_1.8.0,src/pytorch_lightning/plugins/precision/native_amp.py,118,64,77,6,27,18,33,33,51,143.89173756274062,3.6666666666666665,943.3017003200307,52.405650017779486,257.2641000872811,24,68.2380493409877
lightning_1.8.0,src/pytorch_lightning/plugins/precision/tpu_bf16.py,35,14,14,0,0,0,0,0,0,0,0,0,0.0,0,3,100.0
lightning_1.8.0,src/pytorch_lightning/plugins/precision/precision_plugin.py,207,102,134,5,15,10,17,20,27,70.2129994085646,2.8333333333333335,330.62749925888323,18.36819440327129,116.69205856195879,27,64.18350079122493
lightning_1.8.0,src/pytorch_lightning/plugins/precision/deepspeed.py,142,55,86,7,16,9,16,23,25,83.65148445440323,3.5,395.81167115498863,21.989537286388256,113.08904890142533,18,74.02766011317475
lightning_1.8.0,src/pytorch_lightning/plugins/precision/colossalai.py,90,34,56,6,13,7,13,19,20,63.61549134016113,3.0,254.8756508066151,14.159758378145284,84.9585502688717,13,79.71717966077583
lightning_1.8.0,src/pytorch_lightning/plugins/precision/sharded_native_amp.py,39,17,19,4,7,4,7,11,11,27.651484454403228,2.0,76.10749561002055,4.228194200556697,38.053747805010275,7,90.09217107357796
lightning_1.8.0,src/pytorch_lightning/plugins/precision/ipu.py,96,37,65,4,8,4,8,12,12,32.0,2.0,86.03910001730776,4.779950000961542,43.01955000865388,11,80.18310513486925
lightning_1.8.0,src/pytorch_lightning/plugins/precision/tpu.py,53,22,31,3,5,3,5,8,8,16.36452797660028,1.5,36.0,2.0,24.0,6,89.38627202235092
lightning_1.8.0,docs/create-symlinks.py,27,22,22,3,6,3,6,9,9,20.264662506490406,1.5,42.793987519471216,2.377443751081734,28.529325012980813,9,71.81708348345585
lightning_1.8.0,docs/source-lit/conf.py,417,120,205,7,30,20,36,37,56,166.8582023226588,4.2,1225.263431595929,68.07019064421827,291.7293884752212,17,63.77984867279856
lightning_1.8.0,docs/source-lit/core_api/lightning_app/app.py,27,17,17,1,2,1,2,3,3,2.0,0.5,2.3774437510817346,0.1320802083934297,4.754887502163469,6,86.6860326728163
lightning_1.8.0,docs/source-lit/workflows/add_web_ui/dash/intermediate_state.py,39,28,27,1,1,1,1,2,2,0.0,0.5,1.0,0.05555555555555555,2.0,5,65.65141613815787
lightning_1.8.0,docs/source-lit/workflows/add_web_ui/dash/intermediate_plot.py,87,45,64,1,4,2,4,5,6,8.0,0.5,6.965784284662087,0.3869880158145604,13.931568569324174,9,62.205044530604404
lightning_1.8.0,docs/source-lit/workflows/share_files_between_components/app.py,48,34,34,1,2,1,2,3,3,2.0,0.5,2.3774437510817346,0.1320802083934297,4.754887502163469,7,71.08279934710754
lightning_1.8.0,docs/source-lit/workflows/build_command_line_interface/commands/notebook/run.py,34,18,21,1,2,1,2,3,3,2.0,0.5,2.3774437510817346,0.1320802083934297,4.754887502163469,3,88.10223780764952
lightning_1.8.0,docs/source-lit/examples/model_server_app/locustfile.py,41,19,29,1,1,1,1,2,2,0.0,0.5,1.0,0.05555555555555555,2.0,4,91.62594728779374
lightning_1.8.0,docs/source-lit/examples/model_server_app/locust_component.py,42,12,27,0,0,0,0,0,0,0,0,0,0.0,0,3,100.0
lightning_1.8.0,docs/source-lit/examples/model_server_app/train.py,42,20,19,1,1,1,1,2,2,0.0,0.5,1.0,0.05555555555555555,2.0,3,98.2811297025354
lightning_1.8.0,docs/source-lit/examples/model_server_app/model_server.py,89,30,45,3,4,3,6,7,9,12.75488750216347,2.25,56.848937171666485,3.158274287314805,25.26619429851844,5,86.5076519497713
lightning_1.8.0,docs/source-lit/examples/model_server_app/app.py,34,19,25,1,2,1,2,3,3,2.0,0.5,2.3774437510817346,0.1320802083934297,4.754887502163469,5,82.863768095197
lightning_1.8.0,docs/source-lit/examples/github_repo_runner/app.py,309,153,192,3,13,7,13,16,20,52.860603837997665,1.5,120.0,6.666666666666667,80.0,26,61.427345992266595
lightning_1.8.0,docs/source-lit/examples/file_server/app.py,243,131,143,4,18,11,20,22,31,83.05865002596161,2.2222222222222223,307.20528928390274,17.066960515772376,138.24238017775622,30,62.047836284949284
lightning_1.8.0,docs/source-lit/code_samples/quickstart/__init__.py,0,0,0,0,0,0,0,0,0,0,0,0,0.0,0,1,100.0
lightning_1.8.0,docs/source-lit/code_samples/quickstart/app_02.py,32,21,21,3,5,3,6,8,9,16.36452797660028,1.8,48.6,2.7,27.0,7,80.82276826103056
lightning_1.8.0,docs/source-lit/code_samples/quickstart/app_03.py,31,21,21,3,5,3,6,8,9,16.36452797660028,1.8,48.6,2.7,27.0,7,72.96846044059043
lightning_1.8.0,docs/source-lit/code_samples/quickstart/app_comp.py,26,18,18,0,0,0,0,0,0,0,0,0,0.0,0,5,100.0
lightning_1.8.0,docs/source-lit/code_samples/quickstart/app_01.py,27,17,17,1,2,1,2,3,3,2.0,0.5,2.3774437510817346,0.1320802083934297,4.754887502163469,6,86.6860326728163
lightning_1.8.0,docs/source-lit/code_samples/quickstart/app/app_0.py,21,16,16,1,2,2,4,3,6,2.0,1.0,9.509775004326938,0.5283208335737188,9.509775004326938,5,66.21169448485274
lightning_1.8.0,docs/source-lit/code_samples/quickstart/app/__init__.py,0,0,0,0,0,0,0,0,0,0,0,0,0.0,0,1,100.0
lightning_1.8.0,docs/source-lit/code_samples/quickstart/app/app_1.py,92,37,56,2,1,2,4,3,6,2.0,4.0,38.03910001730775,2.1132833342948754,9.509775004326938,9,86.11329390074557
lightning_1.8.0,docs/source-lit/code_samples/quickstart/hello_world/app_ui.py,58,29,34,0,0,0,0,0,0,0,0,0,0.0,0,8,100.0
lightning_1.8.0,docs/source-lit/code_samples/quickstart/hello_world/app.py,16,5,5,0,0,0,0,0,0,0,0,0,0.0,0,2,100.0
lightning_1.8.0,docs/source-lit/code_samples/basics/1.py,22,13,13,0,0,0,0,0,0,0,0,0,0.0,0,3,100.0
lightning_1.8.0,docs/source-lit/code_samples/basics/0.py,19,11,11,0,0,0,0,0,0,0,0,0,0.0,0,2,100.0
lightning_1.8.0,docs/source-lit/code_samples/convert_pl_to_app/train.py,46,32,32,2,2,3,5,4,8,4.0,2.5,40.0,2.2222222222222223,16.0,5,77.6184228472931
lightning_1.8.0,docs/source-lit/code_samples/convert_pl_to_app/app.py,17,9,12,0,0,0,0,0,0,0,0,0,0.0,0,3,100.0
lightning_1.8.0,docs/source-pytorch/conf.py,402,116,201,2,10,9,18,12,27,35.219280948873624,1.8,174.22917753504822,9.679398751947124,96.79398751947123,15,68.09106291443686
lightning_1.8.0,docs/source-app/conf.py,393,116,185,7,30,20,36,37,56,166.8582023226588,4.2,1225.263431595929,68.07019064421827,291.7293884752212,16,63.68521547220332
lightning_1.8.0,docs/source-app/core_api/lightning_app/app.py,27,17,17,1,2,1,2,3,3,2.0,0.5,2.3774437510817346,0.1320802083934297,4.754887502163469,6,86.6860326728163
lightning_1.8.0,docs/source-app/workflows/build_rest_api/post_example_pydantic.py,33,15,20,0,0,0,0,0,0,0,0,0,0.0,0,5,100.0
lightning_1.8.0,docs/source-app/workflows/build_rest_api/post_example.py,26,14,14,0,0,0,0,0,0,0,0,0,0.0,0,5,100.0
lightning_1.8.0,docs/source-app/workflows/build_rest_api/models.py,6,4,3,0,0,0,0,0,0,0,0,0,0.0,0,1,100.0
lightning_1.8.0,docs/source-app/workflows/add_web_ui/dash/intermediate_state.py,39,28,27,1,1,1,1,2,2,0.0,0.5,1.0,0.05555555555555555,2.0,5,65.65141613815787
lightning_1.8.0,docs/source-app/workflows/add_web_ui/dash/intermediate_plot.py,87,45,64,1,4,2,4,5,6,8.0,0.5,6.965784284662087,0.3869880158145604,13.931568569324174,9,62.205044530604404
lightning_1.8.0,docs/source-app/workflows/share_files_between_components/app.py,48,34,34,1,2,1,2,3,3,2.0,0.5,2.3774437510817346,0.1320802083934297,4.754887502163469,7,71.08279934710754
lightning_1.8.0,docs/source-app/workflows/build_command_line_interface/example_command.py,25,16,16,0,0,0,0,0,0,0,0,0,0.0,0,5,100.0
lightning_1.8.0,docs/source-app/workflows/build_command_line_interface/post_example.py,27,14,14,0,0,0,0,0,0,0,0,0,0.0,0,5,100.0
lightning_1.8.0,docs/source-app/workflows/build_command_line_interface/app.py,36,22,22,1,2,1,2,3,3,2.0,0.5,2.3774437510817346,0.1320802083934297,4.754887502163469,7,89.44382187468788
lightning_1.8.0,docs/source-app/workflows/build_command_line_interface/commands/__init__.py,0,0,0,0,0,0,0,0,0,0,0,0,0.0,0,1,100.0
lightning_1.8.0,docs/source-app/workflows/build_command_line_interface/commands/notebook/__init__.py,0,0,0,0,0,0,0,0,0,0,0,0,0.0,0,1,100.0
lightning_1.8.0,docs/source-app/workflows/build_command_line_interface/commands/notebook/run.py,34,18,21,1,2,1,2,3,3,2.0,0.5,2.3774437510817346,0.1320802083934297,4.754887502163469,3,88.10223780764952
lightning_1.8.0,docs/source-app/examples/model_server_app/locustfile.py,41,19,29,1,1,1,1,2,2,0.0,0.5,1.0,0.05555555555555555,2.0,4,91.62594728779374
lightning_1.8.0,docs/source-app/examples/model_server_app/locust_component.py,42,12,27,0,0,0,0,0,0,0,0,0,0.0,0,3,100.0
lightning_1.8.0,docs/source-app/examples/model_server_app/train.py,42,20,19,1,1,1,1,2,2,0.0,0.5,1.0,0.05555555555555555,2.0,3,98.2811297025354
lightning_1.8.0,docs/source-app/examples/model_server_app/model_server.py,89,30,45,3,4,3,6,7,9,12.75488750216347,2.25,56.848937171666485,3.158274287314805,25.26619429851844,5,86.5076519497713
lightning_1.8.0,docs/source-app/examples/model_server_app/app.py,34,19,25,1,2,1,2,3,3,2.0,0.5,2.3774437510817346,0.1320802083934297,4.754887502163469,5,82.863768095197
lightning_1.8.0,docs/source-app/examples/github_repo_runner/app.py,309,153,192,3,13,7,13,16,20,52.860603837997665,1.5,120.0,6.666666666666667,80.0,26,61.427345992266595
lightning_1.8.0,docs/source-app/examples/file_server/app.py,243,131,143,4,18,11,20,22,31,83.05865002596161,2.2222222222222223,307.20528928390274,17.066960515772376,138.24238017775622,30,62.047836284949284
lightning_1.8.0,docs/source-app/code_samples/quickstart/__init__.py,0,0,0,0,0,0,0,0,0,0,0,0,0.0,0,1,100.0
lightning_1.8.0,docs/source-app/code_samples/quickstart/app_02.py,32,21,21,3,5,3,6,8,9,16.36452797660028,1.8,48.6,2.7,27.0,7,80.82276826103056
lightning_1.8.0,docs/source-app/code_samples/quickstart/app_03.py,31,21,21,3,5,3,6,8,9,16.36452797660028,1.8,48.6,2.7,27.0,7,72.96846044059043
lightning_1.8.0,docs/source-app/code_samples/quickstart/app_comp.py,26,18,18,0,0,0,0,0,0,0,0,0,0.0,0,5,100.0
lightning_1.8.0,docs/source-app/code_samples/quickstart/app_01.py,27,17,17,1,2,1,2,3,3,2.0,0.5,2.3774437510817346,0.1320802083934297,4.754887502163469,6,86.6860326728163
lightning_1.8.0,docs/source-app/code_samples/quickstart/app/app_0.py,21,16,16,1,2,2,4,3,6,2.0,1.0,9.509775004326938,0.5283208335737188,9.509775004326938,5,66.21169448485274
lightning_1.8.0,docs/source-app/code_samples/quickstart/app/__init__.py,0,0,0,0,0,0,0,0,0,0,0,0,0.0,0,1,100.0
lightning_1.8.0,docs/source-app/code_samples/quickstart/app/app_1.py,92,37,56,2,1,2,4,3,6,2.0,4.0,38.03910001730775,2.1132833342948754,9.509775004326938,9,86.11329390074557
lightning_1.8.0,docs/source-app/code_samples/quickstart/hello_world/app_ui.py,58,29,34,0,0,0,0,0,0,0,0,0,0.0,0,8,100.0
lightning_1.8.0,docs/source-app/code_samples/quickstart/hello_world/app.py,16,5,5,0,0,0,0,0,0,0,0,0,0.0,0,2,100.0
lightning_1.8.0,docs/source-app/code_samples/basics/1.py,22,13,13,0,0,0,0,0,0,0,0,0,0.0,0,3,100.0
lightning_1.8.0,docs/source-app/code_samples/basics/0.py,19,11,11,0,0,0,0,0,0,0,0,0,0.0,0,2,100.0
lightning_1.8.0,docs/source-app/code_samples/convert_pl_to_app/train.py,46,32,32,2,2,3,5,4,8,4.0,2.5,40.0,2.2222222222222223,16.0,5,77.6184228472931
lightning_1.8.0,docs/source-app/code_samples/convert_pl_to_app/app.py,17,9,12,0,0,0,0,0,0,0,0,0,0.0,0,3,100.0
lightning_1.8.0,tests/tests_pytorch/test_cli.py,1471,916,1113,10,335,216,423,345,639,2843.2050715394944,6.313432835820896,34010.83631876923,1889.4909065982906,5387.059180514275,225,0.0
lightning_1.8.0,tests/tests_pytorch/__init__.py,29,11,11,2,3,2,3,5,5,6.754887502163469,1.0,11.60964047443681,0.6449800263576005,11.60964047443681,4,90.34529851436282
lightning_1.8.0,tests/tests_pytorch/conftest.py,323,197,221,9,39,27,50,48,77,234.6600115486085,5.769230769230769,2481.01218782036,137.83401043446443,430.04211255552906,34,49.079777020567526
lightning_1.8.0,tests/tests_pytorch/graveyard/test_core.py,70,27,45,0,0,0,0,0,0,0,0,0,0.0,0,1,100.0
lightning_1.8.0,tests/tests_pytorch/graveyard/test_trainer.py,128,42,94,0,0,0,0,0,0,0,0,0,0.0,0,1,100.0
lightning_1.8.0,tests/tests_pytorch/graveyard/test_loggers.py,74,35,47,0,0,0,0,0,0,0,0,0,0.0,0,1,100.0
lightning_1.8.0,tests/tests_pytorch/graveyard/test_callbacks.py,26,6,9,0,0,0,0,0,0,0,0,0,0.0,0,1,100.0
lightning_1.8.0,tests/tests_pytorch/graveyard/__init__.py,0,0,0,0,0,0,0,0,0,0,0,0,0.0,0,1,100.0
lightning_1.8.0,tests/tests_pytorch/graveyard/test_training_type.py,93,63,82,0,0,0,0,0,0,0,0,0,0.0,0,1,100.0
lightning_1.8.0,tests/tests_pytorch/graveyard/test_legacy_import_unpickler.py,73,38,61,4,11,10,15,15,25,46.053747805010275,2.727272727272727,266.37890424603535,14.798828013668631,97.67226489021297,11,57.793422022568954
lightning_1.8.0,tests/tests_pytorch/accelerators/test_common.py,62,36,36,2,9,5,10,11,15,30.529325012980813,1.1111111111111112,57.65719364395497,3.203177424664165,51.89147427955947,7,80.80340711241786
lightning_1.8.0,tests/tests_pytorch/accelerators/test_ipu.py,656,434,475,9,101,70,138,110,208,701.0086847709122,6.148514851485149,8672.620509668845,481.81225053715804,1410.5228204131292,91,24.15684841395379
lightning_1.8.0,tests/tests_pytorch/accelerators/__init__.py,0,0,0,0,0,0,0,0,0,0,0,0,0.0,0,1,100.0
lightning_1.8.0,tests/tests_pytorch/accelerators/test_registry.py,18,3,3,1,2,1,2,3,3,2.0,0.5,2.3774437510817346,0.1320802083934297,4.754887502163469,2,57.63891330416229
lightning_1.8.0,tests/tests_pytorch/accelerators/test_tpu.py,325,217,233,4,38,22,42,42,64,207.42124551085624,2.210526315789474,762.8710122331216,42.38172290184009,345.1083150578407,28,42.60369637334484
lightning_1.8.0,tests/tests_pytorch/accelerators/test_mps.py,135,80,84,3,37,34,68,40,102,197.50466203043462,2.7567567567567566,1496.4686459245436,83.13714699580798,542.8366656785109,26,60.99847324692588
lightning_1.8.0,tests/tests_pytorch/accelerators/test_hpu.py,327,193,223,7,50,31,62,57,93,301.8442939431394,4.34,2354.2710675171734,130.7928370842874,542.4587713173211,36,43.156905134322564
lightning_1.8.0,tests/tests_pytorch/accelerators/test_gpu.py,71,36,44,1,4,2,4,5,6,8.0,0.5,6.965784284662087,0.3869880158145604,13.931568569324174,6,83.6319315517169
lightning_1.8.0,tests/tests_pytorch/accelerators/test_cpu.py,79,52,57,3,7,4,7,10,11,24.406371956566698,1.5,54.81181356564148,3.0451007536467487,36.541209043760986,7,61.749205727442465
lightning_1.8.0,tests/tests_pytorch/models/test_onnx.py,172,104,116,4,16,8,16,20,24,72.0,2.0,207.45254855459342,11.525141586366301,103.72627427729671,13,59.96288232325207
lightning_1.8.0,tests/tests_pytorch/models/test_torchscript.py,205,135,132,4,12,13,18,16,31,51.01955000865388,3.0,372.0,20.666666666666668,124.0,23,53.47893899212206
lightning_1.8.0,tests/tests_pytorch/models/test_hparams.py,907,577,583,6,96,68,128,102,196,647.666175073558,4.0,5231.181468105652,290.6211926725362,1307.795367026413,110,22.272962315489856
lightning_1.8.0,tests/tests_pytorch/models/test_restore.py,835,446,553,12,88,69,126,100,195,611.4495324487361,8.590909090909092,11129.969085188524,618.331615843807,1295.5519570060715,71,32.373678764355844
lightning_1.8.0,tests/tests_pytorch/models/test_horovod.py,453,197,330,6,39,24,46,45,70,221.64046153995463,3.5384615384615383,1360.2897669370425,75.57165371872458,384.4297167430772,17,47.83070118033533
lightning_1.8.0,tests/tests_pytorch/models/__init__.py,0,0,0,0,0,0,0,0,0,0,0,0,0.0,0,1,100.0
lightning_1.8.0,tests/tests_pytorch/models/test_ddp_fork_amp.py,30,11,10,1,1,1,1,2,2,0.0,0.5,1.0,0.05555555555555555,2.0,2,89.45009179905541
lightning_1.8.0,tests/tests_pytorch/models/test_tpu.py,385,190,278,3,18,10,20,21,30,79.81353752812508,1.6666666666666667,219.61587113893805,12.200881729941003,131.76952268336282,16,48.37221721223665
lightning_1.8.0,tests/tests_pytorch/models/test_hooks.py,958,406,811,10,105,67,125,115,192,738.2150603038165,5.9523809523809526,7823.417201079286,434.63428894884925,1314.33408978132,64,26.223005178421303
lightning_1.8.0,tests/tests_pytorch/models/test_gpu.py,202,112,141,3,41,37,74,44,111,224.4145196915049,2.707317073170732,1640.6257798348818,91.14587665749343,605.99690966874,29,54.3108656391015
lightning_1.8.0,tests/tests_pytorch/models/test_cpu.py,318,135,200,4,6,4,7,10,11,23.509775004326936,2.3333333333333335,85.26282110210897,4.736823394561609,36.541209043760986,10,65.39199960454451
lightning_1.8.0,tests/tests_pytorch/models/test_grad_norm.py,107,63,64,6,19,12,22,25,34,96.22039775975506,3.473684210526316,548.4638573607622,30.47021429782012,157.89111045234063,19,70.47578780459067
lightning_1.8.0,tests/tests_pytorch/models/test_amp.py,253,130,189,4,23,14,25,27,39,112.0419249893113,2.1739130434782608,403.1317664877723,22.396209249320684,185.4406125843753,23,53.16104198474619
lightning_1.8.0,tests/tests_pytorch/models/data/horovod/test_train_script.py,29,5,12,0,0,0,0,0,0,0,0,0,0.0,0,1,100.0
lightning_1.8.0,tests/tests_pytorch/models/data/horovod/train_default_model.py,107,61,59,5,19,10,19,24,29,92.32026322986493,2.5,332.4097813022838,18.4672100723491,132.96391252091354,14,72.4260592924736
lightning_1.8.0,tests/tests_pytorch/overrides/test_base.py,42,18,22,1,4,2,4,5,6,8.0,0.5,6.965784284662087,0.3869880158145604,13.931568569324174,3,93.43639419198935
lightning_1.8.0,tests/tests_pytorch/overrides/__init__.py,0,0,0,0,0,0,0,0,0,0,0,0,0.0,0,1,100.0
lightning_1.8.0,tests/tests_pytorch/overrides/test_distributed.py,67,41,39,3,20,16,28,23,44,91.19344939991072,2.1,417.97712473966806,23.220951374426004,199.03672606650858,17,73.64845881981731
lightning_1.8.0,tests/tests_pytorch/overrides/test_data_parallel.py,205,124,143,2,17,11,21,19,32,71.48686830125578,1.2352941176470589,167.91807582553466,9.328781990307482,135.93368043019473,11,57.960960726682224
lightning_1.8.0,tests/tests_pytorch/benchmarks/__init__.py,0,0,0,0,0,0,0,0,0,0,0,0,0.0,0,1,100.0
lightning_1.8.0,tests/tests_pytorch/benchmarks/test_sharded_parity.py,222,81,132,8,25,14,28,33,42,140.0964047443681,4.48,949.1531974984866,52.73073319436037,211.86455301305503,21,66.74780313006237
lightning_1.8.0,tests/tests_pytorch/benchmarks/test_basic_parity.py,169,87,105,7,29,16,30,36,46,160.53293331310283,3.6206896551724137,861.0599226540127,47.83666236966737,237.81655006634637,15,65.19375741135819
lightning_1.8.0,tests/tests_pytorch/benchmarks/test_sync_batchnorm_parity.py,114,62,74,4,8,6,9,12,15,32.0,2.25,120.99248439933903,6.721804688852169,53.77443751081735,14,74.44101324512006
lightning_1.8.0,tests/tests_pytorch/benchmarks/generate_comparison.py,54,30,29,2,4,2,4,6,6,10.0,1.0,15.509775004326936,0.861654166907052,15.509775004326936,4,88.04840023841545
lightning_1.8.0,tests/tests_pytorch/core/test_results.py,50,26,27,2,4,2,4,6,6,10.0,1.0,15.509775004326936,0.861654166907052,15.509775004326936,2,89.75778906046533
lightning_1.8.0,tests/tests_pytorch/core/__init__.py,0,0,0,0,0,0,0,0,0,0,0,0,0.0,0,1,100.0
lightning_1.8.0,tests/tests_pytorch/core/test_lightning_module.py,442,265,314,9,49,76,148,58,224,303.650107374626,13.591836734693878,17835.04156687983,990.8356426044351,1312.1877429085762,32,35.932310301312
lightning_1.8.0,tests/tests_pytorch/core/test_datamodules.py,521,336,357,8,57,40,76,65,116,356.4747308073903,5.333333333333333,3725.8382203269366,206.99101224038537,698.5946663113007,56,38.38536986369157
lightning_1.8.0,tests/tests_pytorch/core/test_lightning_optimizer.py,348,220,232,12,69,50,99,81,149,464.5077375263476,8.608695652173912,8132.098034134878,451.7832241186043,944.6376504298091,39,44.35137113736635
lightning_1.8.0,tests/tests_pytorch/core/test_metric_result_integration.py,681,424,479,15,155,117,226,170,343,1186.4026417516347,10.935483870967742,27791.66935100915,1543.9816306116195,2541.421091095232,71,27.12792433119218
lightning_1.8.0,tests/tests_pytorch/checkpointing/test_legacy_checkpoints.py,113,69,77,4,19,11,20,23,31,88.71062275542812,2.1052631578947367,295.2219381847734,16.401218788042968,140.2304206377674,12,65.84314338312993
lightning_1.8.0,tests/tests_pytorch/checkpointing/test_trainer_checkpoint.py,121,61,90,4,9,7,12,13,19,36.52932501298081,2.6666666666666665,187.48894571914866,10.416052539952704,70.30835464468075,7,68.50396395916063
lightning_1.8.0,tests/tests_pytorch/checkpointing/test_torch_saving.py,66,35,36,0,0,0,0,0,0,0,0,0,0.0,0,1,100.0
lightning_1.8.0,tests/tests_pytorch/checkpointing/__init__.py,0,0,0,0,0,0,0,0,0,0,0,0,0.0,0,1,100.0
lightning_1.8.0,tests/tests_pytorch/checkpointing/test_checkpoint_callback_frequency.py,125,63,92,5,25,16,30,30,46,127.70604521880493,3.0,677.1509021939755,37.61949456633197,225.71696739799185,8,65.43102194842088
lightning_1.8.0,tests/tests_pytorch/checkpointing/test_model_checkpoint.py,1362,782,1016,16,402,258,485,418,743,3541.7227798539293,9.651741293532337,62442.59502569168,3469.033056982871,6469.567835136097,171,4.114827455925996
lightning_1.8.0,tests/tests_pytorch/strategies/test_deepspeed_strategy.py,1331,679,1039,11,126,72,139,137,211,917.1910181659998,6.067460317460317,9087.142907034295,504.8412726130164,1497.6847695046713,88,18.840345614079553
lightning_1.8.0,tests/tests_pytorch/strategies/test_dp.py,187,99,129,3,10,6,11,13,17,37.974168451037094,1.65,103.79733409385763,5.766518560769868,62.907475208398566,25,60.00374005715175
lightning_1.8.0,tests/tests_pytorch/strategies/test_sharded_strategy.py,323,210,230,4,20,10,20,24,30,94.43856189774725,2.0,275.0977500432694,15.28320833573719,137.5488750216347,34,37.68751308435135
lightning_1.8.0,tests/tests_pytorch/strategies/test_common.py,68,32,42,1,2,1,2,3,3,2.0,0.5,2.3774437510817346,0.1320802083934297,4.754887502163469,3,89.23523703015705
lightning_1.8.0,tests/tests_pytorch/strategies/test_ddp_fully_sharded_with_full_state_dict.py,256,139,186,4,9,9,17,13,26,36.52932501298081,3.7777777777777777,363.4654123151917,20.19252290639954,96.21143267166839,49,47.46357572051789
lightning_1.8.0,tests/tests_pytorch/strategies/test_colossalai.py,294,161,223,5,11,8,15,16,23,49.663388279447084,3.409090909090909,313.6363636363636,17.424242424242422,92.0,33,49.07967487621341
lightning_1.8.0,tests/tests_pytorch/strategies/test_bagua_strategy.py,126,59,94,2,4,2,4,6,6,10.0,1.0,15.509775004326936,0.861654166907052,15.509775004326936,6,72.59390876140776
lightning_1.8.0,tests/tests_pytorch/strategies/test_ddp_strategy.py,305,184,215,4,14,9,16,18,25,61.30296890880645,2.2857142857142856,238.28142865384638,13.23785714743591,104.2481250360578,28,51.68208600644363
lightning_1.8.0,tests/tests_pytorch/strategies/__init__.py,0,0,0,0,0,0,0,0,0,0,0,0,0.0,0,1,100.0
lightning_1.8.0,tests/tests_pytorch/strategies/test_ddp_fully_sharded_native.py,248,143,174,5,23,22,43,28,65,115.65156546374811,4.673913043478261,1460.4953268642394,81.13862927023553,312.4780699337442,56,43.67200373170658
lightning_1.8.0,tests/tests_pytorch/strategies/test_registry.py,150,52,109,2,24,12,24,26,36,112.03910001730776,1.0,169.21582985307933,9.400879436282185,169.21582985307933,18,64.3147099557309
lightning_1.8.0,tests/tests_pytorch/strategies/test_ddp.py,169,91,122,2,10,5,10,12,15,35.219280948873624,1.0,53.77443751081735,2.987468750600964,53.77443751081735,5,63.35528835663187
lightning_1.8.0,tests/tests_pytorch/strategies/test_tpu_spawn.py,98,48,63,2,6,3,6,8,9,17.509775004326936,1.0,27.0,1.5,27.0,10,76.18910378911127
lightning_1.8.0,tests/tests_pytorch/strategies/test_hivemind.py,312,184,243,4,15,8,16,19,24,66.60335893412778,2.1333333333333333,217.49388868831156,12.082993816017309,101.95026032264605,12,46.850507385956014
lightning_1.8.0,tests/tests_pytorch/strategies/test_ddp_strategy_with_comm_hook.py,246,87,191,1,2,1,2,3,3,2.0,0.5,2.3774437510817346,0.1320802083934297,4.754887502163469,11,68.84078923340431
lightning_1.8.0,tests/tests_pytorch/strategies/test_ddp_spawn.py,75,25,51,0,0,0,0,0,0,0,0,0,0.0,0,2,100.0
lightning_1.8.0,tests/tests_pytorch/strategies/test_custom_plugin.py,48,26,26,1,2,1,2,3,3,2.0,0.5,2.3774437510817346,0.1320802083934297,4.754887502163469,2,93.32624654125921
lightning_1.8.0,tests/tests_pytorch/strategies/test_single_device_strategy.py,77,39,37,2,10,5,10,12,15,35.219280948873624,1.0,53.77443751081735,2.987468750600964,53.77443751081735,13,80.66489632926668
lightning_1.8.0,tests/tests_pytorch/strategies/test_ddp_spawn_strategy.py,200,122,133,4,21,14,25,25,39,100.23866587835397,2.380952380952381,431.21521762193873,23.956400978996598,181.11039140121426,31,55.55533597389633
lightning_1.8.0,tests/tests_pytorch/strategies/scripts/__init__.py,0,0,0,0,0,0,0,0,0,0,0,0,0.0,0,1,100.0
lightning_1.8.0,tests/tests_pytorch/strategies/scripts/cli_script.py,24,5,9,1,2,1,2,3,3,2.0,0.5,2.3774437510817346,0.1320802083934297,4.754887502163469,2,97.46726092031876
lightning_1.8.0,tests/tests_pytorch/strategies/launchers/test_subprocess_script.py,161,70,108,4,22,13,25,26,38,106.10749561002054,2.272727272727273,405.94706656673077,22.55261480926282,178.61670928936152,15,64.71786084805314
lightning_1.8.0,tests/tests_pytorch/strategies/launchers/test_multiprocessing.py,78,44,47,2,9,5,9,11,14,30.529325012980813,1.0,48.43204266092217,2.6906690367178983,48.43204266092217,8,78.62103490334529
lightning_1.8.0,tests/tests_pytorch/strategies/launchers/__init__.py,0,0,0,0,0,0,0,0,0,0,0,0,0.0,0,1,100.0
lightning_1.8.0,tests/tests_pytorch/profilers/test_xla_profiler.py,59,32,32,0,0,0,0,0,0,0,0,0,0.0,0,3,100.0
lightning_1.8.0,tests/tests_pytorch/profilers/__init__.py,0,0,0,0,0,0,0,0,0,0,0,0,0.0,0,1,100.0
lightning_1.8.0,tests/tests_pytorch/profilers/test_profiler.py,626,347,448,11,95,55,109,106,164,662.1900305964504,6.310526315789474,6962.901928965733,386.8278849425407,1103.3789545483646,74,29.330558745212514
lightning_1.8.0,tests/tests_pytorch/callbacks/test_timer.py,185,123,131,12,66,44,81,78,125,441.9495618863118,7.363636363636363,5785.427042361842,321.4126134645468,785.675277357781,40,49.928726769536304
lightning_1.8.0,tests/tests_pytorch/callbacks/test_prediction_writer.py,166,93,113,1,7,10,20,8,30,19.651484454403228,1.4285714285714286,128.57142857142858,7.142857142857143,90.0,12,61.79832729259347
lightning_1.8.0,tests/tests_pytorch/callbacks/test_rich_model_summary.py,65,37,35,1,4,2,4,5,6,8.0,0.5,6.965784284662087,0.3869880158145604,13.931568569324174,5,85.67939210251006
lightning_1.8.0,tests/tests_pytorch/callbacks/test_device_stats_monitor.py,168,85,121,4,13,9,17,17,26,56.105716335834195,2.6153846153846154,277.94747320502313,15.441526289167951,106.27403387250884,5,62.53959675344554
lightning_1.8.0,tests/tests_pytorch/callbacks/test_callbacks.py,162,96,106,5,15,14,26,20,40,70.2129994085646,4.333333333333333,749.1342031138095,41.61856683965608,172.8771237954945,19,61.439850578623016
lightning_1.8.0,tests/tests_pytorch/callbacks/test_quantization.py,259,147,183,10,31,16,31,41,47,186.7993665708668,5.0,1259.0247210852497,69.94581783806943,251.80494421704995,28,52.083125684446244
lightning_1.8.0,tests/tests_pytorch/callbacks/__init__.py,0,0,0,0,0,0,0,0,0,0,0,0,0.0,0,1,100.0
lightning_1.8.0,tests/tests_pytorch/callbacks/test_finetuning_callback.py,439,270,308,7,48,38,67,55,105,287.7296844890187,4.885416666666667,2965.6568655471033,164.75871475261684,607.0427699200893,70,36.40485080277251
lightning_1.8.0,tests/tests_pytorch/callbacks/test_callback_hook_outputs.py,80,33,47,3,9,8,15,12,23,33.28421251514428,2.5,206.13534379146648,11.45196354397036,82.4541375165866,3,78.9757915119981
lightning_1.8.0,tests/tests_pytorch/callbacks/test_early_stopping.py,492,227,377,6,65,36,71,71,107,406.96368285117643,3.276923076923077,2156.290563086634,119.79392017147967,658.022941787001,42,40.69225769220484
lightning_1.8.0,tests/tests_pytorch/callbacks/test_stochastic_weight_avg.py,387,227,291,14,95,57,108,109,165,677.4392517002465,7.957894736842105,8886.982238659722,493.7212354810957,1116.7504135881927,50,36.62485637594327
lightning_1.8.0,tests/tests_pytorch/callbacks/test_lambda_function.py,65,26,39,3,6,3,6,9,9,20.264662506490406,1.5,42.793987519471216,2.377443751081734,28.529325012980813,3,86.59447091493922
lightning_1.8.0,tests/tests_pytorch/callbacks/test_gradient_accumulation_scheduler.py,108,45,80,3,22,13,26,25,39,102.862383112184,1.7727272727272727,321.05933021124343,17.83662945618019,181.11039140121426,10,68.46256564197223
lightning_1.8.0,tests/tests_pytorch/callbacks/test_pruning.py,331,163,264,10,39,27,45,49,72,239.34996748450132,5.769230769230769,2332.2640890940097,129.57022717188943,404.259108776295,36,46.35114421957954
lightning_1.8.0,tests/tests_pytorch/callbacks/test_model_summary.py,67,32,36,2,16,9,17,18,26,66.0,1.0625,115.19417816484386,6.399676564713548,108.41805003750011,6,80.5576785999829
lightning_1.8.0,tests/tests_pytorch/callbacks/test_lr_monitor.py,547,318,415,6,119,72,144,125,216,835.9930888379722,3.630252100840336,5462.11145521335,303.4506364007417,1504.609405487011,48,28.613878829905726
lightning_1.8.0,tests/tests_pytorch/callbacks/progress/test_base_progress.py,34,16,17,2,4,2,4,6,6,10.0,1.0,15.509775004326936,0.861654166907052,15.509775004326936,3,93.38667264407277
lightning_1.8.0,tests/tests_pytorch/callbacks/progress/test_rich_progress_bar.py,512,283,392,10,84,66,128,94,194,570.1739444622895,7.619047619047619,9688.306569336852,538.2392538520473,1271.5902372254618,70,29.70813731540651
lightning_1.8.0,tests/tests_pytorch/callbacks/progress/test_tqdm_progress_bar.py,756,425,579,13,150,122,239,163,361,1132.4285199102162,10.356666666666667,27475.10637815247,1526.3947987862484,2652.890863677419,105,19.193732416668094
lightning_1.8.0,tests/tests_pytorch/lite/__init__.py,0,0,0,0,0,0,0,0,0,0,0,0,0.0,0,1,100.0
lightning_1.8.0,tests/tests_pytorch/lite/test_lite.py,79,52,51,1,8,4,8,9,12,24.0,0.5,19.019550008653876,1.0566416671474377,38.03910001730775,19,72.16622991185382
lightning_1.8.0,tests/tests_pytorch/trainer/test_trainer_cli.py,199,109,133,4,20,10,20,24,30,94.43856189774725,2.0,275.0977500432694,15.28320833573719,137.5488750216347,22,59.06853174832301
lightning_1.8.0,tests/tests_pytorch/trainer/test_dataloaders.py,1375,826,1002,13,224,151,296,237,447,1796.9532188767373,8.589285714285714,30288.125352069073,1682.673630670504,3526.2682322575224,163,4.534747315259682
lightning_1.8.0,tests/tests_pytorch/trainer/test_config_validator.py,160,108,99,2,10,5,10,12,15,35.219280948873624,1.0,53.77443751081735,2.987468750600964,53.77443751081735,6,65.76287226172944
lightning_1.8.0,tests/tests_pytorch/trainer/test_trainer.py,2238,1194,1662,20,290,212,396,310,608,2458.612198002078,13.655172413793103,68711.23864858855,3817.2910360326973,5031.883638406737,244,0.0
lightning_1.8.0,tests/tests_pytorch/trainer/__init__.py,0,0,0,0,0,0,0,0,0,0,0,0,0.0,0,1,100.0
lightning_1.8.0,tests/tests_pytorch/trainer/test_progress.py,108,62,66,1,23,17,34,24,51,104.0419249893113,0.7391304347826086,172.83315165761925,9.601841758756626,233.833087536779,18,66.81148949561425
lightning_1.8.0,tests/tests_pytorch/trainer/test_states.py,93,55,59,2,20,10,20,22,30,88.43856189774725,1.0,133.78294855911892,7.432386031062162,133.78294855911892,7,70.36819460891441
lightning_1.8.0,tests/tests_pytorch/trainer/test_supporters.py,474,288,344,12,140,82,159,152,241,1041.119172380949,6.814285714285714,11902.857188041919,661.2698437801066,1746.7505307399042,90,25.552097874929107
lightning_1.8.0,tests/tests_pytorch/trainer/connectors/test_data_connector.py,607,390,456,7,76,53,105,83,158,494.49397547611574,4.8355263157894735,4870.614007646832,270.58966709149064,1007.2562301528142,71,26.7849818831425
lightning_1.8.0,tests/tests_pytorch/trainer/connectors/test_accelerator_connector.py,802,432,624,4,62,36,71,66,107,377.1601712439863,2.2903225806451615,1481.2665201537477,82.29258445298598,646.7501707713545,112,17.84361934744507
lightning_1.8.0,tests/tests_pytorch/trainer/connectors/__init__.py,0,0,0,0,0,0,0,0,0,0,0,0,0.0,0,1,100.0
lightning_1.8.0,tests/tests_pytorch/trainer/connectors/test_signal_connector.py,164,111,114,6,24,15,29,30,44,125.5488750216347,3.625,782.6490499995588,43.480502777753266,215.90318620677482,19,55.898100029999505
lightning_1.8.0,tests/tests_pytorch/trainer/connectors/test_checkpoint_connector.py,144,89,96,6,27,24,40,33,64,143.89173756274062,4.444444444444445,1434.849882839738,79.71388237998545,322.841223638941,24,58.56842813177992
lightning_1.8.0,tests/tests_pytorch/trainer/connectors/test_callback_connector.py,298,157,224,5,38,23,46,43,69,211.03088598529305,3.026315789473684,1133.089758646346,62.949431035908106,374.41226807444474,26,49.849847046917425
lightning_1.8.0,tests/tests_pytorch/trainer/dynamic_args/test_multiple_eval_dataloaders.py,165,95,115,1,16,16,32,17,48,64.0,1.0,196.19821638001633,10.899900910000907,196.19821638001633,9,59.489564100024566
lightning_1.8.0,tests/tests_pytorch/trainer/dynamic_args/__init__.py,0,0,0,0,0,0,0,0,0,0,0,0,0.0,0,1,100.0
lightning_1.8.0,tests/tests_pytorch/trainer/flags/test_min_max_epochs.py,60,29,45,3,8,5,9,11,14,28.75488750216347,1.6875,81.72907199030617,4.540503999461453,48.43204266092217,6,64.3818151658084
lightning_1.8.0,tests/tests_pytorch/trainer/flags/test_fast_dev_run.py,126,81,92,4,33,23,45,37,68,174.46500593882897,2.727272727272727,966.1168059893688,53.67315588829827,354.2428288627686,3,57.76558450632583
lightning_1.8.0,tests/tests_pytorch/trainer/flags/__init__.py,0,0,0,0,0,0,0,0,0,0,0,0,0.0,0,1,100.0
lightning_1.8.0,tests/tests_pytorch/trainer/flags/test_overfit_batches.py,150,88,104,3,19,10,20,22,30,85.46551025759159,1.5789473684210527,211.23623456702987,11.735346364834992,133.78294855911892,16,62.739942113411104
lightning_1.8.0,tests/tests_pytorch/trainer/flags/test_limit_batches.py,89,51,58,4,18,14,28,22,42,83.05865002596161,3.111111111111111,582.6990648352735,32.372170268626306,187.29612798276648,18,70.3196559962517
lightning_1.8.0,tests/tests_pytorch/trainer/flags/test_val_check_interval.py,127,67,86,8,28,17,33,36,50,158.6059378176129,4.714285714285714,1218.6251789114024,67.70139882841124,258.49625007211563,9,64.85379367553014
lightning_1.8.0,tests/tests_pytorch/trainer/flags/test_check_val_every_n_epoch.py,81,38,53,3,14,9,18,17,27,58.05785641096992,1.9285714285714286,212.84002937653557,11.824446076474198,110.36149671375918,7,75.30342558422727
lightning_1.8.0,tests/tests_pytorch/trainer/flags/test_env_vars.py,57,38,31,4,18,14,26,22,40,83.05865002596161,2.888888888888889,515.3120981536432,28.628449897424623,178.37726474549189,13,76.50285470367498
lightning_1.8.0,tests/tests_pytorch/trainer/flags/test_inference_mode.py,39,19,18,1,3,3,3,4,6,4.754887502163469,0.5,6.0,0.3333333333333333,12.0,1,93.12721610312981
lightning_1.8.0,tests/tests_pytorch/trainer/logging_/test_eval_loop_logging.py,1027,549,804,14,213,136,263,227,399,1700.7961180169102,8.64319248826291,26990.899672656935,1499.4944262587187,3122.7928464290753,92,15.969448719237832
lightning_1.8.0,tests/tests_pytorch/trainer/logging_/test_distributed_logging.py,196,109,132,3,8,7,11,11,18,28.75488750216347,2.0625,128.43139884190967,7.135077713439426,62.26976913547136,14,62.61627473962441
lightning_1.8.0,tests/tests_pytorch/trainer/logging_/test_progress_bar_logging.py,19,14,13,0,0,0,0,0,0,0,0,0,0.0,0,1,100.0
lightning_1.8.0,tests/tests_pytorch/trainer/logging_/test_loop_logging.py,109,41,84,3,9,6,12,12,18,33.28421251514428,2.0,129.05865002596164,7.169925001442313,64.52932501298082,6,73.22822590711019
lightning_1.8.0,tests/tests_pytorch/trainer/logging_/test_logger_connector.py,667,358,535,11,108,80,159,119,239,767.581598038665,8.097222222222221,13343.100315083871,741.2833508379929,1647.8614454305985,63,27.68300473238429
lightning_1.8.0,tests/tests_pytorch/trainer/logging_/__init__.py,0,0,0,0,0,0,0,0,0,0,0,0,0.0,0,1,100.0
lightning_1.8.0,tests/tests_pytorch/trainer/logging_/test_train_loop_logging.py,848,487,642,14,152,113,217,166,330,1154.9879509522316,9.993421052631579,24321.61852467943,1351.2010291488573,2433.7630123444856,62,22.560979993254932
lightning_1.8.0,tests/tests_pytorch/trainer/properties/test_loggers.py,97,47,55,2,25,20,40,27,60,118.09640474436812,1.6,456.46920020769306,25.359400011538504,285.29325012980814,22,70.4687715249395
lightning_1.8.0,tests/tests_pytorch/trainer/properties/__init__.py,0,0,0,0,0,0,0,0,0,0,0,0,0.0,0,1,100.0
lightning_1.8.0,tests/tests_pytorch/trainer/properties/test_log_dir.py,126,70,74,2,19,17,34,21,51,82.71062275542812,1.7894736842105263,400.85675847886165,22.269819915492313,224.0081885617168,18,63.19366525831472
lightning_1.8.0,tests/tests_pytorch/trainer/properties/test_estimated_stepping_batches.py,181,120,120,6,27,17,32,33,49,143.89173756274062,3.5555555555555554,878.8455532393393,48.824752957741076,247.1753118485642,17,57.07056060782387
lightning_1.8.0,tests/tests_pytorch/trainer/properties/test_get_model.py,82,29,49,1,4,2,4,5,6,8.0,0.5,6.965784284662087,0.3869880158145604,13.931568569324174,5,85.02739437069765
lightning_1.8.0,tests/tests_pytorch/trainer/properties/test_auto_gpu_select.py,61,29,38,1,7,5,10,8,15,19.651484454403228,0.7142857142857143,32.142857142857146,1.7857142857142858,45.0,7,82.95927620613257
lightning_1.8.0,tests/tests_pytorch/trainer/optimization/test_multiple_optimizers.py,198,111,123,5,29,18,34,34,52,152.49108933313642,2.9310344827586206,775.3995089078105,43.07775049487836,264.5480677450177,9,61.6336243892667
lightning_1.8.0,tests/tests_pytorch/trainer/optimization/test_optimizers.py,825,529,612,8,109,75,138,117,213,761.7320914006849,5.064220183486238,7410.917452015948,411.71763622310823,1463.3876852712651,60,24.259863113762407
lightning_1.8.0,tests/tests_pytorch/trainer/optimization/__init__.py,0,0,0,0,0,0,0,0,0,0,0,0,0.0,0,1,100.0
lightning_1.8.0,tests/tests_pytorch/trainer/optimization/test_manual_optimization.py,1049,635,747,14,156,123,238,170,361,1189.8257150513173,10.679487179487179,28565.386879215086,1586.9659377341713,2674.7901279457105,71,22.7468105553334
lightning_1.8.0,tests/tests_pytorch/trainer/optimization/test_backward_calls.py,57,41,38,1,9,6,12,10,18,28.529325012980813,0.6666666666666666,39.86313713864835,2.2146187299249083,59.794705707972525,7,51.43705466433691
lightning_1.8.0,tests/tests_pytorch/loops/test_loops.py,1021,537,792,16,213,232,457,229,689,1711.4931491081038,17.164319248826292,92708.11697162251,5150.450942867918,5401.211409998795,115,14.632263713520528
lightning_1.8.0,tests/tests_pytorch/loops/test_utilities.py,61,32,31,3,4,3,5,7,8,12.75488750216347,1.875,42.11032383086406,2.3394624350480036,22.458839376460833,4,86.14141436410591
lightning_1.8.0,tests/tests_pytorch/loops/test_evaluation_loop_flow.py,249,156,173,4,25,30,56,29,86,124.09640474436812,4.48,1871.6829178027515,103.98238432237508,417.7863655809713,21,50.30530305355455
lightning_1.8.0,tests/tests_pytorch/loops/test_evaluation_loop.py,210,115,136,8,45,29,56,53,85,271.13338933483533,4.977777777777778,2423.546787886296,134.64148821590533,486.87323863787196,12,59.05024268251004
lightning_1.8.0,tests/tests_pytorch/loops/test_all.py,110,55,70,4,7,7,14,11,21,27.651484454403228,4.0,290.592255965533,16.14401422030739,72.64806399138325,23,69.29060302229911
lightning_1.8.0,tests/tests_pytorch/loops/test_training_loop_flow_dict.py,191,108,127,3,27,22,40,30,62,133.13685006057713,2.2222222222222223,676.0604820616181,37.558915670089895,304.22721692772814,13,57.51206286471079
lightning_1.8.0,tests/tests_pytorch/loops/__init__.py,0,0,0,0,0,0,0,0,0,0,0,0,0.0,0,1,100.0
lightning_1.8.0,tests/tests_pytorch/loops/test_training_loop_flow_scalar.py,345,202,233,5,56,39,73,61,112,336.82151610966264,3.2589285714285716,2164.7191282104536,120.26217378946964,664.2425818070433,30,45.70585807037956
lightning_1.8.0,tests/tests_pytorch/loops/test_training_loop.py,234,153,170,8,47,33,60,55,93,285.06567602884894,5.1063829787234045,2745.5308256568173,152.52949031426763,537.6664533577933,26,47.981677863455246
lightning_1.8.0,tests/tests_pytorch/loops/test_flow_warnings.py,45,16,22,1,2,1,2,3,3,2.0,0.5,2.3774437510817346,0.1320802083934297,4.754887502163469,4,97.6866888052287
lightning_1.8.0,tests/tests_pytorch/loops/test_loop_state_dict.py,154,23,132,1,4,2,4,5,6,8.0,0.5,6.965784284662087,0.3869880158145604,13.931568569324174,3,81.67529277917149
lightning_1.8.0,tests/tests_pytorch/loops/batch/__init__.py,0,0,0,0,0,0,0,0,0,0,0,0,0.0,0,1,100.0
lightning_1.8.0,tests/tests_pytorch/loops/batch/test_truncated_bptt.py,205,120,140,12,50,36,70,62,106,325.2123594973901,8.4,5301.616394768474,294.5342441538041,631.1448089010088,12,56.80493443745934
lightning_1.8.0,tests/tests_pytorch/loops/epoch/__init__.py,0,0,0,0,0,0,0,0,0,0,0,0,0.0,0,1,100.0
lightning_1.8.0,tests/tests_pytorch/loops/epoch/test_training_epoch_loop.py,220,79,176,6,24,13,24,30,37,125.5488750216347,3.0,544.6648561125455,30.259158672919195,181.5549520375152,16,65.24151610911497
lightning_1.8.0,tests/tests_pytorch/loops/optimization/test_closure.py,47,23,25,0,0,0,0,0,0,0,0,0,0.0,0,1,100.0
lightning_1.8.0,tests/tests_pytorch/loops/optimization/__init__.py,0,0,0,0,0,0,0,0,0,0,0,0,0.0,0,1,100.0
lightning_1.8.0,tests/tests_pytorch/loops/optimization/test_optimizer_loop.py,240,115,177,6,44,22,46,50,68,255.724766224368,3.1363636363636362,1203.6806019283185,66.87114455157325,383.78222090468125,16,55.965735539744884
lightning_1.8.0,tests/tests_pytorch/loops/optimization/test_manual_loop.py,45,25,24,2,5,3,5,7,8,13.60964047443681,1.0,22.458839376460833,1.2477132986922685,22.458839376460833,4,88.71406413760097
lightning_1.8.0,tests/tests_pytorch/serve/__init__.py,0,0,0,0,0,0,0,0,0,0,0,0,0.0,0,1,100.0
lightning_1.8.0,tests/tests_pytorch/serve/test_servable_module_validator.py,50,33,37,0,0,0,0,0,0,0,0,0,0.0,0,6,100.0
lightning_1.8.0,tests/tests_pytorch/deprecated_api/test_remove_2-0.py,322,169,246,3,10,14,28,13,42,37.974168451037094,4.2,652.7575662800887,36.264309237782705,155.41846816192586,15,48.780879962064986
lightning_1.8.0,tests/tests_pytorch/deprecated_api/__init__.py,23,7,7,0,0,0,0,0,0,0,0,0,0.0,0,1,100.0
lightning_1.8.0,tests/tests_pytorch/deprecated_api/test_remove_1-10.py,334,189,236,2,6,4,8,8,12,17.509775004326936,1.3333333333333333,48.0,2.6666666666666665,36.0,6,52.303026468823546
lightning_1.8.0,tests/tests_pytorch/deprecated_api/test_remove_1-9.py,239,135,167,2,4,2,4,6,6,10.0,1.0,15.509775004326936,0.861654166907052,15.509775004326936,3,60.76696899484225
lightning_1.8.0,tests/tests_pytorch/loggers/test_mlflow.py,279,192,184,7,64,47,90,71,137,403.6514844544032,4.921875,4146.755264722259,230.37529248456997,842.5153553721415,37,46.161219102745974
lightning_1.8.0,tests/tests_pytorch/loggers/test_all.py,341,199,243,6,29,22,43,35,65,156.39122386302654,4.448275862068965,1483.0702792097773,82.39279328943206,333.4033961014228,29,48.982549028335114
lightning_1.8.0,tests/tests_pytorch/loggers/__init__.py,0,0,0,0,0,0,0,0,0,0,0,0,0.0,0,1,100.0
lightning_1.8.0,tests/tests_pytorch/loggers/test_logger.py,349,223,262,6,39,23,46,45,69,221.64046153995463,3.5384615384615383,1340.857055980799,74.49205866559994,378.9378636467476,33,43.12498926138139
lightning_1.8.0,tests/tests_pytorch/loggers/test_csv.py,128,82,82,3,20,12,24,23,36,91.19344939991072,1.8,293.12681475249445,16.284823041805247,162.84823041805248,12,63.237201481861675
lightning_1.8.0,tests/tests_pytorch/loggers/test_neptune.py,381,206,256,1,19,11,22,20,33,80.71062275542812,0.5789473684210527,82.57157360232172,4.587309644573429,142.62362713128297,41,52.588262936008064
lightning_1.8.0,tests/tests_pytorch/loggers/test_wandb.py,345,221,234,5,38,25,48,43,73,211.03088598529305,3.1578947368421053,1250.8968223997467,69.49426791109704,396.11732709325315,27,50.09889088930006
lightning_1.8.0,tests/tests_pytorch/loggers/test_comet.py,234,148,141,6,39,29,57,45,86,221.64046153995463,4.384615384615385,2070.8510675544667,115.0472815308037,472.299366284352,27,50.45875620253854
lightning_1.8.0,tests/tests_pytorch/loggers/test_tensorboard.py,331,202,224,6,60,39,76,66,115,369.92321074083804,3.8,2641.4002301596443,146.74445723109136,695.1053237262222,33,45.74488964653572
lightning_1.8.0,tests/tests_pytorch/utilities/test_migration.py,36,15,15,3,4,4,6,7,10,12.75488750216347,2.25,63.16548574629609,3.509193652572005,28.07354922057604,7,90.64613059723875
lightning_1.8.0,tests/tests_pytorch/utilities/test_deepspeed_model_summary.py,53,21,29,3,6,6,10,9,16,20.264662506490406,2.5,126.7970000576925,7.044277780982917,50.718800023077,2,88.17361508583554
lightning_1.8.0,tests/tests_pytorch/utilities/test_model_helpers.py,32,14,14,1,3,3,3,4,6,4.754887502163469,0.5,6.0,0.3333333333333333,12.0,6,91.18848087929128
lightning_1.8.0,tests/tests_pytorch/utilities/test_parameter_tying.py,77,45,48,1,2,1,2,3,3,2.0,0.5,2.3774437510817346,0.1320802083934297,4.754887502163469,6,84.15390054875094
lightning_1.8.0,tests/tests_pytorch/utilities/test_auto_restart.py,1482,1019,1123,16,289,179,338,305,517,2426.5535222426965,9.356401384083044,39920.28439194328,2217.793577330182,4266.628028576778,238,0.0
lightning_1.8.0,tests/tests_pytorch/utilities/test_seed.py,37,26,25,1,2,1,2,3,3,2.0,0.5,2.3774437510817346,0.1320802083934297,4.754887502163469,10,84.60131508282042
lightning_1.8.0,tests/tests_pytorch/utilities/test_parsing.py,306,194,202,3,60,35,68,63,103,359.1683232386746,1.7,1046.6217146048352,58.14565081137974,615.6598321204914,56,43.70045275816235
lightning_1.8.0,tests/tests_pytorch/utilities/test_imports.py,143,71,93,4,11,8,11,15,19,46.053747805010275,2.0,148.46184263312372,8.24788014628465,74.23092131656186,23,71.65333784230323
lightning_1.8.0,tests/tests_pytorch/utilities/__init__.py,0,0,0,0,0,0,0,0,0,0,0,0,0.0,0,1,100.0
lightning_1.8.0,tests/tests_pytorch/utilities/test_argparse.py,254,136,178,6,61,36,71,67,107,377.284752595663,3.4918032786885247,2266.430143274149,125.91278573745272,649.0715433789816,47,45.34814071237953
lightning_1.8.0,tests/tests_pytorch/utilities/test_logger.py,193,124,130,5,80,51,102,85,153,517.3638880654257,3.1875,3125.7798421676557,173.65443567598086,980.6368132290685,53,48.27254751903439
lightning_1.8.0,tests/tests_pytorch/utilities/test_torchdistx.py,92,43,65,2,4,4,6,6,10,10.0,1.5,38.77443751081734,2.1541354172676304,25.84962500721156,9,77.24750722166259
lightning_1.8.0,tests/tests_pytorch/utilities/test_dtype_device_mixin.py,72,31,45,4,9,6,12,13,18,36.52932501298081,2.6666666666666665,177.62110647077242,9.867839248376246,66.60791492653966,7,80.51486125746436
lightning_1.8.0,tests/tests_pytorch/utilities/test_upgrade_checkpoint.py,49,13,32,1,2,1,2,3,3,2.0,0.5,2.3774437510817346,0.1320802083934297,4.754887502163469,2,99.02017703177616
lightning_1.8.0,tests/tests_pytorch/utilities/test_finite_checks.py,20,13,13,1,1,1,1,2,2,0.0,0.5,1.0,0.05555555555555555,2.0,2,73.32365793579612
lightning_1.8.0,tests/tests_pytorch/utilities/test_distributed.py,36,16,13,1,2,1,2,3,3,2.0,0.5,2.3774437510817346,0.1320802083934297,4.754887502163469,2,90.55131097900453
lightning_1.8.0,tests/tests_pytorch/utilities/test_fetching.py,597,416,427,11,101,71,138,112,209,710.5331075629416,7.514851485148514,10691.658600405146,593.9810333558414,1422.7371787100392,68,29.5134405462284
lightning_1.8.0,tests/tests_pytorch/utilities/test_all_gather_grad.py,135,64,94,2,20,14,28,22,42,88.43856189774725,1.4,262.21457917587304,14.567476620881836,187.29612798276648,5,64.98369647088498
lightning_1.8.0,tests/tests_pytorch/utilities/test_grads.py,92,36,65,2,5,4,5,7,9,13.60964047443681,1.0,25.26619429851844,1.403677461028802,25.26619429851844,4,80.2236523695453
lightning_1.8.0,tests/tests_pytorch/utilities/test_enums.py,21,6,6,2,3,2,3,5,5,6.754887502163469,1.0,11.60964047443681,0.6449800263576005,11.60964047443681,5,77.57095091543897
lightning_1.8.0,tests/tests_pytorch/utilities/test_memory.py,55,28,27,2,4,5,9,6,14,10.0,2.25,81.42631877271643,4.523684376262024,36.18947501009619,10,85.32269860347189
lightning_1.8.0,tests/tests_pytorch/utilities/test_types.py,37,16,16,1,2,2,2,3,4,2.0,0.5,3.1699250014423126,0.17610694452457293,6.339850002884625,4,95.5392299479906
lightning_1.8.0,tests/tests_pytorch/utilities/test_deepspeed_collate_checkpoint.py,59,29,37,1,2,1,2,3,3,2.0,0.5,2.3774437510817346,0.1320802083934297,4.754887502163469,6,90.87102108904666
lightning_1.8.0,tests/tests_pytorch/utilities/test_model_summary.py,360,218,240,6,57,30,60,63,90,347.9845058117172,3.1578947368421053,1698.8058729947134,94.37810405526186,537.9551931149925,44,43.76743751569218
lightning_1.8.0,tests/tests_pytorch/utilities/test_warnings.py,61,29,28,2,8,5,10,10,15,26.0,1.25,62.28615177913805,3.4603417655076694,49.82892142331044,6,82.03409130952015
lightning_1.8.0,tests/tests_pytorch/utilities/test_data.py,301,195,189,5,56,31,57,61,88,336.82151610966264,2.544642857142857,1328.0615395185466,73.78119663991926,521.9048857055341,36,49.157319906738806
lightning_1.8.0,tests/tests_pytorch/tuner/__init__.py,0,0,0,0,0,0,0,0,0,0,0,0,0.0,0,1,100.0
lightning_1.8.0,tests/tests_pytorch/tuner/test_tuning.py,27,10,9,0,0,0,0,0,0,0,0,0,0.0,0,1,100.0
lightning_1.8.0,tests/tests_pytorch/tuner/test_lr_finder.py,436,266,295,11,53,36,69,64,105,341.6335318968599,7.160377358490566,4511.037735849056,250.61320754716976,630.0,40,38.70986691363589
lightning_1.8.0,tests/tests_pytorch/tuner/test_scale_batch_size.py,476,312,331,13,79,63,119,92,182,546.1043954418253,9.791139240506329,11624.904828959976,645.828046053332,1187.2882760023763,67,29.940318026393204
lightning_1.8.0,tests/tests_pytorch/helpers/deterministic_model.py,128,86,82,9,39,23,45,48,68,234.6600115486085,5.1923076923076925,1971.921375254624,109.55118751414578,379.7774500490387,34,58.345460125671956
lightning_1.8.0,tests/tests_pytorch/helpers/utils.py,94,53,53,7,18,11,20,25,31,94.71013448036484,3.888888888888889,559.8426628783973,31.10237015991096,143.95954188301644,14,73.34329421278458
lightning_1.8.0,tests/tests_pytorch/helpers/simple_models.py,122,92,90,0,0,0,0,0,0,0,0,0,0.0,0,16,100.0
lightning_1.8.0,tests/tests_pytorch/helpers/advanced_models.py,251,150,170,5,9,7,12,14,19,40.13896548741762,3.3333333333333335,241.13247839698158,13.39624879983231,72.33974351909447,28,56.930244828346666
lightning_1.8.0,tests/tests_pytorch/helpers/__init__.py,7,2,7,0,0,0,0,0,0,0,0,0,0.0,0,1,100.0
lightning_1.8.0,tests/tests_pytorch/helpers/pipelines.py,106,53,62,4,12,9,12,16,21,51.01955000865388,2.0,168.0,9.333333333333334,84.0,17,74.71432747108805
lightning_1.8.0,tests/tests_pytorch/helpers/test_models.py,49,19,28,1,2,1,2,3,3,2.0,0.5,2.3774437510817346,0.1320802083934297,4.754887502163469,4,95.69730114926395
lightning_1.8.0,tests/tests_pytorch/helpers/dataloaders.py,52,32,30,2,4,4,8,6,12,10.0,2.0,62.039100017307746,3.446616667628208,31.019550008653873,10,84.26511544611714
lightning_1.8.0,tests/tests_pytorch/helpers/test_datasets.py,36,12,15,0,0,0,0,0,0,0,0,0,0.0,0,1,100.0
lightning_1.8.0,tests/tests_pytorch/helpers/datasets.py,214,123,124,8,24,15,26,32,41,134.03910001730776,4.333333333333333,888.3333333333333,49.35185185185185,205.0,43,60.91697245499244
lightning_1.8.0,tests/tests_pytorch/helpers/runif.py,274,135,175,11,52,36,56,63,92,334.4766131483471,5.923076923076923,3257.1577675441085,180.95320930800602,549.9097529619924,41,56.21775341265758
lightning_1.8.0,tests/tests_pytorch/helpers/datamodules.py,120,65,79,2,4,5,7,6,12,10.0,1.75,54.284212515144276,3.015789584174682,31.019550008653873,22,70.00651626127697
lightning_1.8.0,tests/tests_pytorch/plugins/test_checkpoint_io_plugin.py,152,84,108,3,25,27,54,28,81,120.85129224653159,3.24,1261.6422257447975,70.09123476359986,389.3957486866659,28,56.52114892161521
lightning_1.8.0,tests/tests_pytorch/plugins/test_cluster_integration.py,109,55,79,3,26,13,26,29,39,126.96632017383187,1.5,284.191888214963,15.78843823416461,189.46125880997533,16,68.36685921628852
lightning_1.8.0,tests/tests_pytorch/plugins/test_amp_plugins.py,287,145,218,6,24,13,26,30,39,125.5488750216347,3.25,621.9483829933797,34.55268794407665,191.36873322873222,31,50.591603306430386
lightning_1.8.0,tests/tests_pytorch/plugins/__init__.py,0,0,0,0,0,0,0,0,0,0,0,0,0.0,0,1,100.0
lightning_1.8.0,tests/tests_pytorch/plugins/test_double_plugin.py,173,116,126,1,21,26,52,22,78,92.23866587835397,1.2380952380952381,430.6536820284019,23.925204557133437,347.8356662537092,46,49.611937358319715
lightning_1.8.0,tests/tests_pytorch/plugins/environments/__init__.py,0,0,0,0,0,0,0,0,0,0,0,0,0.0,0,1,100.0
lightning_1.8.0,tests/tests_pytorch/plugins/environments/torch_elastic_deadlock.py,43,22,30,2,6,3,6,8,9,17.509775004326936,1.0,27.0,1.5,27.0,7,79.82456077371003
lightning_1.8.0,tests/tests_pytorch/plugins/precision/test_deepspeed_precision.py,39,17,17,1,2,1,2,3,3,2.0,0.5,2.3774437510817346,0.1320802083934297,4.754887502163469,3,96.40762456334086
lightning_1.8.0,tests/tests_pytorch/plugins/precision/test_sharded_precision.py,42,16,24,1,1,1,1,2,2,0.0,0.5,1.0,0.05555555555555555,2.0,5,100.0
lightning_1.8.0,tests/tests_pytorch/plugins/precision/__init__.py,0,0,0,0,0,0,0,0,0,0,0,0,0.0,0,1,100.0
lightning_1.8.0,tests/tests_pytorch/plugins/precision/test_tpu_bf16_plugin.py,25,9,9,2,4,2,4,6,6,10.0,1.0,15.509775004326936,0.861654166907052,15.509775004326936,3,88.16896230816141
lightning_1.8.0,tests/tests_pytorch/plugins/precision/hpu/test_hpu.py,95,48,66,1,12,6,12,13,18,43.01955000865388,0.5,33.30395746326983,1.8502198590705463,66.60791492653966,8,72.73746866849785
lightning_1.8.0,tests/tests_app_examples/test_template_react_ui.py,34,22,26,4,7,4,7,11,11,27.651484454403228,2.0,76.10749561002055,4.228194200556697,38.053747805010275,4,59.11246459579878
lightning_1.8.0,tests/tests_app_examples/test_multi_node.py,29,17,23,1,2,1,2,3,3,2.0,0.5,2.3774437510817346,0.1320802083934297,4.754887502163469,5,67.7451719500489
lightning_1.8.0,tests/tests_app_examples/test_collect_failures.py,40,19,35,5,8,5,9,13,14,35.60964047443681,2.8125,145.70481390180552,8.09471188343364,51.80615605397529,6,69.32716330715748
lightning_1.8.0,tests/tests_app_examples/test_quick_start.py,70,44,53,3,8,4,8,11,12,28.75488750216347,1.5,62.26976913547136,3.4594316186372978,41.51317942364757,5,60.357075898656205
lightning_1.8.0,tests/tests_app_examples/layout.py,24,9,19,2,4,2,4,6,6,10.0,1.0,15.509775004326936,0.861654166907052,15.509775004326936,3,70.44404409360986
lightning_1.8.0,tests/tests_app_examples/__init__.py,0,0,0,0,0,0,0,0,0,0,0,0,0.0,0,1,100.0
lightning_1.8.0,tests/tests_app_examples/test_argparse.py,67,34,50,1,11,12,24,12,36,38.053747805010275,1.0909090909090908,140.7912545737763,7.821736365209795,129.05865002596164,13,50.06407681211816
lightning_1.8.0,tests/tests_app_examples/test_drive.py,24,14,19,2,3,2,3,5,5,6.754887502163469,1.0,11.60964047443681,0.6449800263576005,11.60964047443681,4,67.00451751628648
lightning_1.8.0,tests/tests_app_examples/test_custom_work_dependencies.py,22,14,17,2,3,2,3,5,5,6.754887502163469,1.0,11.60964047443681,0.6449800263576005,11.60964047443681,4,81.08827036812559
lightning_1.8.0,tests/tests_app_examples/pickle_or_not.py,24,9,19,2,4,2,4,6,6,10.0,1.0,15.509775004326936,0.861654166907052,15.509775004326936,3,70.44404409360986
lightning_1.8.0,tests/tests_app_examples/test_v0_app.py,80,46,67,4,11,7,13,15,20,46.053747805010275,2.3636363636363638,184.68937361058454,10.260520756143585,78.13781191217038,7,49.53330065732397
lightning_1.8.0,tests/tests_app_examples/test_core_features_app.py,27,8,22,1,2,1,2,3,3,2.0,0.5,2.3774437510817346,0.1320802083934297,4.754887502163469,2,87.79081682215599
lightning_1.8.0,tests/tests_app_examples/test_commands_and_api.py,52,31,36,5,11,8,14,16,22,49.663388279447084,3.1818181818181817,280.0,15.555555555555555,88.0,7,76.06183618874259
lightning_1.8.0,tests/tests_app_examples/test_template_streamlit_ui.py,34,21,25,3,5,3,5,8,8,16.36452797660028,1.5,36.0,2.0,24.0,4,60.954886895363295
lightning_1.8.0,tests/tests_app_examples/test_boring_app.py,38,21,30,3,6,3,6,9,9,20.264662506490406,1.5,42.793987519471216,2.377443751081734,28.529325012980813,4,60.42917396326843
lightning_1.8.0,tests/tests_app_examples/test_idle_timeout.py,23,14,19,2,3,2,3,5,5,6.754887502163469,1.0,11.60964047443681,0.6449800263576005,11.60964047443681,4,67.00451751628648
lightning_1.8.0,tests/tests_app_examples/test_payload.py,19,14,14,2,3,2,3,5,5,6.754887502163469,1.0,11.60964047443681,0.6449800263576005,11.60964047443681,4,67.00451751628648
lightning_1.8.0,tests/tests_app_examples/components/__init__.py,0,0,0,0,0,0,0,0,0,0,0,0,0.0,0,1,100.0
lightning_1.8.0,tests/tests_app_examples/components/python/__init__.py,0,0,0,0,0,0,0,0,0,0,0,0,0.0,0,1,100.0
lightning_1.8.0,tests/tests_app_examples/components/python/test_scripts.py,40,17,33,2,4,2,4,6,6,10.0,1.0,15.509775004326936,0.861654166907052,15.509775004326936,3,64.41888735626253
lightning_1.8.0,tests/tests_app_examples/custom_work_dependencies/__init__.py,0,0,0,0,0,0,0,0,0,0,0,0,0.0,0,1,100.0
lightning_1.8.0,tests/tests_app_examples/custom_work_dependencies/app.py,53,32,32,3,5,4,6,8,10,16.36452797660028,1.8,54.0,3.0,30.0,12,76.56964753042385
lightning_1.8.0,tests/tests_app_examples/collect_failures/__init__.py,0,0,0,0,0,0,0,0,0,0,0,0,0.0,0,1,100.0
lightning_1.8.0,tests/tests_app_examples/collect_failures/app.py,46,35,35,3,7,4,7,10,11,24.406371956566698,1.5,54.81181356564148,3.0451007536467487,36.541209043760986,9,64.19758919441857
lightning_1.8.0,tests/tests_app_examples/idle_timeout/__init__.py,0,0,0,0,0,0,0,0,0,0,0,0,0.0,0,1,100.0
lightning_1.8.0,tests/tests_app_examples/idle_timeout/app.py,71,53,56,7,21,20,38,28,58,111.8901503327572,6.333333333333333,1765.9017080358265,98.10565044643481,278.826585479341,21,50.43311487056676
lightning_1.8.0,tests/tests_app_examples/core_features_app/app.py,17,10,10,1,4,2,4,5,6,8.0,0.5,6.965784284662087,0.3869880158145604,13.931568569324174,5,87.32066082742186
lightning_1.8.0,tests/tests_lite/test_connector.py,792,440,622,7,66,38,75,73,113,418.58149633206114,3.977272727272727,2781.9041057239165,154.55022809577315,699.4501751534419,118,17.410981709147894
lightning_1.8.0,tests/tests_lite/__init__.py,0,0,0,0,0,0,0,0,0,0,0,0,0.0,0,1,100.0
lightning_1.8.0,tests/tests_lite/conftest.py,157,81,102,8,27,18,34,35,52,152.38196255841368,5.037037037037037,1343.4922035494371,74.63845575274651,266.72271688113824,19,64.94829175188725
lightning_1.8.0,tests/tests_lite/test_parity.py,226,141,171,3,17,11,19,20,30,74.24175580341925,1.6764705882352942,217.36756006639382,12.075975559244101,129.65784284662087,29,51.261574806094856
lightning_1.8.0,tests/tests_lite/test_wrappers.py,272,151,190,4,29,21,41,33,62,148.8814488586996,2.8275862068965516,884.3344725109785,49.12969291727658,312.7524354002241,26,49.70885976977618
lightning_1.8.0,tests/tests_lite/test_lite.py,488,303,328,5,54,43,83,59,126,322.37356559126414,3.8425925925925926,2848.1796763993584,158.2322042444088,741.2130242195921,52,38.528123327492615
lightning_1.8.0,tests/tests_lite/accelerators/__init__.py,0,0,0,0,0,0,0,0,0,0,0,0,0.0,0,1,100.0
lightning_1.8.0,tests/tests_lite/accelerators/test_registry.py,73,40,41,4,11,7,14,15,21,46.053747805010275,2.5454545454545454,208.84106092889172,11.602281162716206,82.0447025077789,8,77.46005713066869
lightning_1.8.0,tests/tests_lite/accelerators/test_tpu.py,40,11,20,1,4,2,4,5,6,8.0,0.5,6.965784284662087,0.3869880158145604,13.931568569324174,4,97.24614368114396
lightning_1.8.0,tests/tests_lite/accelerators/test_mps.py,56,23,31,1,4,2,4,5,6,8.0,0.5,6.965784284662087,0.3869880158145604,13.931568569324174,5,90.38863984998477
lightning_1.8.0,tests/tests_lite/accelerators/test_cuda.py,75,37,42,1,8,4,8,9,12,24.0,0.5,19.019550008653876,1.0566416671474377,38.03910001730775,7,81.78803531739787
lightning_1.8.0,tests/tests_lite/accelerators/test_cpu.py,50,18,24,1,4,2,4,5,6,8.0,0.5,6.965784284662087,0.3869880158145604,13.931568569324174,4,93.27833647736841
lightning_1.8.0,tests/tests_lite/strategies/test_dp.py,50,27,27,1,9,5,10,10,15,28.529325012980813,0.5555555555555556,27.68273412406136,1.5379296735589643,49.82892142331044,7,84.93049294536121
lightning_1.8.0,tests/tests_lite/strategies/test_deepspeed_integration.py,324,195,232,4,49,30,59,53,89,283.1207823616452,2.4081632653061225,1227.6453186494434,68.20251770274686,509.7849204561248,16,48.76225408979965
lightning_1.8.0,tests/tests_lite/strategies/test_fairscale.py,91,52,55,5,15,8,16,20,24,70.2129994085646,2.6666666666666665,276.6033980727912,15.366855448488401,103.72627427729671,9,73.52938540437599
lightning_1.8.0,tests/tests_lite/strategies/__init__.py,0,0,0,0,0,0,0,0,0,0,0,0,0.0,0,1,100.0
lightning_1.8.0,tests/tests_lite/strategies/test_registry.py,68,20,43,3,10,6,12,13,18,37.974168451037094,1.8,119.8942468677714,6.660791492653967,66.60791492653966,8,84.83606431232658
lightning_1.8.0,tests/tests_lite/strategies/test_xla.py,115,71,68,3,11,6,12,14,18,42.808635307173745,1.6363636363636365,112.14390861333307,6.23021714518517,68.53238859703687,8,71.68164526966154
lightning_1.8.0,tests/tests_lite/strategies/test_ddp.py,64,29,37,1,2,1,2,3,3,2.0,0.5,2.3774437510817346,0.1320802083934297,4.754887502163469,3,90.4951860629562
lightning_1.8.0,tests/tests_lite/strategies/test_deepspeed.py,118,63,72,5,13,8,15,18,23,59.715356810271004,2.8846153846153846,276.658485672615,15.369915870700831,95.90827503317318,13,69.83577296782181
lightning_1.8.0,tests/tests_lite/strategies/test_single_device.py,54,29,28,1,13,8,16,14,24,48.105716335834195,0.6153846153846154,56.23170346423538,3.1239835257908544,91.37651812938249,10,81.89582655332526
lightning_1.8.0,tests/tests_lite/strategies/test_fairscale_integration.py,83,43,49,2,4,2,4,6,6,10.0,1.0,15.509775004326936,0.861654166907052,15.509775004326936,10,82.1498348507497
lightning_1.8.0,tests/tests_lite/strategies/launchers/test_subprocess_script.py,125,82,82,5,15,11,21,20,32,70.2129994085646,3.5,484.0559466273846,26.8919970348547,138.3016990363956,9,67.01771493258259
lightning_1.8.0,tests/tests_lite/strategies/launchers/test_multiprocessing.py,96,58,61,2,13,7,13,15,20,50.105716335834195,1.0,78.13781191217038,4.340989550676132,78.13781191217038,9,72.59302664887686
lightning_1.8.0,tests/tests_lite/strategies/launchers/__init__.py,0,0,0,0,0,0,0,0,0,0,0,0,0.0,0,1,100.0
lightning_1.8.0,tests/tests_lite/strategies/launchers/test_xla.py,37,25,29,1,2,1,2,3,3,2.0,0.5,2.3774437510817346,0.1320802083934297,4.754887502163469,3,64.36053324294122
lightning_1.8.0,tests/tests_lite/utilities/test_xla_device_utils.py,54,28,25,4,6,4,7,10,11,23.509775004326936,2.3333333333333335,85.26282110210897,4.736823394561609,36.541209043760986,5,85.97063248385622
lightning_1.8.0,tests/tests_lite/utilities/test_optimizer.py,30,22,22,1,2,2,4,3,6,2.0,1.0,9.509775004326938,0.5283208335737188,9.509775004326938,9,75.15789278232964
lightning_1.8.0,tests/tests_lite/utilities/test_seed.py,84,68,57,4,25,15,29,29,44,124.09640474436812,2.32,495.90269998262255,27.550149999034588,213.7511637856132,17,49.349706169950196
lightning_1.8.0,tests/tests_lite/utilities/test_imports.py,31,15,15,1,2,2,2,3,4,2.0,0.5,3.1699250014423126,0.17610694452457293,6.339850002884625,9,93.16040532897712
lightning_1.8.0,tests/tests_lite/utilities/test_device_parser.py,86,31,58,1,4,2,4,5,6,8.0,0.5,6.965784284662087,0.3869880158145604,13.931568569324174,3,83.35331461231023
lightning_1.8.0,tests/tests_lite/utilities/__init__.py,0,0,0,0,0,0,0,0,0,0,0,0,0.0,0,1,100.0
lightning_1.8.0,tests/tests_lite/utilities/test_cloud_io.py,34,13,13,0,0,0,0,0,0,0,0,0,0.0,0,3,100.0
lightning_1.8.0,tests/tests_lite/utilities/test_device_dtype_mixin.py,145,90,106,4,36,34,64,40,98,194.11730005192322,3.5555555555555554,1854.3962783963077,103.02201546646154,521.5489532989616,36,53.49746100716958
lightning_1.8.0,tests/tests_lite/utilities/test_rank_zero.py,51,23,40,1,4,2,4,5,6,8.0,0.5,6.965784284662087,0.3869880158145604,13.931568569324174,3,71.29070778180822
lightning_1.8.0,tests/tests_lite/utilities/test_distributed.py,78,47,59,3,16,10,20,19,30,68.75488750216347,1.875,238.94592263120165,13.274773479511204,127.43782540330756,9,62.59432425888885
lightning_1.8.0,tests/tests_lite/utilities/test_apply_func.py,35,16,16,1,2,1,2,3,3,2.0,0.5,2.3774437510817346,0.1320802083934297,4.754887502163469,2,96.01086596015217
lightning_1.8.0,tests/tests_lite/utilities/test_enums.py,9,7,7,2,4,3,4,6,7,10.0,1.0,18.094737505048094,1.0052631947248942,18.094737505048094,6,71.95264655153322
lightning_1.8.0,tests/tests_lite/utilities/test_warnings.py,78,39,38,3,15,11,22,18,33,63.35824643629125,2.2,302.7365551047119,16.818697505817326,137.6075250475963,12,77.76716240412095
lightning_1.8.0,tests/tests_lite/utilities/test_data.py,526,275,373,8,103,68,122,111,190,712.7095542998715,4.737864077669903,6116.293583766814,339.7940879870452,1290.9390146065202,92,31.175609596148924
lightning_1.8.0,tests/tests_lite/helpers/utils.py,40,21,21,2,6,4,8,8,12,17.509775004326936,1.3333333333333333,48.0,2.6666666666666665,36.0,8,88.20968698308657
lightning_1.8.0,tests/tests_lite/helpers/__init__.py,0,0,0,0,0,0,0,0,0,0,0,0,0.0,0,1,100.0
lightning_1.8.0,tests/tests_lite/helpers/models.py,77,56,56,0,0,0,0,0,0,0,0,0,0.0,0,14,100.0
lightning_1.8.0,tests/tests_lite/helpers/dataloaders.py,52,32,30,2,4,4,8,6,12,10.0,2.0,62.039100017307746,3.446616667628208,31.019550008653873,10,84.26511544611714
lightning_1.8.0,tests/tests_lite/helpers/runif.py,163,81,98,10,30,17,30,40,47,180.4259988171292,5.0,1250.6531022985303,69.4807279054739,250.13062045970605,23,67.05371918609409
lightning_1.8.0,tests/tests_lite/plugins/__init__.py,0,0,0,0,0,0,0,0,0,0,0,0,0.0,0,1,100.0
lightning_1.8.0,tests/tests_lite/plugins/environments/test_torchelastic.py,104,52,70,3,25,15,28,28,43,120.85129224653159,1.68,347.2833195694413,19.29351775385785,206.71626164847697,19,68.25484176305136
lightning_1.8.0,tests/tests_lite/plugins/environments/test_slurm.py,148,81,101,5,36,22,41,41,63,197.72694052636004,2.8472222222222223,961.0108908283688,53.38949393490938,337.5257762909393,24,60.31800225457887
lightning_1.8.0,tests/tests_lite/plugins/environments/test_lsf.py,116,61,78,3,19,11,21,22,32,85.46551025759159,1.6578947368421053,236.58458271507345,13.143587928615192,142.7018117963935,14,65.97489031978984
lightning_1.8.0,tests/tests_lite/plugins/environments/test_lightning.py,88,59,52,4,32,19,37,36,56,168.0,2.3125,669.5052876867795,37.194738204821086,289.5158000807695,23,66.7615491661165
lightning_1.8.0,tests/tests_lite/plugins/environments/__init__.py,0,0,0,0,0,0,0,0,0,0,0,0,0.0,0,1,100.0
lightning_1.8.0,tests/tests_lite/plugins/environments/test_xla.py,79,46,51,2,22,14,26,24,40,100.10749561002054,1.1818181818181819,216.74368185227289,12.041315658459604,183.39850002884629,16,72.09450437594651
lightning_1.8.0,tests/tests_lite/plugins/environments/test_kubeflow.py,103,47,70,3,19,12,23,22,35,85.46551025759159,1.8157894736842106,283.4086147107651,15.74492303948695,156.0801066523054,15,71.52347349142589
lightning_1.8.0,tests/tests_lite/plugins/precision/test_deepspeed_integration.py,37,13,16,1,1,1,2,2,3,0.0,1.0,3.0,0.16666666666666666,3.0,4,97.4639704367898
lightning_1.8.0,tests/tests_lite/plugins/precision/test_double_integration.py,54,29,28,1,8,8,15,9,23,24.0,0.9375,68.35150784359986,3.7973059913111036,72.90827503317318,13,82.3844151487674
lightning_1.8.0,tests/tests_lite/plugins/precision/test_double.py,25,8,8,1,5,3,6,6,9,11.60964047443681,0.6,13.95879750389424,0.7754887502163467,23.264662506490403,4,84.21581664552185
lightning_1.8.0,tests/tests_lite/plugins/precision/test_native_amp_integration.py,72,40,46,1,8,7,14,9,21,24.0,0.875,58.2473719015025,3.2359651056390275,66.56842503028857,15,76.34767479033731
lightning_1.8.0,tests/tests_lite/plugins/precision/test_native_amp.py,94,60,58,2,17,9,18,19,27,71.48686830125578,1.0588235294117647,121.44075126668132,6.746708403704518,114.6940428629768,13,69.92709078502098
lightning_1.8.0,tests/tests_lite/plugins/precision/__init__.py,0,0,0,0,0,0,0,0,0,0,0,0,0.0,0,1,100.0
lightning_1.8.0,tests/tests_lite/plugins/precision/test_deepspeed.py,66,35,34,1,2,1,2,3,3,2.0,0.5,2.3774437510817346,0.1320802083934297,4.754887502163469,4,89.95261509720677
lightning_1.8.0,tests/tests_lite/plugins/precision/test_tpu_bf16.py,23,7,7,2,4,2,4,6,6,10.0,1.0,15.509775004326936,0.861654166907052,15.509775004326936,3,81.96239236383082
lightning_1.8.0,tests/tests_lite/plugins/collectives/__init__.py,0,0,0,0,0,0,0,0,0,0,0,0,0.0,0,1,100.0
lightning_1.8.0,tests/tests_lite/plugins/collectives/test_single_device.py,27,18,17,0,0,0,0,0,0,0,0,0,0.0,0,3,100.0
lightning_1.8.0,tests/tests_lite/plugins/collectives/test_torch_collective.py,277,159,215,8,62,44,83,70,127,393.1601712439863,5.354838709677419,4168.307889136574,231.57266050758744,778.4189431520108,43,43.59010067509522
lightning_1.8.0,tests/tests_app/test_imports.py,68,34,53,6,22,14,23,28,37,113.61727061434748,3.1363636363636362,557.8716870915027,30.992871505083485,177.87213211613133,20,65.52513841082036
lightning_1.8.0,tests/tests_app/__init__.py,4,3,3,0,0,0,0,0,0,0,0,0,0.0,0,1,100.0
lightning_1.8.0,tests/tests_app/conftest.py,87,64,62,6,10,6,10,16,16,48.72905595320056,3.0,192.0,10.666666666666666,64.0,11,66.28258509661366
lightning_1.8.0,tests/tests_app/components/__init__.py,0,0,0,0,0,0,0,0,0,0,0,0,0.0,0,1,100.0
lightning_1.8.0,tests/tests_app/components/python/test_python.py,124,83,93,5,17,12,21,22,33,81.0965087756926,3.088235294117647,454.46854584053636,25.248252546696463,147.1612434150308,13,49.95866642952293
lightning_1.8.0,tests/tests_app/components/python/scripts/a.py,1,1,1,0,0,0,0,0,0,0,0,0,0.0,0,1,100.0
lightning_1.8.0,tests/tests_app/components/python/scripts/c.py,4,3,3,1,4,2,4,5,6,8.0,0.5,6.965784284662087,0.3869880158145604,13.931568569324174,3,81.1782821759445
lightning_1.8.0,tests/tests_app/components/python/scripts/b.py,3,2,2,0,0,0,0,0,0,0,0,0,0.0,0,1,100.0
lightning_1.8.0,tests/tests_app/components/serve/test_gradio.py,30,23,22,1,3,2,4,4,6,4.754887502163469,0.6666666666666666,8.0,0.4444444444444444,12.0,3,62.33536790821647
lightning_1.8.0,tests/tests_app/components/serve/test_streamlit.py,107,64,75,3,23,14,27,26,41,108.79681249147477,1.7608695652173914,339.3513109553602,18.852850608631122,192.7180284437848,20,41.91094022425561
lightning_1.8.0,tests/tests_app/components/serve/test_model_inference_api.py,78,56,53,0,0,0,0,0,0,0,0,0,0.0,0,10,100.0
lightning_1.8.0,tests/tests_app/components/sample_package_repo/setup.py,46,12,40,0,0,0,0,0,0,0,0,0,0.0,0,2,100.0
lightning_1.8.0,tests/tests_app/components/sample_package_repo/external_lightning_component_package/__init__.py,17,11,11,0,0,0,0,0,0,0,0,0,0.0,0,3,100.0
lightning_1.8.0,tests/tests_app/components/database/test_client_server.py,162,124,118,4,24,18,30,28,48,118.03910001730776,2.5,576.8825906469125,32.04903281371736,230.75303625876498,9,44.36930716615226
lightning_1.8.0,tests/tests_app/source_code/test_tar.py,125,83,85,8,62,48,96,70,144,393.1601712439863,6.193548387096774,5466.529575886918,303.6960875492732,882.6167544400753,17,47.92945904871013
lightning_1.8.0,tests/tests_app/source_code/test_local.py,390,146,282,5,128,155,291,133,446,907.6096404744368,5.68359375,17884.314183085105,993.5730101713948,3146.6559662335308,39,45.60755725309277
lightning_1.8.0,tests/tests_app/source_code/test_uploader.py,49,32,35,1,8,4,8,9,12,24.0,0.5,19.019550008653876,1.0566416671474377,38.03910001730775,7,65.19338596821838
lightning_1.8.0,tests/tests_app/source_code/test_copytree.py,107,63,76,4,38,23,46,42,69,207.42124551085624,2.4210526315789473,900.8008157841994,50.04448976578885,372.0699021717345,25,59.352761868587976
lightning_1.8.0,tests/tests_app/storage/test_path.py,722,518,529,7,185,151,287,192,438,1412.957054649921,5.42972972972973,18038.721818404258,1002.1512121335699,3322.2135753158664,179,9.144891081456485
lightning_1.8.0,tests/tests_app/storage/test_mount.py,42,27,27,1,9,5,10,10,15,28.529325012980813,0.5555555555555556,27.68273412406136,1.5379296735589643,49.82892142331044,6,56.0834770892891
lightning_1.8.0,tests/tests_app/storage/test_orchestrator.py,77,53,54,4,14,17,24,18,41,61.30296890880645,3.4285714285714284,586.1723144884621,32.56512858269234,170.9669250591348,18,66.21917133739909
lightning_1.8.0,tests/tests_app/storage/__init__.py,0,0,0,0,0,0,0,0,0,0,0,0,0.0,0,1,100.0
lightning_1.8.0,tests/tests_app/storage/test_drive.py,242,188,192,3,24,16,31,27,47,114.79398751947123,1.9375,432.9919431657609,24.055107953653383,223.47971260168305,32,29.638112796232075
lightning_1.8.0,tests/tests_app/storage/test_copier.py,134,102,96,4,17,12,22,21,34,77.48686830125578,2.588235294117647,386.523933204531,21.473551844696164,149.33879237447786,13,57.3414081979271
lightning_1.8.0,tests/tests_app/storage/test_payload.py,154,112,121,4,27,19,37,31,56,136.38196255841368,2.740740740740741,760.3773892682672,42.24318829268151,277.43499338166504,37,33.214776442800655
lightning_1.8.0,tests/tests_app/runners/test_multiprocess.py,83,59,57,2,5,4,8,7,12,13.60964047443681,1.6,53.901214503506004,2.9945119168614447,33.68825906469125,15,48.65772902210413
lightning_1.8.0,tests/tests_app/runners/__init__.py,0,0,0,0,0,0,0,0,0,0,0,0,0.0,0,1,100.0
lightning_1.8.0,tests/tests_app/runners/test_singleprocess.py,18,11,11,0,0,0,0,0,0,0,0,0,0.0,0,2,100.0
lightning_1.8.0,tests/tests_app/runners/test_runtime.py,45,22,36,1,2,1,2,3,3,2.0,0.5,2.3774437510817346,0.1320802083934297,4.754887502163469,2,65.70608916016936
lightning_1.8.0,tests/tests_app/runners/test_cloud.py,1096,512,964,6,43,28,56,49,84,248.83915945651714,3.9069767441860463,1842.6694260500888,102.37052366944937,471.6356269056775,39,28.770453613949236
lightning_1.8.0,tests/tests_app/core/test_lightning_app.py,1113,761,804,16,166,157,306,182,463,1288.2565456035895,14.74698795180723,51262.13633899137,2847.896463277298,3476.1089184119965,250,0.0
lightning_1.8.0,tests/tests_app/core/__init__.py,0,0,0,0,0,0,0,0,0,0,0,0,0.0,0,1,100.0
lightning_1.8.0,tests/tests_app/core/test_lightning_work.py,349,235,260,7,52,28,55,59,83,316.07434979774,3.701923076923077,1807.4986407919005,100.41659115510558,488.25937309703284,38,32.62730692442984
lightning_1.8.0,tests/tests_app/core/test_queues.py,214,144,158,3,38,21,41,41,62,204.1761330130197,1.618421052631579,537.5880472002304,29.866002622235026,332.1682242863212,26,46.32722842418772
lightning_1.8.0,tests/tests_app/core/test_lightning_api.py,562,374,423,11,99,75,144,110,219,694.3600531928917,8.0,11880.942218095204,660.0523454497336,1485.1177772619005,79,25.409935674593566
lightning_1.8.0,tests/tests_app/core/test_lightning_flow.py,782,471,633,11,122,110,209,133,319,883.6037029876825,9.422131147540984,21205.77904848483,1178.098836026935,2250.6350969248797,112,11.382877382063317
lightning_1.8.0,tests/tests_app/core/test_constants.py,9,7,6,1,2,1,2,3,3,2.0,0.5,2.3774437510817346,0.1320802083934297,4.754887502163469,2,76.55471099040834
lightning_1.8.0,tests/tests_app/core/lightning_app/__init__.py,0,0,0,0,0,0,0,0,0,0,0,0,0.0,0,1,100.0
lightning_1.8.0,tests/tests_app/core/lightning_app/test_configure_layout.py,238,150,178,9,41,29,56,50,85,248.18895720232226,6.146341463414634,2948.5707215847465,163.80948453248593,479.72777613085157,25,41.253123217361235
lightning_1.8.0,tests/tests_app/core/scripts/example_1.py,1,1,1,0,0,0,0,0,0,0,0,0,0.0,0,1,100.0
lightning_1.8.0,tests/tests_app/core/scripts/lightning_cli.py,60,44,43,1,2,1,2,3,3,2.0,0.5,2.3774437510817346,0.1320802083934297,4.754887502163469,17,57.12188780047866
lightning_1.8.0,tests/tests_app/core/scripts/lightning_overrides.py,55,38,38,1,2,1,2,3,3,2.0,0.5,2.3774437510817346,0.1320802083934297,4.754887502163469,4,60.25930083083444
lightning_1.8.0,tests/tests_app/core/scripts/registry.py,103,76,74,1,2,1,2,3,3,2.0,0.5,2.3774437510817346,0.1320802083934297,4.754887502163469,28,50.46457315535425
lightning_1.8.0,tests/tests_app/core/scripts/lightning_trainer.py,74,54,53,1,2,1,2,3,3,2.0,0.5,2.3774437510817346,0.1320802083934297,4.754887502163469,4,56.93026821868602
lightning_1.8.0,tests/tests_app/core/scripts/app_metadata.py,61,43,38,0,0,0,0,0,0,0,0,0,0.0,0,12,100.0
lightning_1.8.0,tests/tests_app/core/scripts/example_2.py,1,1,1,0,0,0,0,0,0,0,0,0,0.0,0,1,100.0
lightning_1.8.0,tests/tests_app/core/scripts/script_with_error.py,13,7,7,1,2,1,2,3,3,2.0,0.5,2.3774437510817346,0.1320802083934297,4.754887502163469,3,97.04976883877337
lightning_1.8.0,tests/tests_app/core/scripts/two_apps.py,10,6,6,0,0,0,0,0,0,0,0,0,0.0,0,2,100.0
lightning_1.8.0,tests/tests_app/core/scripts/empty.py,0,0,0,0,0,0,0,0,0,0,0,0,0.0,0,1,100.0
lightning_1.8.0,tests/tests_app/cli/test_cmd_clusters.py,135,57,113,3,8,4,8,11,12,28.75488750216347,1.5,62.26976913547136,3.4594316186372978,41.51317942364757,13,54.28184133743603
lightning_1.8.0,tests/tests_app/cli/test_cmd_react_ui_init.py,59,39,39,4,14,8,16,18,24,61.30296890880645,2.2857142857142856,228.75017150769253,12.708342861538474,100.07820003461549,10,67.95148916349142
lightning_1.8.0,tests/tests_app/cli/test_cmd_init.py,99,56,60,3,11,7,14,14,21,42.808635307173745,1.9090909090909092,152.64032005703666,8.480017780946481,79.95445336320968,12,74.44476338582784
lightning_1.8.0,tests/tests_app/cli/test_cmd_show_cluster_logs.py,40,25,24,2,8,6,12,10,18,26.0,1.5,89.69205856195879,4.9828921423310435,59.794705707972525,7,75.67913955768111
lightning_1.8.0,tests/tests_app/cli/test_cli.py,193,106,152,4,35,30,60,39,90,187.5249055930738,3.4285714285714284,1630.9241132489224,90.60689518049568,475.6861996976024,32,41.16136902352933
lightning_1.8.0,tests/tests_app/cli/test_cmd_apps.py,111,40,95,1,4,2,4,5,6,8.0,0.5,6.965784284662087,0.3869880158145604,13.931568569324174,3,56.638909029615625
lightning_1.8.0,tests/tests_app/cli/__init__.py,0,0,0,0,0,0,0,0,0,0,0,0,0.0,0,1,100.0
lightning_1.8.0,tests/tests_app/cli/test_cmd_pl_init.py,126,88,90,4,54,38,74,58,112,318.76392511682735,2.740740740740741,1798.183203245086,99.89906684694921,656.0938714542881,22,41.235411090624595
lightning_1.8.0,tests/tests_app/cli/test_cmd_show_logs.py,61,38,37,2,9,8,16,11,24,30.529325012980813,1.7777777777777777,147.60241572852468,8.200134207140259,83.02635884729514,9,71.06989647279568
lightning_1.8.0,tests/tests_app/cli/test_cloud_cli.py,223,146,171,1,18,9,18,19,27,75.05865002596161,0.5,57.3470214314884,3.185945635082689,114.6940428629768,24,39.75172893410036
lightning_1.8.0,tests/tests_app/cli/test_cmd_install.py,371,171,214,4,66,40,80,70,120,406.93001187765793,2.4242424242424243,1783.0641503839904,99.05911946577724,735.5139620333961,45,52.256481570107624
lightning_1.8.0,tests/tests_app/cli/test_run_app.py,133,57,105,2,6,3,6,8,9,17.509775004326936,1.0,27.0,1.5,27.0,5,66.82910647757751
lightning_1.8.0,tests/tests_app/cli/test_connect.py,182,106,146,3,26,17,32,29,49,126.96632017383187,1.8461538461538463,439.46043463615587,24.41446859089755,238.04106876125107,21,36.354141490664354
lightning_1.8.0,tests/tests_app/cli/test_cmd_ssh_keys.py,43,22,32,0,0,0,0,0,0,0,0,0,0.0,0,1,100.0
lightning_1.8.0,tests/tests_app/structures/__init__.py,0,0,0,0,0,0,0,0,0,0,0,0,0.0,0,1,100.0
lightning_1.8.0,tests/tests_app/structures/test_structures.py,499,254,409,8,100,78,146,108,224,688.3856189774725,5.84,8836.473634830163,490.91520193500907,1513.094800484617,84,23.723283426602546
lightning_1.8.0,tests/tests_app/utilities/test_dependency_caching.py,15,8,8,2,6,3,6,8,9,17.509775004326936,1.0,27.0,1.5,27.0,3,95.03176615475792
lightning_1.8.0,tests/tests_app/utilities/test_introspection.py,59,34,43,2,6,5,6,8,11,17.509775004326936,1.0,33.0,1.8333333333333333,33.0,11,67.11616377704757
lightning_1.8.0,tests/tests_app/utilities/test_secrets.py,49,19,44,1,2,1,2,3,3,2.0,0.5,2.3774437510817346,0.1320802083934297,4.754887502163469,3,66.96046125485263
lightning_1.8.0,tests/tests_app/utilities/test_tree.py,171,30,156,1,4,2,4,5,6,8.0,0.5,6.965784284662087,0.3869880158145604,13.931568569324174,6,58.96080936512373
lightning_1.8.0,tests/tests_app/utilities/test_commands.py,162,127,122,5,12,11,22,17,33,54.62919048309069,4.583333333333333,618.2287547391138,34.346041929950765,134.8862737612612,19,36.63808348765592
lightning_1.8.0,tests/tests_app/utilities/test_login.py,142,97,110,4,24,15,28,28,43,118.03910001730776,2.3333333333333335,482.3379438464463,26.796552435913682,206.71626164847697,24,52.72225157608074
lightning_1.8.0,tests/tests_app/utilities/test_app_helpers.py,85,60,64,2,8,6,9,10,15,26.0,1.125,56.05753660122424,3.1143075889569025,49.82892142331044,12,58.18413189781291
lightning_1.8.0,tests/tests_app/utilities/test_imports.py,40,30,28,0,0,0,0,0,0,0,0,0,0.0,0,1,100.0
lightning_1.8.0,tests/tests_app/utilities/test_tracer.py,27,19,19,0,0,0,0,0,0,0,0,0,0.0,0,2,100.0
lightning_1.8.0,tests/tests_app/utilities/__init__.py,0,0,0,0,0,0,0,0,0,0,0,0,0.0,0,1,100.0
lightning_1.8.0,tests/tests_app/utilities/test_component.py,78,53,58,3,21,14,26,24,40,96.99355338051744,1.8571428571428572,340.597214339286,18.922067463293665,183.39850002884629,17,57.526739262950954
lightning_1.8.0,tests/tests_app/utilities/test_network.py,5,3,3,0,0,0,0,0,0,0,0,0,0.0,0,2,100.0
lightning_1.8.0,tests/tests_app/utilities/test_load_app.py,84,24,75,1,2,1,2,3,3,2.0,0.5,2.3774437510817346,0.1320802083934297,4.754887502163469,3,64.74726792786996
lightning_1.8.0,tests/tests_app/utilities/test_git.py,29,13,20,1,8,4,8,9,12,24.0,0.5,19.019550008653876,1.0566416671474377,38.03910001730775,7,76.76230315527575
lightning_1.8.0,tests/tests_app/utilities/test_proxies.py,691,410,524,8,92,68,121,100,189,624.1676999572452,5.260869565217392,6606.015095824269,367.00083865690385,1255.688819867423,77,26.612334580710822
lightning_1.8.0,tests/tests_app/utilities/test_state.py,321,198,243,3,52,35,68,55,103,301.17775284550027,1.9615384615384615,1168.057022120963,64.89205678449794,595.4800504930399,56,33.0112886990863
lightning_1.8.0,tests/tests_app/utilities/test_cli_helpers.py,64,33,40,1,14,8,16,15,24,53.30296890880645,0.5714285714285714,53.58021388263111,2.9766785490350616,93.76537429460444,9,67.57258668875191
lightning_1.8.0,tests/tests_app/utilities/test_log_helpers.py,23,15,15,0,0,0,0,0,0,0,0,0,0.0,0,3,100.0
lightning_1.8.0,tests/tests_app/utilities/test_exceptions.py,85,40,68,1,10,5,10,11,15,33.219280948873624,0.5,25.945737139779734,1.4414298410988742,51.89147427955947,8,59.23776345654579
lightning_1.8.0,tests/tests_app/utilities/test_cloud.py,16,12,9,1,1,1,1,2,2,0.0,0.5,1.0,0.05555555555555555,2.0,3,73.94745434767408
lightning_1.8.0,tests/tests_app/utilities/test_app_logs.py,13,10,10,2,2,2,4,4,6,4.0,2.0,24.0,1.3333333333333333,12.0,3,70.22608591497008
lightning_1.8.0,tests/tests_app/utilities/test_logs_socket_api.py,36,15,26,1,6,3,6,7,9,15.509775004326936,0.5,12.63309714925922,0.701838730514401,25.26619429851844,4,63.986173530973204
lightning_1.8.0,tests/tests_app/utilities/packaging/test_docker.py,68,45,56,2,10,7,14,12,21,35.219280948873624,1.4,105.397897521202,5.855438751177889,75.28421251514429,8,63.21191146090645
lightning_1.8.0,tests/tests_app/utilities/packaging/test_build_spec.py,81,50,56,5,36,21,38,41,59,197.72694052636004,2.638888888888889,834.1410829412322,46.3411712745129,316.09556827246695,15,58.794950555641435
lightning_1.8.0,tests/tests_app/utilities/packaging/test_lightning_utils.py,65,40,42,2,8,4,8,10,12,26.0,1.0,39.863137138648355,2.2146187299249087,39.863137138648355,6,72.20714695267782
lightning_1.8.0,tests/tests_app/utilities/packaging/__init__.py,0,0,0,0,0,0,0,0,0,0,0,0,0.0,0,1,100.0
lightning_1.8.0,tests/tests_app/utilities/packaging/test_app_config.py,61,44,42,3,21,13,26,24,39,96.99355338051744,1.8571428571428572,332.0822839808038,18.449015776711324,178.81353752812512,10,56.22373765249746
lightning_1.8.0,tests/tests_app/utilities/packaging/test_cloud_compute.py,43,27,29,2,14,9,18,16,27,55.30296890880645,1.2857142857142858,138.85714285714286,7.714285714285714,108.0,10,64.1683662843875
lightning_1.8.0,tests/tests_app/utilities/packaging/projects/req/__init__.py,0,0,0,0,0,0,0,0,0,0,0,0,0.0,0,1,100.0
lightning_1.8.0,tests/tests_app/utilities/packaging/projects/req/app.py,12,8,8,1,2,1,2,3,3,2.0,0.5,2.3774437510817346,0.1320802083934297,4.754887502163469,2,75.28967674449181
lightning_1.8.0,tests/tests_app/utilities/packaging/projects/req/comp_req/__init__.py,0,0,0,0,0,0,0,0,0,0,0,0,0.0,0,1,100.0
lightning_1.8.0,tests/tests_app/utilities/packaging/projects/req/comp_req/a/a.py,8,5,5,0,0,0,0,0,0,0,0,0,0.0,0,2,100.0
lightning_1.8.0,tests/tests_app/utilities/packaging/projects/req/comp_req/a/__init__.py,0,0,0,0,0,0,0,0,0,0,0,0,0.0,0,1,100.0
lightning_1.8.0,tests/tests_app/utilities/packaging/projects/req/comp_req/b/__init__.py,0,0,0,0,0,0,0,0,0,0,0,0,0.0,0,1,100.0
lightning_1.8.0,tests/tests_app/utilities/packaging/projects/req/comp_req/b/b.py,10,7,7,0,0,0,0,0,0,0,0,0,0.0,0,3,100.0
lightning_1.8.0,tests/tests_app/utilities/packaging/projects/dock/__init__.py,0,0,0,0,0,0,0,0,0,0,0,0,0.0,0,1,100.0
lightning_1.8.0,tests/tests_app/utilities/packaging/projects/dock/app.py,12,8,8,1,2,1,2,3,3,2.0,0.5,2.3774437510817346,0.1320802083934297,4.754887502163469,2,75.28967674449181
lightning_1.8.0,tests/tests_app/utilities/packaging/projects/dock/compo/__init__.py,0,0,0,0,0,0,0,0,0,0,0,0,0.0,0,1,100.0
lightning_1.8.0,tests/tests_app/utilities/packaging/projects/dock/compo/a/a.py,14,9,9,0,0,0,0,0,0,0,0,0,0.0,0,3,100.0
lightning_1.8.0,tests/tests_app/utilities/packaging/projects/dock/compo/a/__init__.py,0,0,0,0,0,0,0,0,0,0,0,0,0.0,0,1,100.0
lightning_1.8.0,tests/tests_app/utilities/packaging/projects/dock/compo/b/__init__.py,0,0,0,0,0,0,0,0,0,0,0,0,0.0,0,1,100.0
lightning_1.8.0,tests/tests_app/utilities/packaging/projects/dock/compo/b/b.py,10,7,7,0,0,0,0,0,0,0,0,0,0.0,0,3,100.0
lightning_1.8.0,tests/tests_app/utilities/packaging/projects/no_req/__init__.py,0,0,0,0,0,0,0,0,0,0,0,0,0.0,0,1,100.0
lightning_1.8.0,tests/tests_app/utilities/packaging/projects/no_req/app.py,12,8,8,1,2,1,2,3,3,2.0,0.5,2.3774437510817346,0.1320802083934297,4.754887502163469,2,75.28967674449181
lightning_1.8.0,tests/tests_app/utilities/packaging/projects/no_req/comp/__init__.py,0,0,0,0,0,0,0,0,0,0,0,0,0.0,0,1,100.0
lightning_1.8.0,tests/tests_app/utilities/packaging/projects/no_req/comp/a/a.py,8,5,5,0,0,0,0,0,0,0,0,0,0.0,0,2,100.0
lightning_1.8.0,tests/tests_app/utilities/packaging/projects/no_req/comp/a/__init__.py,0,0,0,0,0,0,0,0,0,0,0,0,0.0,0,1,100.0
lightning_1.8.0,tests/tests_app/utilities/packaging/projects/no_req/comp/b/__init__.py,0,0,0,0,0,0,0,0,0,0,0,0,0.0,0,1,100.0
lightning_1.8.0,tests/tests_app/utilities/packaging/projects/no_req/comp/b/b.py,10,7,7,0,0,0,0,0,0,0,0,0,0.0,0,3,100.0
lightning_1.8.0,tests/tests_app/utilities/packaging/projects/dockerfile/__init__.py,0,0,0,0,0,0,0,0,0,0,0,0,0.0,0,1,100.0
lightning_1.8.0,tests/tests_app/utilities/packaging/projects/dockerfile/app.py,11,8,8,1,2,1,2,3,3,2.0,0.5,2.3774437510817346,0.1320802083934297,4.754887502163469,2,75.28967674449181
lightning_1.8.0,tests/tests_app/utilities/packaging/projects/dockerfile/comp_dockerfile/__init__.py,0,0,0,0,0,0,0,0,0,0,0,0,0.0,0,1,100.0
lightning_1.8.0,tests/tests_app/utilities/packaging/projects/dockerfile/comp_dockerfile/a/a.py,6,4,4,0,0,0,0,0,0,0,0,0,0.0,0,2,100.0
lightning_1.8.0,tests/tests_app/utilities/packaging/projects/dockerfile/comp_dockerfile/a/__init__.py,0,0,0,0,0,0,0,0,0,0,0,0,0.0,0,1,100.0
lightning_1.8.0,tests/tests_app/utilities/packaging/projects/dockerfile/comp_dockerfile/b/__init__.py,0,0,0,0,0,0,0,0,0,0,0,0,0.0,0,1,100.0
lightning_1.8.0,tests/tests_app/utilities/packaging/projects/dockerfile/comp_dockerfile/b/b.py,10,7,7,0,0,0,0,0,0,0,0,0,0.0,0,3,100.0
lightning_1.8.0,tests/tests_app/frontend/test_web.py,82,52,62,3,7,4,8,10,12,24.406371956566698,1.7142857142857142,68.33680652339717,3.796489251299843,39.863137138648355,7,58.02448922735173
lightning_1.8.0,tests/tests_app/frontend/__init__.py,0,0,0,0,0,0,0,0,0,0,0,0,0.0,0,1,100.0
lightning_1.8.0,tests/tests_app/frontend/conftest.py,73,36,48,0,0,0,0,0,0,0,0,0,0.0,0,1,100.0
lightning_1.8.0,tests/tests_app/frontend/test_stream_lit.py,94,51,70,2,12,7,14,14,21,45.01955000865388,1.1666666666666667,93.2801955904113,5.182233088356183,79.95445336320968,11,55.115606054559954
lightning_1.8.0,tests/tests_app/frontend/test_utils.py,42,25,22,1,20,10,20,21,30,86.43856189774725,0.5,65.88476134168141,3.6602645189823004,131.76952268336282,12,79.9573170559877
lightning_1.8.0,tests/tests_app/frontend/just_py/test_just_py.py,47,35,34,1,17,9,18,18,27,69.48686830125578,0.5294117647058824,59.60539855002835,3.3114110305571303,112.58797503894243,10,50.60815195243017
lightning_1.8.0,tests/tests_app/frontend/panel/__init__.py,0,0,0,0,0,0,0,0,0,0,0,0,0.0,0,1,100.0
lightning_1.8.0,tests/tests_app/frontend/panel/test_app_state_watcher.py,85,40,42,3,14,8,16,17,24,58.05785641096992,1.7142857142857142,168.1698997542997,9.342772208572207,98.09910819000817,10,78.98131114437395
lightning_1.8.0,tests/tests_app/frontend/panel/test_app_state_comm.py,39,25,18,1,4,2,4,5,6,8.0,0.5,6.965784284662087,0.3869880158145604,13.931568569324174,3,87.04442829854145
lightning_1.8.0,tests/tests_app/frontend/panel/test_panel_frontend.py,164,82,114,3,22,16,28,25,44,102.862383112184,1.9090909090909092,390.08391994107683,21.67132888561538,204.32967235008786,22,57.32558668312181
lightning_1.8.0,tests/tests_app/frontend/panel/app_panel.py,5,3,3,1,2,1,2,3,3,2.0,0.5,2.3774437510817346,0.1320802083934297,4.754887502163469,2,84.58174335197131
lightning_1.8.0,tests/tests_app/frontend/panel/test_panel_serve_render_fn.py,79,36,45,1,4,3,6,5,9,8.0,0.75,15.673014640489694,0.8707230355827608,20.89735285398626,5,81.11855234494047
lightning_1.8.0,tests/tests_app/frontend/utilities/__init__.py,0,0,0,0,0,0,0,0,0,0,0,0,0.0,0,1,100.0
lightning_1.8.0,tests/legacy/simple_classif_training.py,177,103,134,6,12,6,12,18,18,58.52932501298082,3.0,225.17595007788483,12.509775004326935,75.05865002596161,23,57.45502006376085
lightning_1.8.0,.actions/setup_tools.py,290,147,141,10,48,34,60,58,94,301.29748098348915,6.25,3441.5638346374485,191.19799081319158,550.6502135419918,43,56.54413647349778
lightning_1.8.0,.actions/assistant.py,236,180,185,10,38,22,38,48,60,232.64052645972987,5.0,1675.488750216347,93.08270834535261,335.0977500432694,53,38.8966090880701
lightning_1.8.0,examples/test_pl_examples.py,43,16,23,2,6,3,6,8,9,17.509775004326936,1.0,27.0,1.5,27.0,1,92.78551969774219
lightning_1.8.0,examples/app_works_on_default_machine/app_v2.py,53,29,34,1,1,1,1,2,2,0.0,0.5,1.0,0.05555555555555555,2.0,9,81.66300958408286
lightning_1.8.0,examples/app_argparse/app.py,28,19,19,1,4,2,4,5,6,8.0,0.5,6.965784284662087,0.3869880158145604,13.931568569324174,8,63.01898838291938
lightning_1.8.0,examples/pl_servable_module/production.py,126,92,94,3,6,3,6,9,9,20.264662506490406,1.5,42.793987519471216,2.377443751081734,28.529325012980813,16,53.52358198633109
lightning_1.8.0,examples/app_justpy/app.py,42,27,27,1,2,1,2,3,3,2.0,0.5,2.3774437510817346,0.1320802083934297,4.754887502163469,4,63.49692571872761
lightning_1.8.0,examples/pl_hpu/mnist_sample.py,75,39,49,4,7,5,8,11,13,27.651484454403228,2.2857142857142856,102.79453952522255,5.710807751401252,44.97261104228487,9,78.66646596435565
lightning_1.8.0,examples/app_pickle_or_not/app.py,55,41,41,3,6,4,8,9,12,20.264662506490406,2.0,76.0782000346155,4.226566668589751,38.03910001730775,12,52.1399629888593
lightning_1.8.0,examples/app_drive/app.py,51,30,30,0,0,0,0,0,0,0,0,0,0.0,0,6,100.0
lightning_1.8.0,examples/pl_bug_report/bug_report_model.py,66,41,48,1,2,1,2,3,3,2.0,0.5,2.3774437510817346,0.1320802083934297,4.754887502163469,11,58.59791387583891
lightning_1.8.0,examples/pl_domain_templates/imagenet.py,194,92,134,4,11,6,12,15,18,46.053747805010275,2.1818181818181817,153.43424884571635,8.52412493587313,70.32403072095333,15,68.11975554137193
lightning_1.8.0,examples/pl_domain_templates/generative_adversarial_net.py,248,115,129,4,10,6,11,14,17,41.219280948873624,2.2,142.3950740849544,7.9108374491641325,64.72503367497926,18,69.14076839642689
lightning_1.8.0,examples/pl_domain_templates/semantic_segmentation.py,433,202,225,7,30,32,56,37,88,166.8582023226588,6.533333333333333,2995.0883883456045,166.3937993525336,458.4318961753476,42,54.66746038061124
lightning_1.8.0,examples/pl_domain_templates/reinforce_learn_ppo.py,475,235,246,9,64,43,80,73,123,412.5293250129808,5.625,4282.584866675113,237.9213814819507,761.3484207422422,41,51.7131007803261
lightning_1.8.0,examples/pl_domain_templates/reinforce_learn_Qnet.py,406,179,184,9,22,13,24,31,37,126.63682062300134,4.909090909090909,899.8622025593615,49.9923445866312,183.3052634843144,33,59.449108596769314
lightning_1.8.0,examples/pl_domain_templates/computer_vision_fine_tuning.py,288,140,158,2,10,10,13,12,23,35.219280948873624,1.3,107.19037877156258,5.955021042864588,82.4541375165866,26,64.72920697725702
lightning_1.8.0,examples/pl_ipu/mnist_sample.py,84,45,45,4,7,5,8,11,13,27.651484454403228,2.2857142857142856,102.79453952522255,5.710807751401252,44.97261104228487,11,79.77126868590699
lightning_1.8.0,examples/convert_from_pt_to_pl/image_classifier_2_lite.py,164,73,91,6,20,13,26,26,39,101.94833690207419,3.9,714.9368811292602,39.71871561829224,183.31714900750262,13,70.68484930965134
lightning_1.8.0,examples/convert_from_pt_to_pl/image_classifier_3_lite_to_lightning_module.py,172,93,105,6,20,13,26,26,39,101.94833690207419,3.9,714.9368811292602,39.71871561829224,183.31714900750262,21,63.76199282101822
lightning_1.8.0,examples/convert_from_pt_to_pl/image_classifier_5_lightning_datamodule.py,94,56,57,2,4,2,4,6,6,10.0,1.0,15.509775004326936,0.861654166907052,15.509775004326936,13,78.24465431518355
lightning_1.8.0,examples/convert_from_pt_to_pl/image_classifier_1_pytorch.py,130,68,91,6,22,15,30,28,45,113.61727061434748,4.090909090909091,884.9903379242406,49.16612988468003,216.33097149259217,12,66.20382214072835
lightning_1.8.0,examples/convert_from_pt_to_pl/image_classifier_4_lightning_module.py,88,52,51,2,4,2,4,6,6,10.0,1.0,15.509775004326936,0.861654166907052,15.509775004326936,12,80.18438770486998
lightning_1.8.0,examples/pl_fault_tolerant/automatic.py,137,68,72,7,20,14,23,27,37,106.09004635215048,4.025,708.1216212596946,39.340090069983034,175.93083758004835,25,69.76937041775419
lightning_1.8.0,examples/app_v0/__init__.py,0,0,0,0,0,0,0,0,0,0,0,0,0.0,0,1,100.0
lightning_1.8.0,examples/app_v0/emulate_ui.py,19,13,11,0,0,0,0,0,0,0,0,0,0.0,0,1,100.0
lightning_1.8.0,examples/app_v0/app.py,49,39,35,1,4,2,4,5,6,8.0,0.5,6.965784284662087,0.3869880158145604,13.931568569324174,7,66.3737370581509
lightning_1.8.0,examples/pl_basics/autoencoder.py,193,100,120,4,9,8,12,13,20,36.52932501298081,2.6666666666666665,197.3567849675249,10.964265831529161,74.00879436282185,23,67.55907945365709
lightning_1.8.0,examples/pl_basics/profiler_example.py,116,60,72,2,6,3,6,8,9,17.509775004326936,1.0,27.0,1.5,27.0,12,76.2086026035547
lightning_1.8.0,examples/pl_basics/backbone_image_classifier.py,136,80,77,4,6,4,7,10,11,23.509775004326936,2.3333333333333335,85.26282110210897,4.736823394561609,36.541209043760986,18,73.40886728531348
lightning_1.8.0,examples/app_mount/app.py,35,19,26,1,2,1,2,3,3,2.0,0.5,2.3774437510817346,0.1320802083934297,4.754887502163469,7,66.42244955894618
lightning_1.8.0,examples/app_multi_node/train.py,7,6,6,1,2,1,2,3,3,2.0,0.5,2.3774437510817346,0.1320802083934297,4.754887502163469,2,78.01508585192973
lightning_1.8.0,examples/app_multi_node/app.py,11,4,10,0,0,0,0,0,0,0,0,0,0.0,0,1,100.0
lightning_1.8.0,examples/app_multi_node/bare/multi_node.py,36,24,26,0,0,0,0,0,0,0,0,0,0.0,0,8,100.0
lightning_1.8.0,examples/app_hpo/objective.py,63,39,55,2,3,2,3,5,5,6.754887502163469,1.0,11.60964047443681,0.6449800263576005,11.60964047443681,7,56.89517837737823
lightning_1.8.0,examples/app_hpo/utils.py,54,39,38,6,15,9,15,21,24,74.11313393845472,3.0,316.2468544400708,17.569269691115046,105.41561814669026,13,73.17620064119765
lightning_1.8.0,examples/app_hpo/pl_script.py,43,25,34,0,0,0,0,0,0,0,0,0,0.0,0,3,100.0
lightning_1.8.0,examples/app_hpo/download_data.py,5,4,4,0,0,0,0,0,0,0,0,0,0.0,0,1,100.0
lightning_1.8.0,examples/app_hpo/hyperplot.py,34,24,24,2,3,2,3,5,5,6.754887502163469,1.0,11.60964047443681,0.6449800263576005,11.60964047443681,5,61.76373195378966
lightning_1.8.0,examples/app_hpo/app_wi_ui.py,61,39,49,9,15,10,17,24,27,87.1326839471086,5.1,631.3493363493033,35.07496313051685,123.79398751947124,11,49.15993193516873
lightning_1.8.0,examples/app_hpo/app_wo_ui.py,58,35,46,7,13,8,14,20,22,67.75720079023742,3.769230769230769,358.38757586835203,19.910420881575114,95.08241808752197,11,50.98753930847126
lightning_1.8.0,examples/app_template_streamlit_ui/app.py,48,33,32,2,3,2,3,5,5,6.754887502163469,1.0,11.60964047443681,0.6449800263576005,11.60964047443681,9,58.208790173602374
lightning_1.8.0,examples/app_commands_and_api/command.py,20,13,12,0,0,0,0,0,0,0,0,0,0.0,0,2,100.0
lightning_1.8.0,examples/app_commands_and_api/app.py,53,34,36,1,2,1,2,3,3,2.0,0.5,2.3774437510817346,0.1320802083934297,4.754887502163469,10,60.50599983012427
lightning_1.8.0,examples/app_dag/processing.py,14,9,11,0,0,0,0,0,0,0,0,0,0.0,0,1,100.0
lightning_1.8.0,examples/app_dag/app.py,137,76,93,3,4,3,4,7,7,12.75488750216347,1.5,29.47722668160484,1.6376237045336022,19.651484454403228,16,68.2169558842925
lightning_1.8.0,examples/pl_loops/kfold.py,316,178,175,5,12,6,12,17,18,54.62919048309069,2.5,183.93582785626532,10.218657103125851,73.57433114250613,43,60.87413148768477
lightning_1.8.0,examples/pl_loops/yielding_training_step.py,302,131,148,6,10,6,10,16,16,48.72905595320056,3.0,192.0,10.666666666666666,64.0,25,66.9038359017015
lightning_1.8.0,examples/pl_loops/mnist_lite.py,191,123,141,8,23,14,28,31,42,128.0419249893113,4.869565217391305,1013.2408453939072,56.29115807743929,208.0762450362488,26,51.888435557678235
lightning_1.8.0,examples/app_boring/__init__.py,0,0,0,0,0,0,0,0,0,0,0,0,0.0,0,1,100.0
lightning_1.8.0,examples/app_boring/app_dynamic.py,67,36,46,3,9,5,10,12,15,33.28421251514428,1.6666666666666667,89.62406251802892,4.9791145843349405,53.77443751081735,12,70.77647749152675
lightning_1.8.0,examples/app_boring/app.py,57,32,42,1,4,2,4,5,6,8.0,0.5,6.965784284662087,0.3869880158145604,13.931568569324174,9,73.32340937155895
lightning_1.8.0,examples/app_boring/scripts/serve.py,29,22,22,3,7,4,7,10,11,24.406371956566698,1.5,54.81181356564148,3.0451007536467487,36.541209043760986,4,71.7369417938804
lightning_1.8.0,examples/app_payload/app.py,31,21,21,1,2,1,2,3,3,2.0,0.5,2.3774437510817346,0.1320802083934297,4.754887502163469,7,65.47429047788003
lightning_1.8.0,examples/app_components/__init__.py,0,0,0,0,0,0,0,0,0,0,0,0,0.0,0,1,100.0
lightning_1.8.0,examples/app_components/python/component_popen.py,7,5,5,2,4,2,4,6,6,10.0,1.0,15.509775004326936,0.861654166907052,15.509775004326936,2,76.14705226402761
lightning_1.8.0,examples/app_components/python/__init__.py,0,0,0,0,0,0,0,0,0,0,0,0,0.0,0,1,100.0
lightning_1.8.0,examples/app_components/python/pl_script.py,65,50,47,1,2,1,2,3,3,2.0,0.5,2.3774437510817346,0.1320802083934297,4.754887502163469,13,65.15244251278978
lightning_1.8.0,examples/app_components/python/pytorch_lightning_script.py,65,50,47,1,2,1,2,3,3,2.0,0.5,2.3774437510817346,0.1320802083934297,4.754887502163469,13,65.15244251278978
lightning_1.8.0,examples/app_components/python/component_tracer.py,53,33,32,3,6,3,6,9,9,20.264662506490406,1.5,42.793987519471216,2.377443751081734,28.529325012980813,4,81.30488495650488
lightning_1.8.0,examples/app_components/python/app.py,24,18,18,3,5,3,5,8,8,16.36452797660028,1.5,36.0,2.0,24.0,7,62.01175298495485
lightning_1.8.0,examples/app_components/serve/gradio/app.py,53,38,37,0,0,0,0,0,0,0,0,0,0.0,0,8,100.0
lightning_1.8.0,examples/pl_integrations/dali_image_classifier.py,204,127,147,8,17,10,18,25,28,93.48686830125578,4.235294117647059,550.7067105050497,30.594817250280542,130.02797331369229,28,53.51038416536569
lightning_1.8.0,examples/app_layout/__init__.py,0,0,0,0,0,0,0,0,0,0,0,0,0.0,0,1,100.0
lightning_1.8.0,examples/app_layout/app.py,100,56,62,0,0,0,0,0,0,0,0,0,0.0,0,18,100.0
lightning_1.8.0,requirements/collect_env_details.py,86,47,51,6,33,24,48,39,72,181.9747809431559,4.363636363636363,1660.5772789443572,92.25429327468652,380.5489597580819,13,70.52237607369165
lightning_1.8.0,requirements/pytorch/adjust-versions.py,92,44,70,3,10,7,11,13,18,37.974168451037094,1.65,109.90305962879044,6.105725534932803,66.60791492653966,11,69.6822272996264
lightning_1.8.0,requirements/pytorch/check-avail-strategies.py,7,5,5,0,0,0,0,0,0,0,0,0,0.0,0,2,100.0
lightning_1.8.0,requirements/pytorch/check-avail-extras.py,5,5,5,0,0,0,0,0,0,0,0,0,0.0,0,1,100.0
