Project,Files,LOC,LLOC,SLOC,h1,h2,N1,N2,N,Length,Calculated_length,Difficulty,Effort,Time,Halstead_Volume,Cyclomatic_Complexity,Maintainabilty_Index
jax_0.2.21,./conftest.py,26,10,9,0,0,0,0,0,0,0,0,0,0.0,0,1,100.0
jax_0.2.21,./setup.py,72,11,50,0,0,0,0,0,0,0,0,0,0.0,0,2,100.0
jax_0.2.21,docs/autodidax.py,2873,1732,1622,20,409,261,485,429,746,3634.9049883709226,11.858190709046454,77358.63889353814,4297.702160752119,6523.646042774661,350,0.0
jax_0.2.21,docs/conf.py,282,41,113,0,0,0,0,0,0,0,0,0,0.0,0,1,100.0
jax_0.2.21,docs/sphinxext/jax_extensions.py,48,21,20,2,7,5,8,9,13,21.651484454403228,1.1428571428571428,47.09602859285721,2.6164460329365116,41.20902501875006,3,85.08776114584734
jax_0.2.21,build/build_wheel.py,257,155,196,9,25,16,29,34,45,144.62572975734892,5.22,1195.0450214097048,66.39139007831693,228.9358278562653,22,52.129971153942826
jax_0.2.21,build/build.py,521,248,411,18,95,60,113,113,173,699.1949328174017,10.705263157894738,12631.043229750429,701.7246238750238,1179.8909604978276,63,34.61303510488141
jax_0.2.21,tests/x64_context_test.py,160,113,116,6,16,11,19,22,30,79.50977500432694,3.5625,476.60175424186116,26.477875235658953,133.78294855911892,17,58.38398270806981
jax_0.2.21,tests/lax_autodiff_test.py,1074,445,955,16,114,67,131,130,198,842.9494616147806,9.192982456140351,12782.187812935581,710.1215451630878,1390.4288269796339,81,23.038589277700854
jax_0.2.21,tests/lax_numpy_indexing_test.py,1162,514,1005,14,79,113,150,93,263,551.3016480147976,13.291139240506329,22858.084882120038,1269.8936045622243,1719.7987673214125,74,20.668676203382002
jax_0.2.21,tests/metadata_test.py,115,78,80,2,22,21,32,24,53,100.10749561002054,1.4545454545454546,353.4589273283219,19.636607073795663,243.00301253822133,17,64.89295780110568
jax_0.2.21,tests/jet_test.py,414,387,334,14,88,54,97,102,151,621.7329513488886,7.715909090909091,7774.057930534039,431.89210725189105,1007.5362266376958,112,22.285508361314818
jax_0.2.21,tests/sharded_jit_test.py,537,350,400,10,116,87,174,126,261,828.7450763836719,7.5,13658.025450251087,758.7791916806159,1821.0700600334783,52,30.62756967552422
jax_0.2.21,tests/multibackend_test.py,194,131,144,4,24,13,26,28,39,118.03910001730776,2.1666666666666665,406.2214909138675,22.567860606325972,187.48684196024655,18,57.700725309490934
jax_0.2.21,tests/xla_bridge_test.py,88,49,59,7,12,7,12,19,19,62.67103446305711,3.5,282.4871796439984,15.693732202444355,80.71062275542812,10,72.59575073415293
jax_0.2.21,tests/core_test.py,516,382,390,9,124,88,173,133,261,890.8496675009535,6.278225806451613,11560.905283434142,642.2725157463412,1841.4287156658106,76,25.497927055530056
jax_0.2.21,tests/debug_nans_test.py,226,153,158,4,28,15,30,32,45,142.6059378176129,2.142857142857143,482.1428571428571,26.785714285714285,225.0,33,52.21694917863739
jax_0.2.21,tests/scipy_stats_test.py,584,364,438,9,32,21,38,41,59,188.52932501298082,5.34375,1689.1356929559952,93.84087183088862,316.09556827246695,36,40.46734752388127
jax_0.2.21,tests/djax_test.py,175,125,127,2,4,3,4,6,7,10.0,1.0,18.094737505048094,1.0052631947248942,18.094737505048094,15,63.538822535600715
jax_0.2.21,tests/callback_test.py,294,206,221,8,59,46,91,67,137,371.07593991234864,6.169491525423729,5127.181961860139,284.8434423255633,831.0542190927148,15,41.14830949880618
jax_0.2.21,tests/xla_interpreter_test.py,37,15,16,1,8,4,8,9,12,24.0,0.5,19.019550008653876,1.0566416671474377,38.03910001730775,6,90.43301638216766
jax_0.2.21,tests/image_test.py,387,162,325,4,10,6,10,14,16,41.219280948873624,2.0,121.83535750584332,6.768630972546851,60.91767875292166,18,52.19763345034441
jax_0.2.21,tests/util_test.py,68,33,30,4,11,6,11,15,17,46.053747805010275,2.0,132.83428025068963,7.379682236149424,66.41714012534482,3,80.27752966989802
jax_0.2.21,tests/dtypes_test.py,378,195,302,5,40,25,47,45,72,224.4867642699313,2.9375,1161.5269298737262,64.52927388187368,395.4134229357366,48,40.59800706853676
jax_0.2.21,tests/errors_test.py,383,250,294,5,19,12,24,24,36,92.32026322986493,3.1578947368421053,521.2378421872473,28.95765789929152,165.05865002596164,28,40.738352577395084
jax_0.2.21,tests/api_test.py,6099,4547,4696,20,989,781,1523,1009,2304,9926.817178838508,15.399393326592518,354046.66502851906,19669.259168251057,22990.948897781047,533,0.0
jax_0.2.21,tests/generated_fun_test.py,285,209,208,11,38,24,44,49,68,237.47499331586653,6.368421052631579,2431.4648735463124,135.08138186368402,381.8002693998342,34,44.258264021728294
jax_0.2.21,tests/infeed_test.py,119,80,85,4,18,10,20,22,30,83.05865002596161,2.2222222222222223,297.2954412424865,16.51641340236036,133.78294855911892,7,65.01268466873115
jax_0.2.21,tests/sparsify_test.py,342,219,232,7,41,25,49,48,74,239.31111664374467,4.182926829268292,1728.7502218695658,96.04167899275366,413.2872250533656,24,47.74393315235424
jax_0.2.21,tests/xmap_test.py,1398,949,1081,21,189,136,261,210,397,1521.5024840561366,14.5,44407.05432244503,2467.0585734691686,3062.5554705134505,171,7.192536313234278
jax_0.2.21,tests/compilation_cache_test.py,281,229,238,6,30,19,38,36,57,162.7164928725825,3.8,1119.8057553124047,62.21143085068915,294.6857250822118,28,41.54981975457329
jax_0.2.21,tests/jax_to_hlo_test.py,76,27,39,4,12,6,12,16,18,51.01955000865388,2.0,144.0,8.0,72.0,5,84.33538277509038
jax_0.2.21,tests/lax_numpy_vectorize_test.py,214,118,165,4,13,9,16,17,25,56.105716335834195,2.4615384615384617,251.53617484617476,13.974231935898597,102.1865710312585,18,54.376767424124544
jax_0.2.21,tests/loops_test.py,488,376,371,10,98,90,176,108,266,681.460845672164,8.979591836734693,16134.531290881885,896.362849493438,1796.8000755754829,35,34.126240878273876
jax_0.2.21,tests/api_util_test.py,71,36,48,3,11,8,16,14,24,42.808635307173745,2.1818181818181817,199.36694864592542,11.075941591440301,91.37651812938249,12,76.47242976250509
jax_0.2.21,tests/nn_test.py,250,137,185,5,25,15,25,30,40,127.70604521880493,2.5,490.6890595608519,27.260503308936215,196.27562382434076,38,51.018557949457936
jax_0.2.21,tests/sparse_test.py,1222,718,1014,12,155,112,215,167,327,1170.8188328261608,8.32258064516129,20094.632139963418,1116.36845222019,2414.4713036390153,89,14.779283759345098
jax_0.2.21,tests/lax_vmap_test.py,756,288,673,10,43,24,47,53,71,266.54866540106383,5.465116279069767,2222.566343822953,123.47590799016406,406.6823522739872,55,34.16571110161099
jax_0.2.21,tests/file_system_cache_test.py,150,111,111,3,8,5,10,11,15,28.75488750216347,1.875,97.296514274174,5.405361904120777,51.89147427955947,18,63.06034505012778
jax_0.2.21,tests/optimizers_test.py,314,251,231,5,33,24,48,38,72,178.07464641326578,3.6363636363636362,1374.0028398834113,76.33349110463396,377.85078096793814,31,44.748706601409594
jax_0.2.21,tests/lax_test.py,2675,1213,2343,13,216,169,319,229,488,1723.1614168031435,9.599537037037036,36723.33082710222,2040.1850459501231,3825.531448591309,217,0.0
jax_0.2.21,tests/pickle_test.py,81,47,48,3,6,5,10,9,15,20.264662506490406,2.5,118.87218755408671,6.604010419671484,47.548875021634686,5,77.89658291951777
jax_0.2.21,tests/lax_scipy_test.py,629,372,497,16,142,90,167,158,257,1079.2640909696647,9.408450704225352,17660.33610878947,981.1297838216373,1877.0716522815155,56,29.508099186167694
jax_0.2.21,tests/pmap_test.py,2504,1854,1949,20,552,389,756,572,1145,5114.344062039297,13.695652173913043,143640.72149532806,7980.040083073782,10488.052680611256,261,0.0
jax_0.2.21,tests/random_test.py,1140,763,895,17,232,159,295,249,454,1892.5384591708523,10.808189655172415,39059.07758394812,2169.9487546637847,3613.8408771589084,150,7.630593198887228
jax_0.2.21,tests/masking_test.py,830,553,649,14,137,97,181,151,278,1025.7333642743986,9.248175182481752,18609.88574973369,1033.8825416518716,2012.276517532372,102,18.339789803536835
jax_0.2.21,tests/pjit_test.py,696,503,565,5,171,110,220,176,330,1280.0624205199256,3.216374269005848,7917.466893465903,439.85927185921685,2461.612434150308,54,27.253250007120265
jax_0.2.21,tests/lax_scipy_sparse_test.py,476,276,381,9,72,47,82,81,129,472.76392511682724,5.125,4191.433333157098,232.85740739761656,817.8406503721167,32,38.11473628375056
jax_0.2.21,tests/scipy_optimize_test.py,238,126,166,8,80,59,115,88,174,529.7542475909889,5.75,6462.661334446617,359.0367408025898,1123.9411016428899,12,50.470510168408936
jax_0.2.21,tests/lax_control_flow_test.py,2773,2081,2163,17,452,388,723,469,1111,4056.207759312921,13.596238938053098,134037.11312287094,7446.506284603941,9858.396409004583,187,0.0
jax_0.2.21,tests/array_interoperability_test.py,228,142,180,6,53,32,58,59,90,319.0895590961765,3.2830188679245285,1738.154531188801,96.56414062160006,529.4378744425658,37,45.46678632723379
jax_0.2.21,tests/lax_numpy_test.py,5889,3428,5128,21,688,485,878,709,1363,6577.5088171133975,13.399709302325581,172951.68000813617,9608.426667118676,12907.121796897462,556,0.0
jax_0.2.21,tests/jax_jit_test.py,209,133,138,3,17,12,24,20,36,74.24175580341925,2.1176470588235294,329.4834594690601,18.304636637170006,155.58941141594505,21,59.55255403170436
jax_0.2.21,tests/jaxpr_util_test.py,90,49,56,5,20,11,21,25,32,98.04820237218406,2.625,390.08391994107683,21.67132888561538,148.60339807279118,19,71.04878688781572
jax_0.2.21,tests/host_callback_test.py,2890,1440,2277,16,349,298,580,365,878,3012.032045947169,13.29512893982808,99358.73745339828,5519.929858522127,7473.318830007759,186,0.0
jax_0.2.21,tests/profiler_test.py,189,126,141,2,22,11,22,24,33,100.10749561002054,1.0,151.30376252379818,8.405764584655454,151.30376252379818,16,58.47930489660207
jax_0.2.21,tests/polynomial_test.py,142,70,91,3,11,7,14,14,21,42.808635307173745,1.9090909090909092,152.64032005703666,8.480017780946481,79.95445336320968,7,72.16747072396456
jax_0.2.21,tests/multi_device_test.py,221,132,132,7,25,15,30,32,45,135.74788919877133,4.2,945.0,52.5,225.0,16,61.51819586068666
jax_0.2.21,tests/batching_test.py,1252,886,1007,11,211,165,280,222,445,1667.2056766222265,7.298578199052133,25315.228403837573,1406.4015779909762,3468.5150605257973,115,7.978905146475138
jax_0.2.21,tests/host_callback_to_tf_test.py,252,135,152,4,39,25,50,43,75,214.1306865356277,2.5641025641025643,1043.5124528273266,57.97291404596259,406.96985660265733,10,59.06943272913278
jax_0.2.21,tests/scipy_fft_test.py,85,51,60,4,18,11,20,22,31,83.05865002596161,2.2222222222222223,307.20528928390274,17.066960515772376,138.24238017775622,9,71.17056797761481
jax_0.2.21,tests/stax_test.py,262,140,212,3,9,5,9,12,14,33.28421251514428,1.5,75.28421251514428,4.182456250841349,50.18947501009619,27,52.957504580915675
jax_0.2.21,tests/fft_test.py,414,260,348,13,68,48,87,81,135,462.0531895408573,8.316176470588236,7117.647041841464,395.4248356578591,855.8797503894244,52,36.50465446122101
jax_0.2.21,tests/linalg_test.py,1444,845,1214,17,355,271,464,372,735,3076.931569410432,11.109859154929577,69728.6059943448,3873.811444130267,6276.281726164403,148,5.520595842353329
jax_0.2.21,tests/scipy_signal_test.py,110,54,80,2,6,3,6,8,9,17.509775004326936,1.0,27.0,1.5,27.0,5,73.19554467017511
jax_0.2.21,tests/lax_numpy_einsum_test.py,354,251,282,4,12,6,12,16,18,51.01955000865388,2.0,144.0,8.0,72.0,49,44.368496559022795
jax_0.2.21,tests/scipy_ndimage_test.py,154,83,110,8,31,18,33,39,51,177.58008562199316,4.258064516129032,1147.7847657219565,63.76582031788647,269.55551316197466,14,61.836811760787086
jax_0.2.21,tests/tree_util_test.py,383,267,300,9,34,23,43,43,66,201.50306161549238,5.6911764705882355,2038.2007994794262,113.23337774885701,358.13347381033844,54,36.48729031504184
jax_0.2.21,tests/custom_object_test.py,361,264,266,7,24,19,36,31,55,129.690584471711,5.25,1430.5241846242104,79.47356581245613,272.4807970712782,43,41.073007362986345
jax_0.2.21,tests/ode_test.py,254,170,169,7,85,52,93,92,145,564.4497140261079,3.8294117647058825,3622.3037108353046,201.23909504640582,945.9164836282669,23,48.647610220230895
jax_0.2.21,tests/heap_profiler_test.py,43,17,17,1,2,1,2,3,3,2.0,0.5,2.3774437510817346,0.1320802083934297,4.754887502163469,3,94.47618306454243
jax_0.2.21,tests/third_party/scipy/line_search_test.py,169,112,113,11,88,62,113,99,175,606.4837302450925,7.0625,8193.470447629643,455.19280264609125,1160.1374085139316,18,53.801028875851415
jax_0.2.21,tests/benchmarks/xla.py,43,12,22,1,1,1,1,2,2,0.0,0.5,1.0,0.05555555555555555,2.0,1,100.0
jax_0.2.21,benchmarks/pmap_benchmark.py,156,112,94,3,10,5,10,13,15,37.974168451037094,1.5,83.25989365817458,4.625549647676365,55.506595772116384,11,68.53417642934342
jax_0.2.21,benchmarks/benchmark.py,164,91,101,13,50,30,59,63,89,330.2985258245704,7.67,4080.270594178748,226.6816996765971,531.9779131914926,21,62.98086431292061
jax_0.2.21,benchmarks/api_benchmark.py,327,232,230,4,32,19,38,36,57,168.0,2.375,699.8785970702529,38.882144281680716,294.6857250822118,33,41.43075741602804
jax_0.2.21,jax/errors.py,24,1,9,0,0,0,0,0,0,0,0,0,0.0,0,1,100.0
jax_0.2.21,jax/flatten_util.py,16,1,1,0,0,0,0,0,0,0,0,0,0.0,0,1,100.0
jax_0.2.21,jax/jaxpr_util.py,123,89,85,7,20,13,25,27,38,106.09004635215048,4.375,790.5000472346768,43.91666929081538,180.68572508221183,17,60.57140149135734
jax_0.2.21,jax/linear_util.py,312,166,155,5,35,19,38,40,57,191.13454606751063,2.7142857142857144,823.3783038232878,45.74323910129377,303.3499014085797,34,58.85773901302088
jax_0.2.21,jax/random.py,117,3,34,0,0,0,0,0,0,0,0,0,0.0,0,1,100.0
jax_0.2.21,jax/cloud_tpu_init.py,16,1,1,0,0,0,0,0,0,0,0,0,0.0,0,1,100.0
jax_0.2.21,jax/dtypes.py,26,1,11,0,0,0,0,0,0,0,0,0,0.0,0,1,100.0
jax_0.2.21,jax/api_util.py,26,1,10,0,0,0,0,0,0,0,0,0,0.0,0,1,100.0
jax_0.2.21,jax/core.py,2108,1572,1528,21,382,256,495,403,751,3368.81647818801,13.606020942408376,88434.12444885826,4913.0069138254585,6499.631657424504,495,0.0
jax_0.2.21,jax/__init__.py,139,34,108,0,0,0,0,0,0,0,0,0,0.0,0,2,100.0
jax_0.2.21,jax/util.py,31,2,16,0,0,0,0,0,0,0,0,0,0.0,0,1,100.0
jax_0.2.21,jax/config.py,18,1,1,0,0,0,0,0,0,0,0,0,0.0,0,1,100.0
jax_0.2.21,jax/custom_derivatives.py,29,1,14,0,0,0,0,0,0,0,0,0,0.0,0,1,100.0
jax_0.2.21,jax/prng.py,23,1,7,0,0,0,0,0,0,0,0,0,0.0,0,1,100.0
jax_0.2.21,jax/version.py,16,2,2,0,0,0,0,0,0,0,0,0,0.0,0,1,100.0
jax_0.2.21,jax/test_util.py,1167,789,838,16,225,137,257,241,394,1822.1007680238333,9.137777777777778,28488.652387839058,1582.7029104355033,3117.678398474605,144,11.162111375617949
jax_0.2.21,jax/tree_util.py,58,2,20,0,0,0,0,0,0,0,0,0,0.0,0,1,100.0
jax_0.2.21,jax/dlpack.py,16,1,1,0,0,0,0,0,0,0,0,0,0.0,0,1,100.0
jax_0.2.21,jax/abstract_arrays.py,22,2,5,0,0,0,0,0,0,0,0,0,0.0,0,1,100.0
jax_0.2.21,jax/profiler.py,29,1,14,0,0,0,0,0,0,0,0,0,0.0,0,1,100.0
jax_0.2.21,jax/ops/__init__.py,27,1,12,0,0,0,0,0,0,0,0,0,0.0,0,1,100.0
jax_0.2.21,jax/nn/__init__.py,45,4,27,0,0,0,0,0,0,0,0,0,0.0,0,1,100.0
jax_0.2.21,jax/nn/initializers.py,39,2,19,0,0,0,0,0,0,0,0,0,0.0,0,1,100.0
jax_0.2.21,jax/scipy/special.py,49,1,33,0,0,0,0,0,0,0,0,0,0.0,0,1,100.0
jax_0.2.21,jax/scipy/signal.py,23,1,7,0,0,0,0,0,0,0,0,0,0.0,0,1,100.0
jax_0.2.21,jax/scipy/linalg.py,42,2,25,0,0,0,0,0,0,0,0,0,0.0,0,1,100.0
jax_0.2.21,jax/scipy/__init__.py,22,7,7,0,0,0,0,0,0,0,0,0,0.0,0,1,100.0
jax_0.2.21,jax/scipy/ndimage.py,19,1,3,0,0,0,0,0,0,0,0,0,0.0,0,1,100.0
jax_0.2.21,jax/scipy/fft.py,20,1,4,0,0,0,0,0,0,0,0,0,0.0,0,1,100.0
jax_0.2.21,jax/scipy/optimize/__init__.py,20,1,4,0,0,0,0,0,0,0,0,0,0.0,0,1,100.0
jax_0.2.21,jax/scipy/sparse/linalg.py,20,1,5,0,0,0,0,0,0,0,0,0,0.0,0,1,100.0
jax_0.2.21,jax/scipy/sparse/__init__.py,16,1,1,0,0,0,0,0,0,0,0,0,0.0,0,1,100.0
jax_0.2.21,jax/scipy/stats/norm.py,23,1,7,0,0,0,0,0,0,0,0,0,0.0,0,1,100.0
jax_0.2.21,jax/scipy/stats/nbinom.py,20,1,4,0,0,0,0,0,0,0,0,0,0.0,0,1,100.0
jax_0.2.21,jax/scipy/stats/laplace.py,21,1,5,0,0,0,0,0,0,0,0,0,0.0,0,1,100.0
jax_0.2.21,jax/scipy/stats/chi2.py,20,1,4,0,0,0,0,0,0,0,0,0,0.0,0,1,100.0
jax_0.2.21,jax/scipy/stats/betabinom.py,20,1,4,0,0,0,0,0,0,0,0,0,0.0,0,1,100.0
jax_0.2.21,jax/scipy/stats/beta.py,20,1,4,0,0,0,0,0,0,0,0,0,0.0,0,1,100.0
jax_0.2.21,jax/scipy/stats/__init__.py,33,18,18,0,0,0,0,0,0,0,0,0,0.0,0,1,100.0
jax_0.2.21,jax/scipy/stats/gamma.py,20,1,4,0,0,0,0,0,0,0,0,0,0.0,0,1,100.0
jax_0.2.21,jax/scipy/stats/logistic.py,24,1,8,0,0,0,0,0,0,0,0,0,0.0,0,1,100.0
jax_0.2.21,jax/scipy/stats/dirichlet.py,20,1,4,0,0,0,0,0,0,0,0,0,0.0,0,1,100.0
jax_0.2.21,jax/scipy/stats/bernoulli.py,20,1,4,0,0,0,0,0,0,0,0,0,0.0,0,1,100.0
jax_0.2.21,jax/scipy/stats/geom.py,20,1,4,0,0,0,0,0,0,0,0,0,0.0,0,1,100.0
jax_0.2.21,jax/scipy/stats/uniform.py,20,1,4,0,0,0,0,0,0,0,0,0,0.0,0,1,100.0
jax_0.2.21,jax/scipy/stats/cauchy.py,20,1,4,0,0,0,0,0,0,0,0,0,0.0,0,1,100.0
jax_0.2.21,jax/scipy/stats/expon.py,20,1,4,0,0,0,0,0,0,0,0,0,0.0,0,1,100.0
jax_0.2.21,jax/scipy/stats/t.py,20,1,4,0,0,0,0,0,0,0,0,0,0.0,0,1,100.0
jax_0.2.21,jax/scipy/stats/poisson.py,21,1,5,0,0,0,0,0,0,0,0,0,0.0,0,1,100.0
jax_0.2.21,jax/scipy/stats/multivariate_normal.py,20,1,4,0,0,0,0,0,0,0,0,0,0.0,0,1,100.0
jax_0.2.21,jax/scipy/stats/pareto.py,20,1,4,0,0,0,0,0,0,0,0,0,0.0,0,1,100.0
jax_0.2.21,jax/lax/linalg.py,34,1,19,0,0,0,0,0,0,0,0,0,0.0,0,1,100.0
jax_0.2.21,jax/lax/__init__.py,360,8,345,0,0,0,0,0,0,0,0,0,0.0,0,1,100.0
jax_0.2.21,jax/interpreters/sharded_jit.py,461,185,253,13,41,28,54,54,82,267.7653485251756,8.560975609756097,4039.931026518755,224.4406125843753,471.90077517740446,33,56.50129171526648
jax_0.2.21,jax/interpreters/pxla.py,1835,1038,1270,18,347,226,434,365,660,3003.319422870618,11.256484149855908,63236.189830853466,3513.121657269637,5617.75675148647,328,0.0
jax_0.2.21,jax/interpreters/__init__.py,18,3,3,0,0,0,0,0,0,0,0,0,0.0,0,1,100.0
jax_0.2.21,jax/interpreters/batching.py,558,393,433,15,211,137,265,226,402,1687.755287751344,9.419431279620854,29611.978608984246,1645.109922721347,3143.711942890906,155,18.31582328510084
jax_0.2.21,jax/interpreters/partial_eval.py,1532,1050,1141,17,330,196,358,347,554,2830.3731990023753,9.22121212121212,43110.00290453693,2395.000161363163,4675.090686328356,330,0.0
jax_0.2.21,jax/interpreters/ad.py,711,524,551,14,157,100,184,171,284,1198.5584264847919,8.203821656050955,17282.745905255684,960.1525502919825,2106.670114227595,145,16.247017611593495
jax_0.2.21,jax/interpreters/xla.py,1587,1056,1159,15,283,181,348,298,529,2363.5416416555504,9.222614840989399,40099.37733044841,2227.743185024912,4347.940147324483,295,0.0
jax_0.2.21,jax/interpreters/masking.py,575,413,391,17,182,117,218,199,335,1435.9054928174185,10.18131868131868,26046.554485305343,1447.0308047391857,2558.2692478821223,156,22.145830853009553
jax_0.2.21,jax/interpreters/invertible_ad.py,304,195,199,13,70,42,76,83,118,477.1555275219819,7.057142857142857,5308.768550458214,294.93158613656743,752.2546528989373,39,51.314938608471174
jax_0.2.21,jax/tools/jax_to_hlo.py,199,72,88,7,23,14,24,30,38,123.69340944371453,3.652173913043478,680.9910774427127,37.83283763570626,186.46184263312372,20,69.01857155116885
jax_0.2.21,jax/tools/__init__.py,13,0,0,0,0,0,0,0,0,0,0,0,0.0,0,1,100.0
jax_0.2.21,jax/tools/colab_tpu.py,41,15,13,2,3,2,3,5,5,6.754887502163469,1.0,11.60964047443681,0.6449800263576005,11.60964047443681,2,87.01835775056678
jax_0.2.21,jax/image/__init__.py,22,2,5,0,0,0,0,0,0,0,0,0,0.0,0,1,100.0
jax_0.2.21,jax/experimental/maps.py,1753,983,1223,21,343,217,404,364,621,2981.006880675628,12.36734693877551,65340.90460749826,3630.050255972126,5283.340471563391,269,0.0
jax_0.2.21,jax/experimental/host_callback.py,1899,675,961,18,293,194,355,311,549,2476.12240837168,10.904436860068259,49573.130966557794,2754.062831475433,4546.143152801701,150,21.519614008791933
jax_0.2.21,jax/experimental/x64_context.py,65,13,10,0,0,0,0,0,0,0,0,0,0.0,0,1,100.0
jax_0.2.21,jax/experimental/__init__.py,24,2,9,0,0,0,0,0,0,0,0,0,0.0,0,1,100.0
jax_0.2.21,jax/experimental/djax.py,1548,1209,1228,19,251,164,294,270,458,2081.568054797072,11.127490039840637,41162.60578029419,2286.811432238566,3699.181543449281,325,0.0
jax_0.2.21,jax/experimental/ode.py,258,149,160,14,252,189,352,266,541,2063.5775096307857,9.777777777777779,42610.65402103786,2367.2585567243254,4357.907797606144,2,53.763770472603106
jax_0.2.21,jax/experimental/pjit.py,666,311,441,15,55,34,64,70,98,376.5781431779841,8.727272727272727,5242.2086021289315,291.2338112293851,600.6697356606068,70,43.44894357015277
jax_0.2.21,jax/experimental/callback.py,293,201,222,4,17,10,19,21,29,77.48686830125578,2.235294117647059,284.72551764130554,15.818084313405864,127.37720526058406,38,47.65595347688339
jax_0.2.21,jax/experimental/optimizers.py,613,296,286,10,141,115,227,151,342,1039.8960216371036,8.049645390070921,19927.174238750464,1107.0652354861368,2475.534420849177,12,49.292596689999186
jax_0.2.21,jax/experimental/stax.py,351,240,230,13,82,55,104,95,159,569.4249807145172,8.24390243902439,8611.638539095655,478.4243632830919,1044.6070417246208,8,50.530996069649355
jax_0.2.21,jax/experimental/jet.py,601,473,460,13,343,225,443,356,668,2936.8739311331083,8.395043731778426,47530.974078322026,2640.6096710178904,5661.789931885554,77,22.666675047016593
jax_0.2.21,jax/experimental/loops.py,586,268,284,12,65,39,70,77,109,434.4734578555034,6.461538461538462,4413.745966661732,245.20810925898513,683.0797329357443,70,46.38761575606646
jax_0.2.21,jax/experimental/sparse/transform.py,517,329,349,12,79,57,112,91,169,541.018229114645,8.50632911392405,9355.40786959602,519.7448816442234,1099.8172941935798,66,38.87976415047946
jax_0.2.21,jax/experimental/sparse/__init__.py,229,4,43,0,0,0,0,0,0,0,0,0,0.0,0,1,100.0
jax_0.2.21,jax/experimental/sparse/ad.py,101,55,62,4,7,5,8,11,13,27.651484454403228,2.2857142857142856,102.79453952522255,5.710807751401252,44.97261104228487,2,78.0499340692822
jax_0.2.21,jax/experimental/sparse/ops.py,1732,1174,1146,18,503,381,696,521,1077,4589.189188698142,12.453280318091451,121046.82253063071,6724.823473923929,9720.075308573954,335,0.0
jax_0.2.21,jax/experimental/compilation_cache/cache_interface.py,24,8,8,0,0,0,0,0,0,0,0,0,0.0,0,3,100.0
jax_0.2.21,jax/experimental/compilation_cache/compilation_cache.py,160,99,104,4,22,13,25,26,38,106.10749561002054,2.272727272727273,405.94706656673077,22.55261480926282,178.61670928936152,17,65.30327108949236
jax_0.2.21,jax/experimental/compilation_cache/__init__.py,13,0,0,0,0,0,0,0,0,0,0,0,0.0,0,1,100.0
jax_0.2.21,jax/experimental/compilation_cache/file_system_cache.py,82,56,52,5,8,6,10,13,16,35.60964047443681,3.125,185.0219859070546,10.27899921705859,59.207035490257475,17,73.84998107119101
jax_0.2.21,jax/experimental/jax2tf/jax2tf.py,3091,1496,1940,23,500,350,639,523,989,4586.934067320355,14.697,131263.75403750566,7292.430779861425,8931.329797748225,270,0.0
jax_0.2.21,jax/experimental/jax2tf/__init__.py,17,2,2,0,0,0,0,0,0,0,0,0,0.0,0,1,100.0
jax_0.2.21,jax/experimental/jax2tf/call_tf.py,417,181,240,9,68,37,73,77,110,442.4767982180039,4.830882352941177,3330.151936000151,185.0084408888973,689.3465194764392,21,57.14681960396823
jax_0.2.21,jax/experimental/jax2tf/shape_poly.py,753,521,511,17,199,139,252,216,391,1589.175167789442,10.763819095477388,32637.63261601484,1813.2018120008242,3032.161013345916,152,21.600912477366244
jax_0.2.21,jax/experimental/jax2tf/tests/savedmodel_test.py,273,162,178,2,10,9,18,12,27,35.219280948873624,1.8,174.22917753504822,9.679398751947124,96.79398751947123,12,63.349059068556556
jax_0.2.21,jax/experimental/jax2tf/tests/sharding_test.py,332,141,260,8,16,12,23,24,35,88.0,5.75,922.7237032701329,51.26242795945183,160.4736875252405,21,60.12536965243554
jax_0.2.21,jax/experimental/jax2tf/tests/jax2tf_test.py,1022,617,776,8,115,92,182,123,274,811.2313558586033,6.3304347826086955,12042.06307312199,669.0035040623328,1902.2489744629518,69,26.926364617554835
jax_0.2.21,jax/experimental/jax2tf/tests/jax2tf_limitations.py,1122,372,925,20,123,104,174,143,278,940.3678460544737,14.146341463414634,28157.50376444262,1564.3057646912566,1990.4442316243922,75,30.112255324077093
jax_0.2.21,jax/experimental/jax2tf/tests/call_tf_test.py,996,657,693,8,180,114,227,188,341,1372.5335573393415,5.044444444444444,12995.067983151352,721.9482212861863,2576.1147984220743,77,26.701810932851707
jax_0.2.21,jax/experimental/jax2tf/tests/primitive_harness.py,2878,775,2250,17,240,242,387,257,629,1967.1406112473003,13.70625,69018.34053927743,3834.3522521820796,5035.53784144295,294,0.0
jax_0.2.21,jax/experimental/jax2tf/tests/control_flow_ops_test.py,305,204,202,4,54,42,84,58,126,318.76392511682735,3.111111111111111,2296.3285500900083,127.57380833833379,738.1056053860741,17,52.17230498507269
jax_0.2.21,jax/experimental/jax2tf/tests/tf_test_util.py,476,266,325,11,61,41,77,72,118,399.8287253963464,6.942622950819672,5054.58462454224,280.81025691901334,728.0511501701928,61,45.254848428318525
jax_0.2.21,jax/experimental/jax2tf/tests/__init__.py,13,0,0,0,0,0,0,0,0,0,0,0,0.0,0,1,100.0
jax_0.2.21,jax/experimental/jax2tf/tests/shape_poly_test.py,1827,646,1454,16,249,233,432,265,665,2046.040481084952,13.879518072289157,74299.13225015768,4127.729569453204,5353.149285384624,97,19.196692973651274
jax_0.2.21,jax/experimental/jax2tf/tests/primitives_test.py,300,138,196,7,30,19,34,37,53,166.8582023226588,3.966666666666667,1095.2007459007264,60.844485883373686,276.1010283783344,34,59.02768614448413
jax_0.2.21,jax/experimental/jax2tf/tests/jax_primitives_coverage_test.py,152,71,94,3,5,3,5,8,8,16.36452797660028,1.5,36.0,2.0,24.0,21,74.6636948706893
jax_0.2.21,jax/experimental/jax2tf/tests/stax_test.py,77,37,48,1,2,1,2,3,3,2.0,0.5,2.3774437510817346,0.1320802083934297,4.754887502163469,5,88.5800541917539
jax_0.2.21,jax/experimental/jax2tf/examples/saved_model_main.py,206,94,147,7,35,23,43,42,66,199.17639004747704,4.3,1530.3396845846123,85.01887136581179,355.89294990339823,18,59.65560372878955
jax_0.2.21,jax/experimental/jax2tf/examples/mnist_lib.py,313,168,180,7,45,33,57,52,90,266.7848737892386,4.433333333333334,2274.475447538296,126.3597470854609,513.0395746326983,25,58.24102917505997
jax_0.2.21,jax/experimental/jax2tf/examples/saved_model_lib.py,151,36,51,3,6,4,6,9,10,20.264662506490406,1.5,47.548875021634686,2.6416041678685938,31.699250014423125,10,67.75825749254653
jax_0.2.21,jax/experimental/jax2tf/examples/saved_model_main_test.py,65,31,41,1,2,1,2,3,3,2.0,0.5,2.3774437510817346,0.1320802083934297,4.754887502163469,5,88.93919675570635
jax_0.2.21,jax/experimental/jax2tf/examples/__init__.py,13,0,0,0,0,0,0,0,0,0,0,0,0.0,0,1,100.0
jax_0.2.21,jax/experimental/jax2tf/examples/keras_reuse_main.py,79,33,42,1,2,1,2,3,3,2.0,0.5,2.3774437510817346,0.1320802083934297,4.754887502163469,3,90.49544489294601
jax_0.2.21,jax/experimental/jax2tf/examples/keras_reuse_main_test.py,50,25,28,1,2,1,2,3,3,2.0,0.5,2.3774437510817346,0.1320802083934297,4.754887502163469,4,93.09737313735253
jax_0.2.21,jax/experimental/jax2tf/examples/serving/__init__.py,13,0,0,0,0,0,0,0,0,0,0,0,0.0,0,1,100.0
jax_0.2.21,jax/experimental/jax2tf/examples/serving/model_server_request.py,127,56,78,7,18,11,22,25,33,94.71013448036484,4.277777777777778,655.5576987898653,36.41987215499252,153.24725426256592,6,74.5085914090044
jax_0.2.21,jax/experimental/jax2tf/examples/tflite/mnist/mnist.py,135,59,78,6,25,16,32,31,48,131.60617974869504,3.84,913.1574639305088,50.7309702183616,237.80142289857002,5,72.81256660618052
jax_0.2.21,jax/experimental/jax2tf/examples/tf_js/quickdraw/utils.py,75,51,49,7,15,9,17,22,26,78.25484338853101,3.966666666666667,459.91604760212664,25.55089153345148,115.94522208456974,8,74.68509813678746
jax_0.2.21,jax/experimental/jax2tf/examples/tf_js/quickdraw/quickdraw.py,164,109,116,8,22,16,25,30,41,122.10749561002054,4.545454545454546,914.4659746361331,50.80366525756295,201.18251441994926,9,63.10044465526242
jax_0.2.21,jax/lib/xla_bridge.py,28,1,13,0,0,0,0,0,0,0,0,0,0.0,0,1,100.0
jax_0.2.21,jax/lib/__init__.py,20,2,5,0,0,0,0,0,0,0,0,0,0.0,0,1,100.0
jax_0.2.21,jax/numpy/linalg.py,56,13,35,1,2,1,2,3,3,2.0,0.5,2.3774437510817346,0.1320802083934297,4.754887502163469,3,99.56102088486993
jax_0.2.21,jax/numpy/__init__.py,408,17,380,1,2,1,2,3,3,2.0,0.5,2.3774437510817346,0.1320802083934297,4.754887502163469,3,81.3962006947821
jax_0.2.21,jax/numpy/fft.py,52,12,31,1,2,1,2,3,3,2.0,0.5,2.3774437510817346,0.1320802083934297,4.754887502163469,3,100.0
jax_0.2.21,jax/_src/errors.py,572,35,35,0,0,0,0,0,0,0,0,0,0.0,0,7,100.0
jax_0.2.21,jax/_src/flatten_util.py,69,32,28,2,2,2,2,4,4,4.0,1.0,8.0,0.4444444444444444,8.0,5,85.81306157705899
jax_0.2.21,jax/_src/pprint_util.py,63,33,34,4,25,16,28,29,44,124.09640474436812,2.24,478.8026068797736,26.600144826654088,213.7511637856132,12,76.96983641272148
jax_0.2.21,jax/_src/random.py,1452,700,788,21,302,219,372,323,591,2580.2368971545275,12.933774834437086,63714.564644807186,3539.6980358226215,4926.215699624109,90,29.21229624302855
jax_0.2.21,jax/_src/traceback_util.py,196,118,117,10,43,26,48,53,74,266.54866540106383,5.5813953488372094,2365.7643551870333,131.4313530659463,423.8661136376768,24,62.09098376769652
jax_0.2.21,jax/_src/cloud_tpu_init.py,99,26,49,1,4,2,4,5,6,8.0,0.5,6.965784284662087,0.3869880158145604,13.931568569324174,3,89.19132218389696
jax_0.2.21,jax/_src/lax_reference.py,459,330,354,19,175,114,219,194,333,1384.672567326086,11.888571428571428,30087.251522861232,1671.5139734922907,2530.7709764483134,57,32.323810533564675
jax_0.2.21,jax/_src/dtypes.py,369,200,214,15,77,45,86,92,131,541.1459225676352,8.376623376623376,7158.55022697451,397.6972348319172,854.5866162434687,56,50.725571732922745
jax_0.2.21,jax/_src/api_util.py,318,216,227,13,74,47,89,87,136,507.60526539237657,7.8175675675675675,6850.06787134317,380.55932618573166,876.2403154354271,64,43.17249850952634
jax_0.2.21,jax/_src/__init__.py,13,0,0,0,0,0,0,0,0,0,0,0,0.0,0,1,100.0
jax_0.2.21,jax/_src/util.py,447,323,309,14,89,60,107,103,167,629.6432442648158,8.415730337078651,9397.38815102987,522.0771195016595,1116.6455880395974,84,36.03153292754778
jax_0.2.21,jax/_src/config.py,605,251,392,10,45,29,55,55,84,280.35267028370896,6.111111111111111,2967.7646529426584,164.87581405236992,485.6342159360714,52,47.87718746431915
jax_0.2.21,jax/_src/custom_derivatives.py,1068,474,562,13,97,63,118,110,181,688.2972620279857,7.907216494845361,9705.523968551423,539.1957760306345,1227.4261081479635,98,36.0193878535627
jax_0.2.21,jax/_src/prng.py,488,296,316,18,141,85,157,159,242,1081.7353907141915,10.02127659574468,17734.830319345136,985.2683510747297,1769.717675178814,68,38.956182282831485
jax_0.2.21,jax/_src/tree_util.py,320,111,121,7,15,8,15,22,23,78.25484338853101,3.5,358.9842453003024,19.943569183350135,102.56692722865783,14,63.25293110820811
jax_0.2.21,jax/_src/dlpack.py,65,23,26,1,2,2,2,3,4,2.0,0.5,3.1699250014423126,0.17610694452457293,6.339850002884625,4,87.33015205921234
jax_0.2.21,jax/_src/abstract_arrays.py,69,34,41,0,0,0,0,0,0,0,0,0,0.0,0,3,100.0
jax_0.2.21,jax/_src/profiler.py,258,75,73,3,7,4,8,10,12,24.406371956566698,1.7142857142857142,68.33680652339717,3.796489251299843,39.863137138648355,9,60.88158970777727
jax_0.2.21,jax/_src/source_info_util.py,106,64,66,4,12,7,13,16,20,51.01955000865388,2.1666666666666665,173.33333333333331,9.629629629629628,80.0,17,71.20090766806535
jax_0.2.21,jax/_src/ad_util.py,90,64,55,2,4,3,4,6,7,10.0,1.0,18.094737505048094,1.0052631947248942,18.094737505048094,6,75.70809255106023
jax_0.2.21,jax/_src/api.py,2807,928,1229,16,233,160,281,249,441,1896.3553717044472,9.648068669527897,33868.2025553239,1881.5668086291055,3510.3608520420235,129,18.768324727364686
jax_0.2.21,jax/_src/third_party/__init__.py,0,0,0,0,0,0,0,0,0,0,0,0,0.0,0,1,100.0
jax_0.2.21,jax/_src/third_party/numpy/linalg.py,207,136,135,15,85,71,121,100,192,603.4015885058325,10.676470588235293,13619.123558898214,756.6179754943453,1275.6203884367474,35,52.44156611163639
jax_0.2.21,jax/_src/third_party/numpy/__init__.py,0,0,0,0,0,0,0,0,0,0,0,0,0.0,0,1,100.0
jax_0.2.21,jax/_src/ops/scatter.py,615,105,167,9,22,17,33,31,50,126.63682062300134,6.75,1672.0412547555704,92.89118081975391,247.70981551934378,20,42.4625020789703
jax_0.2.21,jax/_src/ops/__init__.py,13,0,0,0,0,0,0,0,0,0,0,0,0.0,0,1,100.0
jax_0.2.21,jax/_src/nn/functions.py,403,113,100,13,82,52,100,95,152,569.4249807145172,7.926829268292683,7915.874806135337,439.77082256307426,998.6180524663041,7,38.148549017964044
jax_0.2.21,jax/_src/nn/__init__.py,13,0,0,0,0,0,0,0,0,0,0,0,0.0,0,1,100.0
jax_0.2.21,jax/_src/nn/initializers.py,195,123,110,10,88,67,126,98,193,601.6492633889558,7.159090909090909,9139.574658476913,507.7541476931618,1276.6389999142355,1,61.756149009028874
jax_0.2.21,jax/_src/scipy/special.py,1463,612,871,20,580,462,811,600,1273,5410.785834106409,13.982758620689655,164273.45004351757,9126.302780195421,11748.286193001257,44,33.20473857638226
jax_0.2.21,jax/_src/scipy/signal.py,148,101,110,16,80,58,111,96,169,569.7542475909889,11.1,12352.731155102816,686.2628419501565,1112.8586626218753,40,50.83660016682552
jax_0.2.21,jax/_src/scipy/linalg.py,598,422,461,18,293,198,383,311,581,2476.12240837168,11.764505119453926,56600.53783868925,3144.474324371625,4811.12781744588,54,27.810964459390977
jax_0.2.21,jax/_src/scipy/__init__.py,13,0,0,0,0,0,0,0,0,0,0,0,0.0,0,1,100.0
jax_0.2.21,jax/_src/scipy/eigh.py,238,99,92,11,32,18,35,43,53,198.0537478050103,6.015625,1730.0458174952548,96.11365652751415,287.5920319992112,8,61.01636485034411
jax_0.2.21,jax/_src/scipy/ndimage.py,136,78,94,10,39,25,50,49,75,239.34996748450132,6.410256410256411,2699.3797327476964,149.96554070820537,421.10323830864064,14,60.527938645509664
jax_0.2.21,jax/_src/scipy/fft.py,96,61,62,10,56,34,66,66,100,358.4311565840995,5.892857142857143,3561.8751060505174,197.88195033613985,604.4394119358453,26,63.939733909784586
jax_0.2.21,jax/_src/scipy/optimize/line_search.py,418,192,313,18,193,158,293,211,451,1540.4028582187013,13.663212435233161,47578.25332041452,2643.2362955785848,3482.2157341069405,10,47.349299552771996
jax_0.2.21,jax/_src/scipy/optimize/minimize.py,128,43,55,5,11,7,12,16,19,49.663388279447084,2.727272727272727,207.27272727272725,11.515151515151514,76.0,5,75.62550362724534
jax_0.2.21,jax/_src/scipy/optimize/__init__.py,13,0,0,0,0,0,0,0,0,0,0,0,0.0,0,1,100.0
jax_0.2.21,jax/_src/scipy/optimize/_lbfgs.py,233,102,132,12,68,45,83,80,128,456.967023213677,7.323529411764706,5926.249771772058,329.236098431781,809.2067961455823,7,64.06449874453386
jax_0.2.21,jax/_src/scipy/optimize/bfgs.py,179,70,109,9,43,25,48,52,73,261.858709465171,5.023255813953488,2090.337987805785,116.1298882114325,416.1320994242998,2,70.19761433120354
jax_0.2.21,jax/_src/scipy/sparse/linalg.py,749,332,337,16,156,105,200,172,305,1200.5227461425109,10.256410256410257,23230.879489068102,1290.604416059339,2265.01075018414,22,46.477870365044616
jax_0.2.21,jax/_src/scipy/sparse/__init__.py,13,0,0,0,0,0,0,0,0,0,0,0,0.0,0,1,100.0
jax_0.2.21,jax/_src/scipy/stats/norm.py,53,28,28,3,6,4,7,9,11,20.264662506490406,1.75,61.021056277764515,3.3900586820980285,34.86917501586544,1,86.36838976988906
jax_0.2.21,jax/_src/scipy/stats/nbinom.py,41,19,19,1,1,1,1,2,2,0.0,0.5,1.0,0.05555555555555555,2.0,1,98.80361971046804
jax_0.2.21,jax/_src/scipy/stats/laplace.py,42,21,23,0,0,0,0,0,0,0,0,0,0.0,0,1,100.0
jax_0.2.21,jax/_src/scipy/stats/chi2.py,40,18,18,1,1,1,1,2,2,0.0,0.5,1.0,0.05555555555555555,2.0,1,99.08805717012652
jax_0.2.21,jax/_src/scipy/stats/betabinom.py,50,27,24,2,3,2,3,5,5,6.754887502163469,1.0,11.60964047443681,0.6449800263576005,11.60964047443681,2,90.2891388065784
jax_0.2.21,jax/_src/scipy/stats/beta.py,38,17,20,1,1,1,1,2,2,0.0,0.5,1.0,0.05555555555555555,2.0,1,100.0
jax_0.2.21,jax/_src/scipy/stats/__init__.py,13,0,0,0,0,0,0,0,0,0,0,0,0.0,0,1,100.0
jax_0.2.21,jax/_src/scipy/stats/gamma.py,36,17,18,1,1,1,1,2,2,0.0,0.5,1.0,0.05555555555555555,2.0,1,99.62955793282077
jax_0.2.21,jax/_src/scipy/stats/logistic.py,44,22,22,3,5,3,5,8,8,16.36452797660028,1.5,36.0,2.0,24.0,1,90.15035513843107
jax_0.2.21,jax/_src/scipy/stats/dirichlet.py,54,27,32,9,22,14,27,31,41,126.63682062300134,5.5227272727272725,1121.7876781905554,62.321537677253076,203.1220487258619,5,80.27487038291208
jax_0.2.21,jax/_src/scipy/stats/bernoulli.py,36,16,17,2,4,3,4,6,7,10.0,1.0,18.094737505048094,1.0052631947248942,18.094737505048094,1,93.1869161907969
jax_0.2.21,jax/_src/scipy/stats/geom.py,33,16,16,2,4,3,4,6,7,10.0,1.0,18.094737505048094,1.0052631947248942,18.094737505048094,1,92.7535086534133
jax_0.2.21,jax/_src/scipy/stats/uniform.py,33,12,14,1,1,1,1,2,2,0.0,0.5,1.0,0.05555555555555555,2.0,1,100.0
jax_0.2.21,jax/_src/scipy/stats/cauchy.py,34,15,15,0,0,0,0,0,0,0,0,0,0.0,0,1,100.0
jax_0.2.21,jax/_src/scipy/stats/expon.py,32,14,14,1,1,1,1,2,2,0.0,0.5,1.0,0.05555555555555555,2.0,1,99.38367921311516
jax_0.2.21,jax/_src/scipy/stats/t.py,40,20,21,0,0,0,0,0,0,0,0,0,0.0,0,1,100.0
jax_0.2.21,jax/_src/scipy/stats/poisson.py,42,22,22,3,9,5,9,12,14,33.28421251514428,1.5,75.28421251514428,4.182456250841349,50.18947501009619,1,87.90690024444606
jax_0.2.21,jax/_src/scipy/stats/multivariate_normal.py,51,27,32,10,45,40,70,55,110,280.35267028370896,7.777777777777778,4946.274421571097,274.7930234206165,635.9495684877126,6,76.66971034956092
jax_0.2.21,jax/_src/scipy/stats/pareto.py,34,15,15,1,1,1,1,2,2,0.0,0.5,1.0,0.05555555555555555,2.0,1,99.48632904559491
jax_0.2.21,jax/_src/lax/other.py,115,18,40,4,12,7,14,16,21,51.01955000865388,2.3333333333333335,196.0,10.88888888888889,84.0,2,75.47689480851739
jax_0.2.21,jax/_src/lax/linalg.py,1443,879,959,20,455,400,679,475,1079,4103.962406361904,14.923076923076923,143175.50118922125,7954.194510512291,9594.234615772557,153,12.254982982018769
jax_0.2.21,jax/_src/lax/__init__.py,18,3,3,0,0,0,0,0,0,0,0,0,0.0,0,1,100.0
jax_0.2.21,jax/_src/lax/parallel.py,1509,809,942,22,334,237,439,356,676,2898.2647292963543,14.45808383233533,82838.97639215698,4602.165355119832,5729.595799333285,234,7.160967246860652
jax_0.2.21,jax/_src/lax/lax.py,7034,3951,4876,25,1652,1117,2086,1677,3203,17775.973053529287,15.783898305084746,541537.1745903246,30085.398588351367,34309.469316326606,888,0.0
jax_0.2.21,jax/_src/lax/polar.py,343,154,148,11,117,85,168,128,253,841.8864199962686,7.897435897435898,13986.358974358975,777.0199430199431,1771.0,9,54.72529268651179
jax_0.2.21,jax/_src/lax/control_flow.py,2705,1376,1709,18,772,467,909,790,1376,7480.43548279692,10.597150259067357,140358.99415294288,7797.721897385715,13244.975368056705,342,0.0
jax_0.2.21,jax/_src/lax/fft.py,145,100,102,8,50,34,60,58,94,306.1928094887362,4.8,2643.1210250015606,146.84005694453114,550.6502135419918,11,60.3856477678267
jax_0.2.21,jax/_src/image/scale.py,306,118,148,13,100,68,130,113,198,712.4913353133068,8.45,11410.841422016852,633.9356345564918,1350.3954345582074,29,57.54689676269177
jax_0.2.21,jax/_src/image/__init__.py,13,0,0,0,0,0,0,0,0,0,0,0,0.0,0,1,100.0
jax_0.2.21,jax/_src/lib/xla_bridge.py,595,283,323,15,79,51,98,94,149,556.6020380401189,9.30379746835443,9086.402507487044,504.8001393048358,976.633738899968,61,46.106521446463546
jax_0.2.21,jax/_src/lib/__init__.py,122,65,77,5,12,7,13,17,20,54.62919048309069,2.7083333333333335,221.4042372343934,12.300235401910745,81.7492568250068,16,73.03159896601281
jax_0.2.21,jax/_src/numpy/polynomial.py,104,47,61,8,19,13,22,27,35,104.71062275542812,4.631578947368421,770.792289824394,42.821793879133,166.4210625757214,7,74.72629182995534
jax_0.2.21,jax/_src/numpy/linalg.py,531,356,386,19,267,253,430,286,683,2232.9164365160054,15.299625468164795,85267.7521443267,4737.097341351484,5573.192123019639,85,30.03933113658326
jax_0.2.21,jax/_src/numpy/__init__.py,13,0,0,0,0,0,0,0,0,0,0,0,0.0,0,1,100.0
jax_0.2.21,jax/_src/numpy/util.py,164,91,89,8,41,28,53,49,81,243.65963218934144,5.170731707317073,2351.6048156864967,130.64471198258315,454.7914973733319,11,66.41115437304612
jax_0.2.21,jax/_src/numpy/vectorize.py,312,118,147,14,52,32,58,66,90,349.7258342521433,7.8076923076923075,4247.3492523338045,235.96384735187803,543.9954707422607,22,61.26634521080634
jax_0.2.21,jax/_src/numpy/lax_numpy.py,6897,4876,5241,26,2033,1486,2769,2059,4255,22463.650450856014,17.70634530250861,829327.7318986648,46073.76288325916,46837.883127760244,1166,0.0
jax_0.2.21,jax/_src/numpy/fft.py,266,164,186,13,114,90,172,127,262,827.0551779506148,9.807017543859649,17956.996172899613,997.6108984944229,1831.0353879343077,41,42.443021337428455
jax_0.2.21,examples/kernel_lsq.py,96,53,48,6,23,13,25,29,38,119.55169999363824,3.260869565217391,601.9672102658079,33.44262279254488,184.60327781484776,3,74.7704539833208
jax_0.2.21,examples/control.py,223,134,131,7,74,46,90,81,136,479.1510335109456,4.256756756756757,3670.259109778073,203.9032838765596,862.2196003923091,7,58.554740763929296
jax_0.2.21,examples/examples_test.py,99,60,68,1,2,1,2,3,3,2.0,0.5,2.3774437510817346,0.1320802083934297,4.754887502163469,7,78.54136586103303
jax_0.2.21,examples/spmd_mnist_classifier_fromscratch.py,128,84,79,5,38,24,44,43,68,211.03088598529305,2.8947368421052633,1068.117378030834,59.33985433504634,368.9860033197427,11,66.36779369409138
jax_0.2.21,examples/control_test.py,247,183,173,8,103,72,138,111,210,712.7095542998715,5.359223300970874,7646.686283760237,424.8159046533465,1426.8273319335224,13,43.06599338578559
jax_0.2.21,examples/mnist_classifier.py,97,59,60,5,17,11,20,22,31,81.0965087756926,2.9411764705882355,406.5952358169301,22.58862421205167,138.24238017775622,6,72.0807942967749
jax_0.2.21,examples/__init__.py,13,0,0,0,0,0,0,0,0,0,0,0,0.0,0,1,100.0
jax_0.2.21,examples/onnx2xla.py,134,80,88,9,46,29,57,55,86,282.6131749916034,5.576086956521739,2772.41334610088,154.02296367227112,497.19693536312076,23,60.074636506684904
jax_0.2.21,examples/gaussian_process_regression.py,132,86,86,10,91,57,110,101,167,625.4285932069549,6.043956043956044,6720.403568030247,373.35575377945815,1111.9213176195499,6,62.95215174406371
jax_0.2.21,examples/resnet50.py,125,57,83,3,10,7,11,13,18,37.974168451037094,1.65,109.90305962879044,6.105725534932803,66.60791492653966,4,73.26266838583634
jax_0.2.21,examples/datasets.py,93,54,49,5,11,7,11,16,18,49.663388279447084,2.5,180.0,10.0,72.0,5,74.69042639190147
jax_0.2.21,examples/mnist_classifier_fromscratch.py,95,61,60,5,33,21,38,38,59,178.07464641326578,2.878787878787879,891.3525367530696,49.51958537517053,309.6277232931715,9,68.05283320166164
jax_0.2.21,examples/mnist_vae.py,137,86,87,8,41,26,46,49,72,243.65963218934144,4.487804878048781,1814.2360003619096,100.79088890899499,404.259108776295,5,62.96836821845701
jax_0.2.21,examples/differentially_private_sgd.py,254,121,149,8,43,26,48,51,74,257.3293844521902,4.465116279069767,1874.2748664821165,104.1263814712287,419.7594753058907,14,62.82978194076829
jax_0.2.21,examples/advi.py,139,81,78,6,15,9,15,21,24,74.11313393845472,3.0,316.2468544400708,17.569269691115046,105.41561814669026,3,72.02332085175419
jax_0.2.21,examples/jax_cpp/prog.py,19,4,3,1,2,1,2,3,3,2.0,0.5,2.3774437510817346,0.1320802083934297,4.754887502163469,1,55.04800712070099
jax_0.2.21,jaxlib/cusolver.py,429,212,364,14,136,173,284,150,457,1017.1979153188527,14.617647058823529,48290.42236334232,2682.8012424079066,3303.5701415566173,32,33.31065115506379
jax_0.2.21,jaxlib/cuda_prng.py,55,28,33,4,11,8,14,15,22,46.053747805010275,2.5454545454545454,218.78587335407704,12.154770741893168,85.95159310338741,8,81.99042263694243
jax_0.2.21,jaxlib/init.py,16,1,1,0,0,0,0,0,0,0,0,0,0.0,0,1,100.0
jax_0.2.21,jaxlib/pocketfft.py,156,95,116,12,36,45,75,48,120,229.1368500605771,12.5,8377.443751081735,465.41354172676307,670.1955000865388,30,53.379218416268614
jax_0.2.21,jaxlib/cuda_linalg.py,63,29,37,3,4,7,9,7,16,12.75488750216347,3.375,151.59716579111063,8.422064766172813,44.91767875292167,4,83.53178035186095
jax_0.2.21,jaxlib/setup.py,43,10,25,1,4,2,4,5,6,8.0,0.5,6.965784284662087,0.3869880158145604,13.931568569324174,2,99.06075381513622
jax_0.2.21,jaxlib/version.py,20,1,1,0,0,0,0,0,0,0,0,0,0.0,0,1,100.0
jax_0.2.21,jaxlib/rocsolver.py,363,156,299,11,109,134,219,120,353,775.7858392056952,11.05045871559633,26942.48121110911,1496.8045117282838,2438.1323802498073,21,48.60807710013796
jax_0.2.21,jaxlib/cusparse.py,328,114,258,4,16,8,16,20,24,72.0,2.0,207.45254855459342,11.525141586366301,103.72627427729671,17,54.67747023274186
jax_0.2.21,jaxlib/lapack.py,586,277,511,10,162,196,318,172,514,1222.2749814161828,9.814814814814815,37464.13045325825,2081.3405807365693,3817.1000839168782,69,25.296607388459257
