Project,Files,LOC,LLOC,SLOC,h1,h2,N1,N2,N,Length,Calculated_length,Difficulty,Effort,Time,Halstead_Volume,Cyclomatic_Complexity,Maintainabilty_Index
jax_0.3.15,./conftest.py,26,10,9,0,0,0,0,0,0,0,0,0,0.0,0,1,100.0
jax_0.3.15,./setup.py,92,17,68,0,0,0,0,0,0,0,0,0,0.0,0,3,100.0
jax_0.3.15,docs/autodidax.py,3001,1742,1634,20,412,263,489,432,752,3665.276779097233,11.868932038834952,78141.19590765944,4341.177550425524,6583.67540162693,354,0.0
jax_0.3.15,docs/conf.py,294,44,122,0,0,0,0,0,0,0,0,0,0.0,0,1,100.0
jax_0.3.15,docs/sphinxext/jax_extensions.py,50,22,22,3,9,6,10,12,16,33.28421251514428,1.6666666666666667,95.59900001923084,5.311055556623936,57.359400011538504,4,84.7406863074896
jax_0.3.15,build/build_wheel.py,306,192,235,10,23,13,24,33,37,137.26120593818493,5.217391304347826,973.7873865196318,54.099299251090656,186.64258241626277,22,49.62240178278965
jax_0.3.15,build/build.py,555,259,441,18,89,55,102,107,157,651.398925381971,10.314606741573034,10917.086189685971,606.5047883158873,1058.41031686498,70,33.66118944288321
jax_0.3.15,build/rocm/run_single_gpu.py,120,77,86,4,16,9,18,20,27,72.0,2.25,262.55713176440725,14.586507320244847,116.69205856195879,10,66.7791333614014
jax_0.3.15,tests/x64_context_test.py,149,104,107,5,10,7,11,15,18,44.82892142331043,2.75,193.39108448262166,10.743949137923426,70.32403072095333,13,62.31953318514132
jax_0.3.15,tests/lax_autodiff_test.py,1106,453,979,16,123,73,140,139,213,917.9292841567265,9.105691056910569,13807.273026901788,767.070723716766,1516.3344484901072,81,23.243136837118687
jax_0.3.15,tests/qdwh_test.py,257,157,179,9,58,31,61,67,92,368.29222273037993,4.732758620689655,2641.2589037210446,146.73660576228025,558.0802055221151,10,52.59316423076364
jax_0.3.15,tests/lax_numpy_indexing_test.py,1480,709,1267,14,101,135,181,115,316,725.7823286667377,12.544554455445544,27136.064778977245,1507.5591543876246,2163.174856098423,96,13.992516519314348
jax_0.3.15,tests/stack_test.py,54,29,28,1,2,1,2,3,3,2.0,0.5,2.3774437510817346,0.1320802083934297,4.754887502163469,4,91.69128887833732
jax_0.3.15,tests/metadata_test.py,112,78,82,2,22,21,32,24,53,100.10749561002054,1.4545454545454546,353.4589273283219,19.636607073795663,243.00301253822133,18,62.25257497587688
jax_0.3.15,tests/array_test.py,182,131,142,3,8,4,8,11,12,28.75488750216347,1.5,62.26976913547136,3.4594316186372978,41.51317942364757,18,57.77219907671895
jax_0.3.15,tests/name_stack_test.py,613,448,512,7,30,50,100,37,150,166.8582023226588,11.666666666666666,9116.543389850662,506.4746327694812,781.4180048443425,42,25.739742945168054
jax_0.3.15,tests/jet_test.py,429,396,342,15,91,56,100,106,156,650.8126711922091,8.241758241758241,8650.183441581255,480.5657467545142,1049.555590911859,114,23.185468751904427
jax_0.3.15,tests/jaxpr_effects_test.py,863,681,697,4,22,34,68,26,102,106.10749561002054,6.181818181818182,2963.840898638783,164.6578277021546,479.4448512503914,61,24.141802252947812
jax_0.3.15,tests/sharded_jit_test.py,525,339,389,9,110,84,168,119,252,774.4788935006934,6.872727272727273,11941.322924757482,663.4068291531935,1737.4940763536017,48,31.808938349149866
jax_0.3.15,tests/multibackend_test.py,197,133,146,6,28,16,32,34,48,150.11571282193984,3.4285714285714284,837.2510275886274,46.513945977145966,244.19821638001633,20,56.37139488514214
jax_0.3.15,tests/clear_backends_test.py,40,20,18,3,6,3,6,9,9,20.264662506490406,1.5,42.793987519471216,2.377443751081734,28.529325012980813,4,89.60424193829225
jax_0.3.15,tests/xla_bridge_test.py,255,163,185,7,14,9,14,21,23,72.95445336320968,3.5,353.5815525336902,19.643419585205013,101.02330072391149,25,52.7610546953811
jax_0.3.15,tests/core_test.py,747,533,549,8,137,95,187,145,282,996.4303953655922,5.45985401459854,11054.754042418906,614.153002356606,2024.7343633842115,83,25.45028833809218
jax_0.3.15,tests/debug_nans_test.py,237,160,167,5,27,15,30,32,45,139.9916030328505,2.7777777777777777,625.0,34.72222222222222,225.0,31,51.957822648217444
jax_0.3.15,tests/scipy_stats_test.py,893,569,703,10,76,65,104,86,169,508.06177197058616,6.842105263157895,7430.791403200268,412.82174462223713,1086.0387435446546,53,27.39838426209424
jax_0.3.15,tests/callback_test.py,294,206,221,8,59,46,91,67,137,371.07593991234864,6.169491525423729,5127.181961860139,284.8434423255633,831.0542190927148,15,41.14830949880618
jax_0.3.15,tests/debugging_primitives_test.py,542,384,456,5,33,23,46,38,69,178.07464641326578,3.484848484848485,1261.8880248234802,70.10489026797113,362.1069984276074,39,34.34697297214005
jax_0.3.15,tests/xla_interpreter_test.py,37,15,16,1,8,4,8,9,12,24.0,0.5,19.019550008653876,1.0566416671474377,38.03910001730775,6,90.43301638216766
jax_0.3.15,tests/scipy_interpolate_test.py,71,36,44,4,13,7,14,17,21,56.105716335834195,2.1538461538461537,184.87908851193845,10.27106047288547,85.83671966625714,3,78.50613892639305
jax_0.3.15,tests/ann_test.py,231,124,175,8,26,17,32,34,49,146.2114326716684,4.923076923076923,1227.2525746277745,68.18069859043192,249.28567922126666,16,57.51987218417181
jax_0.3.15,tests/image_test.py,404,172,338,4,12,8,12,16,20,51.01955000865388,2.0,160.0,8.88888888888889,80.0,20,50.837884362251565
jax_0.3.15,tests/global_device_array_test.py,383,207,326,4,9,5,9,13,14,36.52932501298081,2.0,103.61231210795059,5.75623956155281,51.80615605397529,27,48.5220429437571
jax_0.3.15,tests/util_test.py,84,45,42,5,13,7,13,18,20,59.715356810271004,2.5,208.4962500721156,11.583125004006423,83.39850002884624,6,78.58496059329892
jax_0.3.15,tests/dtypes_test.py,529,314,422,9,61,39,75,70,114,390.3043026043169,5.532786885245901,3865.969902900944,214.77610571671912,698.7382639317262,83,29.328300455170595
jax_0.3.15,tests/errors_test.py,396,261,304,5,21,13,26,26,39,103.84830635279079,3.0952380952380953,567.4102231184605,31.522790173247806,183.31714900750262,29,40.52400748920242
jax_0.3.15,tests/api_test.py,8471,6388,6520,20,1313,1081,2100,1333,3181,13687.347588670107,15.993907083015994,528122.7567471506,29340.153152619474,33020.24664804803,708,0.0
jax_0.3.15,tests/generated_fun_test.py,285,209,208,11,38,24,44,49,68,237.47499331586653,6.368421052631579,2431.4648735463124,135.08138186368402,381.8002693998342,34,44.258264021728294
jax_0.3.15,tests/jax_to_ir_test.py,150,85,100,5,14,7,14,19,21,64.91260938324326,2.5,223.01619445578822,12.389788580877124,89.20647778231529,14,67.83008528234795
jax_0.3.15,tests/infeed_test.py,122,82,87,4,18,10,20,22,30,83.05865002596161,2.2222222222222223,297.2954412424865,16.51641340236036,133.78294855911892,7,65.61277357418047
jax_0.3.15,tests/sparsify_test.py,578,328,435,9,52,36,70,61,106,324.9521903563176,6.0576923076923075,3808.217686562015,211.56764925344527,628.658157781666,37,37.91889964684792
jax_0.3.15,tests/xmap_test.py,1919,1351,1518,22,267,196,380,289,576,2250.313309370598,15.655430711610487,73717.62197469377,4095.4234430385427,4708.757193120392,220,0.0
jax_0.3.15,tests/svd_test.py,232,135,161,8,48,27,54,56,81,292.0782000346155,4.5,2116.780869089997,117.59893717166649,470.39574868666597,14,54.56312859603056
jax_0.3.15,tests/compilation_cache_test.py,323,259,272,7,33,21,42,40,63,186.1164903932322,4.454545454545454,1493.5265480833898,82.97369711574387,335.28146997790384,30,39.722079976516326
jax_0.3.15,tests/lax_numpy_vectorize_test.py,213,117,164,4,13,9,16,17,25,56.105716335834195,2.4615384615384617,251.53617484617476,13.974231935898597,102.1865710312585,18,54.50062732375096
jax_0.3.15,tests/lobpcg_test.py,399,270,295,12,101,61,115,113,176,715.4989097665853,6.8316831683168315,8200.42112074951,455.57895115275056,1200.3514973850731,38,39.431722704325836
jax_0.3.15,tests/api_util_test.py,71,36,48,3,11,8,16,14,24,42.808635307173745,2.1818181818181817,199.36694864592542,11.075941591440301,91.37651812938249,12,76.47242976250509
jax_0.3.15,tests/nn_test.py,291,163,216,6,32,21,32,38,53,175.50977500432694,3.0,834.4204746375301,46.35669303541834,278.14015821251,39,47.681137763368774
jax_0.3.15,tests/version_test.py,44,16,23,1,2,1,2,3,3,2.0,0.5,2.3774437510817346,0.1320802083934297,4.754887502163469,3,97.8258162014667
jax_0.3.15,tests/sparse_test.py,2323,1475,1916,16,294,210,399,310,609,2474.703669381891,10.857142857142858,54721.73456767327,3040.0963648707375,5040.159762812012,192,0.0
jax_0.3.15,tests/lax_vmap_test.py,831,331,735,12,54,34,61,66,95,353.78347512548123,6.777777777777778,3891.918213520248,216.21767852890267,574.217441339053,62,31.422943053639713
jax_0.3.15,tests/optimizers_test.py,314,251,231,5,33,24,48,38,72,178.07464641326578,3.6363636363636362,1374.0028398834113,76.33349110463396,377.85078096793814,31,44.748706601409594
jax_0.3.15,tests/lax_test.py,2985,1378,2596,13,252,196,367,265,563,2058.380257057813,9.466269841269842,42901.7477039054,2383.4304279947446,4532.064733340667,245,0.0
jax_0.3.15,tests/pickle_test.py,115,76,75,3,6,5,10,9,15,20.264662506490406,2.5,118.87218755408671,6.604010419671484,47.548875021634686,9,69.39881019612508
jax_0.3.15,tests/remote_transfer_test.py,49,26,25,3,6,3,6,9,9,20.264662506490406,1.5,42.793987519471216,2.377443751081734,28.529325012980813,5,87.50514140779416
jax_0.3.15,tests/custom_root_test.py,247,173,168,10,54,34,65,64,99,343.983206065701,6.018518518518518,3575.0,198.61111111111111,594.0,8,50.96630912842953
jax_0.3.15,tests/lax_scipy_test.py,609,355,487,16,140,87,161,156,248,1062.0996223722952,9.2,16622.373702556106,923.4652056975615,1806.7797502778376,54,31.524642968642272
jax_0.3.15,tests/pmap_test.py,2959,2215,2316,20,631,439,851,651,1290,5955.682660931736,13.486529318541997,162607.12062015693,9033.728923342052,12057.002715783668,305,0.0
jax_0.3.15,tests/random_test.py,1705,1128,1378,18,335,256,419,353,675,2885.044440616582,11.256716417910448,64308.25829204118,3572.68101622451,5712.878951958047,224,0.0
jax_0.3.15,tests/checkify_test.py,830,623,631,8,47,57,104,55,161,285.06567602884894,8.851063829787234,8238.56059942612,457.6978110792289,930.7989138774702,48,28.721684017066007
jax_0.3.15,tests/pjit_test.py,2051,1441,1694,13,295,211,420,308,631,2468.454203889349,9.254237288135593,48273.26948677036,2681.848304820576,5216.342307178482,171,0.0
jax_0.3.15,tests/lax_scipy_sparse_test.py,518,314,416,9,83,54,96,92,150,557.6575978147756,5.204819277108434,5093.094153644512,282.94967520247286,978.534293408552,40,34.42253852956003
jax_0.3.15,tests/scipy_optimize_test.py,237,125,165,8,80,59,115,88,174,529.7542475909889,5.75,6462.661334446617,359.0367408025898,1123.9411016428899,12,50.5938231308107
jax_0.3.15,tests/gfile_cache_test.py,85,58,58,3,8,5,10,11,15,28.75488750216347,1.875,97.296514274174,5.405361904120777,51.89147427955947,11,72.34362509216962
jax_0.3.15,tests/lax_control_flow_test.py,3071,2321,2448,15,460,410,765,475,1175,4127.528782368541,12.472826086956522,130314.16428636454,7239.675793686919,10447.845851281514,238,0.0
jax_0.3.15,tests/array_interoperability_test.py,260,164,209,6,53,32,58,59,90,319.0895590961765,3.2830188679245285,1738.154531188801,96.56414062160006,529.4378744425658,39,44.46997603825403
jax_0.3.15,tests/lax_numpy_test.py,6663,3969,5753,21,824,595,1085,845,1680,8073.915100277326,13.825849514563107,225835.8039588185,12546.433553267694,16334.31665236484,641,0.0
jax_0.3.15,tests/jax_jit_test.py,213,137,142,3,17,12,24,20,36,74.24175580341925,2.1176470588235294,329.4834594690601,18.304636637170006,155.58941141594505,21,59.04177324082919
jax_0.3.15,tests/transfer_guard_test.py,243,142,173,3,10,5,10,13,15,37.974168451037094,1.5,83.25989365817458,4.625549647676365,55.506595772116384,30,59.01478841561404
jax_0.3.15,tests/debugger_test.py,326,203,266,5,20,13,26,25,39,98.04820237218406,3.25,588.6087720539464,32.700487336330355,181.11039140121426,18,47.16687030539081
jax_0.3.15,tests/jaxpr_util_test.py,106,61,70,5,22,12,23,27,35,109.71713608445735,2.6136363636363638,434.96414082290823,24.16467449016157,166.4210625757214,20,66.75120307623529
jax_0.3.15,tests/host_callback_test.py,3038,1559,2403,16,355,308,600,371,908,3071.444701109176,13.52112676056338,104789.13859567353,5821.618810870752,7750.030041971689,205,0.0
jax_0.3.15,tests/distributed_test.py,113,60,75,6,10,7,12,16,19,48.72905595320056,3.6,273.6,15.200000000000001,76.0,13,71.13371756089646
jax_0.3.15,tests/profiler_test.py,245,168,190,5,30,16,32,35,48,158.81635834269238,2.6666666666666665,656.5482261689556,36.47490145383087,246.20558481335837,21,50.83894778150818
jax_0.3.15,tests/polynomial_test.py,134,63,81,6,16,9,17,22,26,79.50977500432694,3.1875,369.57539539456604,20.531966410809225,115.94522208456974,8,71.92208035806354
jax_0.3.15,tests/mesh_utils_test.py,274,154,194,5,64,41,80,69,121,395.6096404744368,3.125,2309.7858102192454,128.32143390106918,739.1314592701585,38,46.556611448579375
jax_0.3.15,tests/multi_device_test.py,226,137,137,7,31,18,36,38,54,173.2315700763964,4.064516129032258,1151.8354452087146,63.99085806715081,283.3880857259536,19,59.79438923690874
jax_0.3.15,tests/batching_test.py,1404,1001,1124,12,232,178,304,244,482,1866.0711408782504,7.862068965517241,30053.665877545205,1669.6481043080669,3822.6153967053115,131,4.335765425105859
jax_0.3.15,tests/host_callback_to_tf_test.py,252,135,152,4,39,25,50,43,75,214.1306865356277,2.5641025641025643,1043.5124528273266,57.97291404596259,406.96985660265733,10,59.06943272913278
jax_0.3.15,tests/scipy_fft_test.py,84,49,58,4,18,11,20,22,31,83.05865002596161,2.2222222222222223,307.20528928390274,17.066960515772376,138.24238017775622,9,71.81588774917269
jax_0.3.15,tests/stax_test.py,264,141,213,3,9,5,9,12,14,33.28421251514428,1.5,75.28421251514428,4.182456250841349,50.18947501009619,27,53.30485183785885
jax_0.3.15,tests/fft_test.py,444,284,373,14,82,57,104,96,161,574.6222332874894,8.878048780487806,9412.320546152749,522.906697008486,1060.1789626161062,61,33.5411096555188
jax_0.3.15,tests/linalg_test.py,1721,1019,1464,17,368,287,493,385,780,3206.157668130237,11.387228260869565,76285.29013782021,4238.071674323345,6699.197415754167,168,0.46461522018189916
jax_0.3.15,tests/scipy_signal_test.py,438,196,364,8,50,37,61,58,98,306.1928094887362,4.88,2801.52083110981,155.64004617276723,574.0821375225021,29,41.88704226814346
jax_0.3.15,tests/custom_linear_solve_test.py,419,270,298,11,73,43,82,84,125,489.91094060325156,6.178082191780822,4936.5328042349665,274.2518224574981,799.0396778473449,18,43.50195654489313
jax_0.3.15,tests/lax_numpy_einsum_test.py,353,246,281,4,12,6,12,16,18,51.01955000865388,2.0,144.0,8.0,72.0,49,44.584641569507845
jax_0.3.15,tests/scipy_ndimage_test.py,157,84,111,8,31,18,33,39,51,177.58008562199316,4.258064516129032,1147.7847657219565,63.76582031788647,269.55551316197466,15,61.51467517061247
jax_0.3.15,tests/tree_util_test.py,541,389,434,9,34,23,43,43,66,201.50306161549238,5.6911764705882355,2038.2007994794262,113.23337774885701,358.13347381033844,69,30.540523355982646
jax_0.3.15,tests/dynamic_api_test.py,1254,857,831,7,56,53,100,63,153,344.86336008962905,6.25,5715.773926846796,317.5429959359331,914.5238282954873,63,34.204872022848306
jax_0.3.15,tests/custom_object_test.py,375,272,278,7,26,20,38,33,58,141.86291712607164,5.115384615384615,1496.6329321819655,83.1462740101092,292.57485892279027,44,40.11905016460251
jax_0.3.15,tests/ode_test.py,258,171,170,7,88,54,96,95,150,588.0814668944854,3.8181818181818183,3762.7354847713614,209.04086026507562,985.4783412496422,23,49.31352065863135
jax_0.3.15,tests/heap_profiler_test.py,43,17,17,1,2,1,2,3,3,2.0,0.5,2.3774437510817346,0.1320802083934297,4.754887502163469,3,94.47618306454243
jax_0.3.15,tests/third_party/scipy/line_search_test.py,168,111,112,10,84,60,109,94,169,570.1739444622895,6.488095238095238,7187.028645044867,399.2793691691593,1107.7255159335207,18,54.09946977915253
jax_0.3.15,tests/benchmarks/xla.py,43,12,22,1,1,1,1,2,2,0.0,0.5,1.0,0.05555555555555555,2.0,1,100.0
jax_0.3.15,tests/filecheck/shapes.filecheck.py,109,25,25,1,2,1,2,3,3,2.0,0.5,2.3774437510817346,0.1320802083934297,4.754887502163469,2,62.49490926813355
jax_0.3.15,tests/filecheck/math.filecheck.py,472,94,99,1,2,1,2,3,3,2.0,0.5,2.3774437510817346,0.1320802083934297,4.754887502163469,2,41.59978677870601
jax_0.3.15,tests/filecheck/subcomputations.filecheck.py,73,29,29,3,8,4,8,11,12,28.75488750216347,1.5,62.26976913547136,3.4594316186372978,41.51317942364757,2,82.63167811069337
jax_0.3.15,tests/filecheck/names.filecheck.py,45,14,13,2,4,2,4,6,6,10.0,1.0,15.509775004326936,0.861654166907052,15.509775004326936,2,80.6165659868963
jax_0.3.15,tests/filecheck/array.filecheck.py,109,23,34,1,2,1,2,3,3,2.0,0.5,2.3774437510817346,0.1320802083934297,4.754887502163469,2,80.07298136276972
jax_0.3.15,tests/filecheck/jax_filecheck_helpers.py,33,13,13,0,0,0,0,0,0,0,0,0,0.0,0,1,100.0
jax_0.3.15,benchmarks/pmap_benchmark.py,156,112,94,3,10,5,10,13,15,37.974168451037094,1.5,83.25989365817458,4.625549647676365,55.506595772116384,11,68.53417642934342
jax_0.3.15,benchmarks/benchmark.py,164,91,101,13,44,27,53,57,80,288.3207075558753,7.829545454545454,3653.5101997813704,202.9727888767428,466.6312011331794,21,63.37941769088791
jax_0.3.15,benchmarks/api_benchmark.py,469,333,330,6,40,23,46,46,69,228.38689879982144,3.45,1314.8839236393721,73.04910686885401,381.1257749679339,50,33.42774560845396
jax_0.3.15,benchmarks/gda_benchmark.py,156,62,110,2,5,3,6,7,9,13.60964047443681,1.2,30.319433158222125,1.6844129532345624,25.26619429851844,12,72.46751648360699
jax_0.3.15,jax/errors.py,23,1,9,0,0,0,0,0,0,0,0,0,0.0,0,1,100.0
jax_0.3.15,jax/flatten_util.py,15,1,1,0,0,0,0,0,0,0,0,0,0.0,0,1,100.0
jax_0.3.15,jax/jaxpr_util.py,208,133,145,5,18,11,20,23,31,86.66829050039843,2.7777777777777777,389.52894621602053,21.64049701200114,140.2304206377674,24,59.065994335218576
jax_0.3.15,jax/custom_batching.py,18,1,4,0,0,0,0,0,0,0,0,0,0.0,0,1,100.0
jax_0.3.15,jax/linear_util.py,349,190,186,6,57,31,65,63,96,347.9845058117172,3.4210526315789473,1963.0645643494463,109.05914246385812,573.818872655992,47,53.77430626656326
jax_0.3.15,jax/random.py,170,4,43,0,0,0,0,0,0,0,0,0,0.0,0,1,100.0
jax_0.3.15,jax/cloud_tpu_init.py,15,1,1,0,0,0,0,0,0,0,0,0,0.0,0,1,100.0
jax_0.3.15,jax/ad_checkpoint.py,21,1,7,0,0,0,0,0,0,0,0,0,0.0,0,1,100.0
jax_0.3.15,jax/dtypes.py,25,1,11,0,0,0,0,0,0,0,0,0,0.0,0,1,100.0
jax_0.3.15,jax/distributed.py,15,1,1,0,0,0,0,0,0,0,0,0,0.0,0,1,100.0
jax_0.3.15,jax/api_util.py,25,1,10,0,0,0,0,0,0,0,0,0,0.0,0,1,100.0
jax_0.3.15,jax/core.py,2784,2004,2001,20,492,333,644,512,977,4486.155698524653,13.089430894308943,115095.36585365854,6394.186991869919,8793.0,652,0.0
jax_0.3.15,jax/__init__.py,149,36,120,0,0,0,0,0,0,0,0,0,0.0,0,2,100.0
jax_0.3.15,jax/util.py,29,1,15,0,0,0,0,0,0,0,0,0,0.0,0,1,100.0
jax_0.3.15,jax/collect_profile.py,107,45,79,4,13,7,13,17,20,56.105716335834195,2.0,163.4985136500136,9.083250758334088,81.7492568250068,7,74.46088269455383
jax_0.3.15,jax/config.py,17,1,1,0,0,0,0,0,0,0,0,0,0.0,0,1,100.0
jax_0.3.15,jax/custom_derivatives.py,28,1,14,0,0,0,0,0,0,0,0,0,0.0,0,1,100.0
jax_0.3.15,jax/prng.py,23,1,9,0,0,0,0,0,0,0,0,0,0.0,0,1,100.0
jax_0.3.15,jax/version.py,25,6,6,0,0,0,0,0,0,0,0,0,0.0,0,3,100.0
jax_0.3.15,jax/custom_transpose.py,17,1,3,0,0,0,0,0,0,0,0,0,0.0,0,1,100.0
jax_0.3.15,jax/test_util.py,47,18,24,1,2,1,2,3,3,2.0,0.5,2.3774437510817346,0.1320802083934297,4.754887502163469,5,95.36177125532097
jax_0.3.15,jax/stages.py,19,1,5,0,0,0,0,0,0,0,0,0,0.0,0,1,100.0
jax_0.3.15,jax/tree_util.py,61,2,24,0,0,0,0,0,0,0,0,0,0.0,0,1,100.0
jax_0.3.15,jax/dlpack.py,15,1,1,0,0,0,0,0,0,0,0,0,0.0,0,1,100.0
jax_0.3.15,jax/abstract_arrays.py,21,2,5,0,0,0,0,0,0,0,0,0,0.0,0,1,100.0
jax_0.3.15,jax/profiler.py,26,1,12,0,0,0,0,0,0,0,0,0,0.0,0,1,100.0
jax_0.3.15,jax/ops/__init__.py,20,1,6,0,0,0,0,0,0,0,0,0,0.0,0,1,100.0
jax_0.3.15,jax/nn/__init__.py,44,4,28,0,0,0,0,0,0,0,0,0,0.0,0,1,100.0
jax_0.3.15,jax/nn/initializers.py,39,2,20,0,0,0,0,0,0,0,0,0,0.0,0,1,100.0
jax_0.3.15,jax/scipy/special.py,47,1,33,0,0,0,0,0,0,0,0,0,0.0,0,1,100.0
jax_0.3.15,jax/scipy/signal.py,25,1,11,0,0,0,0,0,0,0,0,0,0.0,0,1,100.0
jax_0.3.15,jax/scipy/linalg.py,44,2,29,0,0,0,0,0,0,0,0,0,0.0,0,1,100.0
jax_0.3.15,jax/scipy/__init__.py,23,9,9,0,0,0,0,0,0,0,0,0,0.0,0,1,100.0
jax_0.3.15,jax/scipy/ndimage.py,17,1,3,0,0,0,0,0,0,0,0,0,0.0,0,1,100.0
jax_0.3.15,jax/scipy/fft.py,18,1,4,0,0,0,0,0,0,0,0,0,0.0,0,1,100.0
jax_0.3.15,jax/scipy/cluster/__init__.py,15,1,1,0,0,0,0,0,0,0,0,0,0.0,0,1,100.0
jax_0.3.15,jax/scipy/cluster/vq.py,15,1,1,0,0,0,0,0,0,0,0,0,0.0,0,1,100.0
jax_0.3.15,jax/scipy/optimize/__init__.py,18,1,4,0,0,0,0,0,0,0,0,0,0.0,0,1,100.0
jax_0.3.15,jax/scipy/sparse/linalg.py,19,1,5,0,0,0,0,0,0,0,0,0,0.0,0,1,100.0
jax_0.3.15,jax/scipy/sparse/__init__.py,15,1,1,0,0,0,0,0,0,0,0,0,0.0,0,1,100.0
jax_0.3.15,jax/scipy/stats/norm.py,21,1,7,0,0,0,0,0,0,0,0,0,0.0,0,1,100.0
jax_0.3.15,jax/scipy/stats/nbinom.py,18,1,4,0,0,0,0,0,0,0,0,0,0.0,0,1,100.0
jax_0.3.15,jax/scipy/stats/laplace.py,19,1,5,0,0,0,0,0,0,0,0,0,0.0,0,1,100.0
jax_0.3.15,jax/scipy/stats/chi2.py,18,1,4,0,0,0,0,0,0,0,0,0,0.0,0,1,100.0
jax_0.3.15,jax/scipy/stats/betabinom.py,18,1,4,0,0,0,0,0,0,0,0,0,0.0,0,1,100.0
jax_0.3.15,jax/scipy/stats/gennorm.py,19,1,5,0,0,0,0,0,0,0,0,0,0.0,0,1,100.0
jax_0.3.15,jax/scipy/stats/beta.py,18,1,4,0,0,0,0,0,0,0,0,0,0.0,0,1,100.0
jax_0.3.15,jax/scipy/stats/__init__.py,34,20,20,0,0,0,0,0,0,0,0,0,0.0,0,1,100.0
jax_0.3.15,jax/scipy/stats/gamma.py,18,1,4,0,0,0,0,0,0,0,0,0,0.0,0,1,100.0
jax_0.3.15,jax/scipy/stats/logistic.py,22,1,8,0,0,0,0,0,0,0,0,0,0.0,0,1,100.0
jax_0.3.15,jax/scipy/stats/dirichlet.py,18,1,4,0,0,0,0,0,0,0,0,0,0.0,0,1,100.0
jax_0.3.15,jax/scipy/stats/bernoulli.py,18,1,4,0,0,0,0,0,0,0,0,0,0.0,0,1,100.0
jax_0.3.15,jax/scipy/stats/geom.py,18,1,4,0,0,0,0,0,0,0,0,0,0.0,0,1,100.0
jax_0.3.15,jax/scipy/stats/uniform.py,18,1,4,0,0,0,0,0,0,0,0,0,0.0,0,1,100.0
jax_0.3.15,jax/scipy/stats/cauchy.py,18,1,4,0,0,0,0,0,0,0,0,0,0.0,0,1,100.0
jax_0.3.15,jax/scipy/stats/expon.py,18,1,4,0,0,0,0,0,0,0,0,0,0.0,0,1,100.0
jax_0.3.15,jax/scipy/stats/t.py,18,1,4,0,0,0,0,0,0,0,0,0,0.0,0,1,100.0
jax_0.3.15,jax/scipy/stats/poisson.py,19,1,5,0,0,0,0,0,0,0,0,0,0.0,0,1,100.0
jax_0.3.15,jax/scipy/stats/multivariate_normal.py,18,1,4,0,0,0,0,0,0,0,0,0,0.0,0,1,100.0
jax_0.3.15,jax/scipy/stats/pareto.py,18,1,4,0,0,0,0,0,0,0,0,0,0.0,0,1,100.0
jax_0.3.15,jax/scipy/interpolate/__init__.py,18,1,2,0,0,0,0,0,0,0,0,0,0.0,0,1,100.0
jax_0.3.15,jax/lax/linalg.py,40,2,24,0,0,0,0,0,0,0,0,0,0.0,0,1,100.0
jax_0.3.15,jax/lax/__init__.py,360,11,346,0,0,0,0,0,0,0,0,0,0.0,0,1,100.0
jax_0.3.15,jax/interpreters/sharded_jit.py,461,177,267,13,36,26,50,49,76,234.2230163877574,9.027777777777779,3852.314809712379,214.0174894284655,426.7179481527558,33,56.89651685036329
jax_0.3.15,jax/interpreters/pxla.py,2864,1597,2017,19,435,280,525,454,805,3893.4297647256276,11.46551724137931,81466.75980963808,4525.931100535449,7105.371532269187,465,0.0
jax_0.3.15,jax/interpreters/__init__.py,18,3,3,0,0,0,0,0,0,0,0,0,0.0,0,1,100.0
jax_0.3.15,jax/interpreters/batching.py,713,517,569,17,202,130,253,219,383,1616.4455878171184,10.646039603960396,31701.174633418315,1761.1763685232397,2977.7434438272494,167,12.744935711270001
jax_0.3.15,jax/interpreters/partial_eval.py,2517,1696,1915,19,584,360,666,603,1026,5447.568165141358,10.83390410958904,102663.70650470511,5703.539250261395,9476.150560889488,625,0.0
jax_0.3.15,jax/interpreters/ad.py,802,566,621,15,177,113,206,192,319,1380.3695412988184,8.728813559322035,21120.263803914837,1173.3479891063798,2419.603037730049,181,10.652096479250776
jax_0.3.15,jax/interpreters/xla.py,574,348,391,13,91,54,104,104,158,640.3150285939156,7.428571428571429,7864.401817749601,436.91121209720006,1058.6694754662924,81,35.84379093582945
jax_0.3.15,jax/interpreters/masking.py,580,415,393,17,182,117,218,199,335,1435.9054928174185,10.18131868131868,26046.554485305343,1447.0308047391857,2558.2692478821223,156,22.152977315553258
jax_0.3.15,jax/interpreters/mlir.py,1514,911,1108,17,203,131,256,220,387,1625.5500594898465,10.719211822660098,32279.686655545218,1793.3159253080676,3011.386209134044,219,3.574057034026802
jax_0.3.15,jax/tools/__init__.py,13,0,0,0,0,0,0,0,0,0,0,0,0.0,0,1,100.0
jax_0.3.15,jax/tools/jax_to_ir.py,249,107,127,8,22,14,24,30,38,122.10749561002054,4.363636363636363,813.6516769445399,45.20287094136333,186.46184263312372,26,65.57335083291308
jax_0.3.15,jax/tools/colab_tpu.py,47,15,13,2,3,2,3,5,5,6.754887502163469,1.0,11.60964047443681,0.6449800263576005,11.60964047443681,2,77.61391406611567
jax_0.3.15,jax/image/__init__.py,27,2,5,0,0,0,0,0,0,0,0,0,0.0,0,1,100.0
jax_0.3.15,jax/experimental/maps.py,1965,1082,1413,21,399,253,474,420,727,3539.6963954310704,12.473684210526315,79023.98886570291,4390.221603650161,6335.256491343272,304,0.0
jax_0.3.15,jax/experimental/mesh_utils.py,324,120,166,8,39,28,51,47,79,230.1306865356277,5.230769230769231,2295.327023939405,127.51816799663362,438.81251928253334,32,60.37401908037505
jax_0.3.15,jax/experimental/sharding.py,288,185,191,7,27,19,35,34,54,148.0334470128169,4.537037037037037,1246.4283961063334,69.2460220059074,274.72299342751836,67,47.12120733734738
jax_0.3.15,jax/experimental/host_callback.py,2040,721,1032,17,298,202,366,315,568,2518.79908739898,10.439597315436242,49211.74137743357,2733.985632079643,4713.9501544439745,176,17.2343033356361
jax_0.3.15,jax/experimental/x64_context.py,65,13,10,0,0,0,0,0,0,0,0,0,0.0,0,1,100.0
jax_0.3.15,jax/experimental/__init__.py,23,3,9,0,0,0,0,0,0,0,0,0,0.0,0,1,100.0
jax_0.3.15,jax/experimental/ode.py,263,152,165,14,257,189,350,271,539,2110.7484780516334,9.53307392996109,41528.72341073874,2307.1513005965967,4356.278333289737,6,52.82992974061901
jax_0.3.15,jax/experimental/pjit.py,1532,741,1049,17,269,176,318,286,494,2240.710243828988,10.048327137546469,40504.56995656551,2250.2538864758617,4030.976440368524,251,4.233299862091724
jax_0.3.15,jax/experimental/checkify.py,29,1,15,0,0,0,0,0,0,0,0,0,0.0,0,1,100.0
jax_0.3.15,jax/experimental/callback.py,293,201,222,4,17,10,19,21,29,77.48686830125578,2.235294117647059,284.72551764130554,15.818084313405864,127.37720526058406,38,47.65595347688339
jax_0.3.15,jax/experimental/global_device_array.py,578,230,274,10,43,29,57,53,86,266.54866540106383,6.627906976744186,3264.914659101024,181.38414772783466,492.6011590924352,63,49.13717111203915
jax_0.3.15,jax/experimental/optimizers.py,30,5,6,0,0,0,0,0,0,0,0,0,0.0,0,1,100.0
jax_0.3.15,jax/experimental/array.py,269,170,184,9,33,19,35,42,54,194.9943309518098,4.7727272727272725,1389.7472630525258,77.20818128069588,291.18514083005306,52,51.908601227770276
jax_0.3.15,jax/experimental/stax.py,30,5,6,0,0,0,0,0,0,0,0,0,0.0,0,1,100.0
jax_0.3.15,jax/experimental/jet.py,703,477,472,13,343,225,443,356,668,2936.8739311331083,8.395043731778426,47530.974078322026,2640.6096710178904,5661.789931885554,77,29.75682155467549
jax_0.3.15,jax/experimental/multihost_utils.py,180,68,71,5,15,9,16,20,25,70.2129994085646,2.6666666666666665,288.12853965915747,16.007141092175416,108.04820237218406,5,70.33816082881823
jax_0.3.15,jax/experimental/loops.py,619,271,289,12,65,39,70,77,109,434.4734578555034,6.461538461538462,4413.745966661732,245.20810925898513,683.0797329357443,70,45.78454173260678
jax_0.3.15,jax/experimental/gda_serialization/serialization_test.py,200,95,151,2,3,2,4,5,6,6.754887502163469,1.3333333333333333,18.575424759098897,1.0319680421721609,13.931568569324174,11,66.09855146728209
jax_0.3.15,jax/experimental/gda_serialization/__init__.py,13,0,0,0,0,0,0,0,0,0,0,0,0.0,0,1,100.0
jax_0.3.15,jax/experimental/gda_serialization/serialization.py,443,221,257,16,70,44,84,86,128,493.04981118614774,9.6,7896.594130577938,438.69967392099653,822.5618886018685,43,50.31595025327106
jax_0.3.15,jax/experimental/sparse/random.py,83,38,38,8,22,19,34,30,53,122.10749561002054,6.181818181818182,1607.6757915066457,89.31532175036921,260.0652015672515,7,74.06601071198412
jax_0.3.15,jax/experimental/sparse/transform.py,805,507,571,14,97,72,137,111,209,693.4945146009578,9.88659793814433,14039.294500086786,779.960805560377,1420.0329160671722,109,25.87083666550687
jax_0.3.15,jax/experimental/sparse/linalg.py,504,165,172,13,101,66,127,114,193,720.5850760937656,8.173267326732674,10778.478083086615,598.8043379492564,1318.7477727337953,13,47.30300936171878
jax_0.3.15,jax/experimental/sparse/__init__.py,262,10,71,0,0,0,0,0,0,0,0,0,0.0,0,1,100.0
jax_0.3.15,jax/experimental/sparse/util.py,69,37,33,5,15,7,15,20,22,70.2129994085646,2.5,237.70604521880495,13.205891401044719,95.08241808752197,11,79.7008225838342
jax_0.3.15,jax/experimental/sparse/csr.py,536,345,359,14,94,84,146,108,230,669.4343209665043,10.872340425531915,16891.530385729202,938.4183547627334,1553.6241254975978,86,34.879715358695066
jax_0.3.15,jax/experimental/sparse/bcoo.py,2243,1435,1533,18,638,503,952,656,1455,6019.567897607948,13.429467084639498,182845.39280948442,10158.07737830469,13615.238166719311,387,0.0
jax_0.3.15,jax/experimental/sparse/ad.py,101,55,62,4,7,5,8,11,13,27.651484454403228,2.2857142857142856,102.79453952522255,5.710807751401252,44.97261104228487,2,78.0499340692822
jax_0.3.15,jax/experimental/sparse/_base.py,116,78,72,0,0,0,0,0,0,0,0,0,0.0,0,26,100.0
jax_0.3.15,jax/experimental/sparse/coo.py,602,347,377,15,79,59,101,94,160,556.6020380401189,9.58860759493671,10055.900871181388,558.6611595100771,1048.734216268422,76,40.12385286534167
jax_0.3.15,jax/experimental/sparse/api.py,152,81,74,4,10,6,10,14,16,41.219280948873624,2.0,121.83535750584332,6.768630972546851,60.91767875292166,12,73.01016248023232
jax_0.3.15,jax/experimental/compilation_cache/cache_interface.py,24,8,8,0,0,0,0,0,0,0,0,0,0.0,0,3,100.0
jax_0.3.15,jax/experimental/compilation_cache/compilation_cache.py,224,127,161,5,25,15,29,30,44,127.70604521880493,2.9,626.119239999647,34.78440222220261,215.90318620677482,24,58.590130341885526
jax_0.3.15,jax/experimental/compilation_cache/__init__.py,13,0,0,0,0,0,0,0,0,0,0,0,0.0,0,1,100.0
jax_0.3.15,jax/experimental/compilation_cache/gfile_cache.py,57,37,34,4,10,8,14,14,22,41.219280948873624,2.8,234.53306319874835,13.029614622152685,83.76180828526728,10,79.37465032418382
jax_0.3.15,jax/experimental/jax2tf/jax2tf.py,2937,1451,1900,22,363,240,439,385,679,3184.9962385024783,13.303030303030303,77579.77719057567,4309.987621698649,5831.737237560358,256,0.0
jax_0.3.15,jax/experimental/jax2tf/__init__.py,17,2,3,0,0,0,0,0,0,0,0,0,0.0,0,1,100.0
jax_0.3.15,jax/experimental/jax2tf/call_tf.py,434,191,255,9,81,44,86,90,130,542.0571752466354,4.777777777777778,4032.1620898314313,224.00900499063508,843.9409025228578,22,55.73190830195985
jax_0.3.15,jax/experimental/jax2tf/impl_no_xla.py,1025,502,618,19,277,200,376,296,576,2328.2172027510533,12.895306859205776,60977.33009056796,3387.6294494759977,4728.6451386022745,117,27.929240836757984
jax_0.3.15,jax/experimental/jax2tf/shape_poly.py,888,585,585,17,222,155,284,239,439,1799.8471906309794,10.873873873873874,37715.81980310976,2095.323322394987,3468.480528703549,166,19.20339721447288
jax_0.3.15,jax/experimental/jax2tf/converters_eval/models.py,225,121,174,0,0,0,0,0,0,0,0,0,0.0,0,1,100.0
jax_0.3.15,jax/experimental/jax2tf/converters_eval/converters.py,183,94,98,4,9,5,9,13,14,36.52932501298081,2.0,103.61231210795059,5.75623956155281,51.80615605397529,12,72.41694228541505
jax_0.3.15,jax/experimental/jax2tf/converters_eval/models_test.py,171,88,108,8,29,16,31,37,47,164.8814488586996,4.275862068965517,1046.9204901684661,58.162249453803675,244.84430818456065,18,64.13629683707228
jax_0.3.15,jax/experimental/jax2tf/converters_eval/test_models/flax/cnn.py,37,17,15,1,1,1,1,2,2,0.0,0.5,1.0,0.05555555555555555,2.0,2,94.32058572664872
jax_0.3.15,jax/experimental/jax2tf/converters_eval/test_models/flax/vae.py,65,38,35,2,6,3,6,8,9,17.509775004326936,1.0,27.0,1.5,27.0,6,83.52839247064115
jax_0.3.15,jax/experimental/jax2tf/converters_eval/test_models/flax/transformer_wmt.py,597,252,348,12,52,54,101,64,155,339.4424153519907,11.653846153846153,10838.076923076922,602.1153846153845,930.0,34,51.1570788637005
jax_0.3.15,jax/experimental/jax2tf/converters_eval/test_models/flax/resnet.py,144,98,97,8,14,12,23,22,35,77.30296890880645,6.571428571428571,1025.6692722865782,56.981626238143235,156.0801066523054,10,63.07159208106543
jax_0.3.15,jax/experimental/jax2tf/converters_eval/test_models/flax/seq2seq_lstm.py,202,98,90,2,2,2,2,4,4,4.0,1.0,8.0,0.4444444444444444,8.0,9,76.41335210148328
jax_0.3.15,jax/experimental/jax2tf/converters_eval/test_models/flax/bilstm_classifier.py,402,191,183,6,12,9,14,18,23,58.52932501298082,3.5,335.67896261610616,18.648831256450343,95.90827503317318,20,61.826404880764656
jax_0.3.15,jax/experimental/jax2tf/converters_eval/test_models/flax/gnn.py,191,113,125,2,6,5,10,8,15,17.509775004326936,1.6666666666666667,75.0,4.166666666666667,45.0,13,66.73013140156391
jax_0.3.15,jax/experimental/jax2tf/converters_eval/test_models/flax/transformer_lm1b.py,385,189,218,12,45,41,76,57,117,290.15293934348927,10.133333333333333,6915.474400793719,384.1930222663177,682.4481316572749,21,56.72800361363689
jax_0.3.15,jax/experimental/jax2tf/converters_eval/test_models/flax/actor_critic.py,59,25,24,2,3,2,3,5,5,6.754887502163469,1.0,11.60964047443681,0.6449800263576005,11.60964047443681,2,85.45904360971755
jax_0.3.15,jax/experimental/jax2tf/converters_eval/test_models/flax/transformer_nlp_seq.py,230,124,122,8,21,19,32,29,51,116.23866587835397,6.095238095238095,1510.138092199657,83.89656067775871,247.75703075150622,11,65.25976042229941
jax_0.3.15,jax/experimental/jax2tf/tests/savedmodel_test.py,329,199,218,4,17,13,26,21,39,77.48686830125578,3.0588235294117645,523.9776313761956,29.109868409788646,171.30037948837168,14,58.21395305592652
jax_0.3.15,jax/experimental/jax2tf/tests/sharding_test.py,258,113,195,8,16,12,23,24,35,88.0,5.75,922.7237032701329,51.26242795945183,160.4736875252405,18,63.91624996131367
jax_0.3.15,jax/experimental/jax2tf/tests/jax2tf_test.py,1339,838,1024,11,156,119,234,167,353,1174.5764939475212,8.25,21503.19282575756,1194.6218236531977,2606.447615243341,95,19.090951221914835
jax_0.3.15,jax/experimental/jax2tf/tests/jax2tf_limitations.py,1256,432,991,19,149,133,215,168,348,1156.3667323042903,13.708053691275168,35264.330878771245,1959.1294932650692,2572.526463127009,79,29.734231395744356
jax_0.3.15,jax/experimental/jax2tf/tests/call_tf_test.py,992,655,688,8,177,112,223,185,335,1345.7661823646906,5.03954802259887,12714.844113172227,706.3802285095682,2523.0127892729643,75,27.05547614468744
jax_0.3.15,jax/experimental/jax2tf/tests/primitive_harness.py,3157,819,2481,17,247,245,392,264,637,2032.7335745026712,13.489878542510121,69125.90205681138,3840.3278920450766,5124.279054031335,308,0.0
jax_0.3.15,jax/experimental/jax2tf/tests/control_flow_ops_test.py,305,204,202,4,54,42,84,58,126,318.76392511682735,3.111111111111111,2296.3285500900083,127.57380833833379,738.1056053860741,17,52.17230498507269
jax_0.3.15,jax/experimental/jax2tf/tests/tf_test_util.py,498,275,338,12,68,45,85,80,130,456.967023213677,7.5,6163.879892515178,342.43777180639876,821.850652335357,68,43.84782885627858
jax_0.3.15,jax/experimental/jax2tf/tests/__init__.py,13,0,0,0,0,0,0,0,0,0,0,0,0.0,0,1,100.0
jax_0.3.15,jax/experimental/jax2tf/tests/shape_poly_test.py,2054,682,1656,16,260,247,455,276,702,2149.8156313873983,14.0,79690.57836121583,4427.254353400879,5692.184168658274,100,18.222673477469115
jax_0.3.15,jax/experimental/jax2tf/tests/primitives_test.py,320,152,214,8,42,27,49,50,76,250.47733175670794,4.666666666666667,2001.6876619734358,111.20487010963532,428.93307042287904,41,55.45578350928203
jax_0.3.15,jax/experimental/jax2tf/tests/jax_primitives_coverage_test.py,154,70,96,3,5,3,5,8,8,16.36452797660028,1.5,36.0,2.0,24.0,21,74.850919135699
jax_0.3.15,jax/experimental/jax2tf/examples/saved_model_main.py,206,94,147,7,35,23,43,42,66,199.17639004747704,4.3,1530.3396845846123,85.01887136581179,355.89294990339823,18,59.65560372878955
jax_0.3.15,jax/experimental/jax2tf/examples/mnist_lib.py,318,168,185,7,45,33,57,52,90,266.7848737892386,4.433333333333334,2274.475447538296,126.3597470854609,513.0395746326983,25,58.18248517421213
jax_0.3.15,jax/experimental/jax2tf/examples/saved_model_lib.py,151,36,51,3,6,4,6,9,10,20.264662506490406,1.5,47.548875021634686,2.6416041678685938,31.699250014423125,10,67.75825749254653
jax_0.3.15,jax/experimental/jax2tf/examples/saved_model_main_test.py,65,31,41,1,2,1,2,3,3,2.0,0.5,2.3774437510817346,0.1320802083934297,4.754887502163469,5,88.93919675570635
jax_0.3.15,jax/experimental/jax2tf/examples/__init__.py,13,0,0,0,0,0,0,0,0,0,0,0,0.0,0,1,100.0
jax_0.3.15,jax/experimental/jax2tf/examples/keras_reuse_main.py,79,33,42,1,2,1,2,3,3,2.0,0.5,2.3774437510817346,0.1320802083934297,4.754887502163469,3,90.49544489294601
jax_0.3.15,jax/experimental/jax2tf/examples/keras_reuse_main_test.py,50,25,28,1,2,1,2,3,3,2.0,0.5,2.3774437510817346,0.1320802083934297,4.754887502163469,4,93.09737313735253
jax_0.3.15,jax/experimental/jax2tf/examples/serving/__init__.py,13,0,0,0,0,0,0,0,0,0,0,0,0.0,0,1,100.0
jax_0.3.15,jax/experimental/jax2tf/examples/serving/model_server_request.py,127,56,78,7,18,11,22,25,33,94.71013448036484,4.277777777777778,655.5576987898653,36.41987215499252,153.24725426256592,6,74.5085914090044
jax_0.3.15,jax/experimental/jax2tf/examples/tflite/mnist/mnist.py,135,59,78,6,25,16,32,31,48,131.60617974869504,3.84,913.1574639305088,50.7309702183616,237.80142289857002,5,72.81256660618052
jax_0.3.15,jax/experimental/jax2tf/examples/tf_js/quickdraw/utils.py,75,51,49,7,15,9,17,22,26,78.25484338853101,3.966666666666667,459.91604760212664,25.55089153345148,115.94522208456974,8,74.68509813678746
jax_0.3.15,jax/experimental/jax2tf/examples/tf_js/quickdraw/quickdraw.py,164,109,116,8,22,16,25,30,41,122.10749561002054,4.545454545454546,914.4659746361331,50.80366525756295,201.18251441994926,9,63.10044465526242
jax_0.3.15,jax/example_libraries/__init__.py,13,0,0,0,0,0,0,0,0,0,0,0,0.0,0,1,100.0
jax_0.3.15,jax/example_libraries/optimizers.py,620,296,286,10,141,115,227,151,342,1039.8960216371036,8.049645390070921,19927.174238750464,1107.0652354861368,2475.534420849177,12,49.1849600084655
jax_0.3.15,jax/example_libraries/stax.py,356,240,230,13,82,55,104,95,159,569.4249807145172,8.24390243902439,8611.638539095655,478.4243632830919,1044.6070417246208,8,51.21886374774841
jax_0.3.15,jax/lib/xla_bridge.py,25,1,10,0,0,0,0,0,0,0,0,0,0.0,0,1,100.0
jax_0.3.15,jax/lib/__init__.py,21,2,6,0,0,0,0,0,0,0,0,0,0.0,0,1,100.0
jax_0.3.15,jax/numpy/linalg.py,54,13,35,1,2,1,2,3,3,2.0,0.5,2.3774437510817346,0.1320802083934297,4.754887502163469,3,99.37480656900803
jax_0.3.15,jax/numpy/__init__.py,429,20,399,1,2,1,2,3,3,2.0,0.5,2.3774437510817346,0.1320802083934297,4.754887502163469,3,78.93166579902825
jax_0.3.15,jax/numpy/fft.py,50,12,31,1,2,1,2,3,3,2.0,0.5,2.3774437510817346,0.1320802083934297,4.754887502163469,3,100.0
jax_0.3.15,jax/_src/errors.py,548,35,35,0,0,0,0,0,0,0,0,0,0.0,0,7,100.0
jax_0.3.15,jax/_src/flatten_util.py,85,43,39,4,6,5,7,10,12,23.509775004326936,2.3333333333333335,93.01398665684617,5.167443703158121,39.863137138648355,8,79.96458932672383
jax_0.3.15,jax/_src/custom_batching.py,265,164,186,9,30,21,37,39,58,175.7360428812364,5.55,1701.3709742517578,94.52060968065321,306.5533286940104,20,51.3938276948668
jax_0.3.15,jax/_src/dispatch.py,1084,683,808,14,209,129,245,223,374,1664.141027513711,8.205741626794259,23940.551219176472,1330.0306232875819,2917.536562570194,228,3.980654819970237
jax_0.3.15,jax/_src/random.py,1680,790,891,23,346,248,424,369,672,3022.4232917516183,14.092485549132949,80756.48883353159,4486.471601862866,5730.464548072586,97,26.662742760639922
jax_0.3.15,jax/_src/traceback_util.py,194,115,114,9,34,21,39,43,60,201.50306161549238,5.161764705882353,1680.5461137356792,93.36367298531552,325.57588528212585,22,63.48245124560143
jax_0.3.15,jax/_src/pretty_printer.py,412,298,286,13,89,64,127,102,191,624.4459916918437,9.275280898876405,11820.72629080131,656.7070161556284,1274.4332403165556,86,35.77776810405372
jax_0.3.15,jax/_src/custom_api_util.py,26,9,9,2,4,2,4,6,6,10.0,1.0,15.509775004326936,0.861654166907052,15.509775004326936,3,88.16896230816141
jax_0.3.15,jax/_src/cloud_tpu_init.py,115,40,62,5,10,6,11,15,17,44.82892142331043,2.75,182.64713534469826,10.147063074705459,66.41714012534482,7,80.59037072532448
jax_0.3.15,jax/_src/ad_checkpoint.py,425,206,232,11,55,36,62,66,98,356.02853204886657,6.2,3672.5738669221964,204.03188149567757,592.3506236971284,47,53.02710947672601
jax_0.3.15,jax/_src/lax_reference.py,460,331,355,19,175,114,219,194,333,1384.672567326086,11.888571428571428,30087.251522861232,1671.5139734922907,2530.7709764483134,57,32.27311785085759
jax_0.3.15,jax/_src/dtypes.py,475,271,300,16,112,68,131,128,199,826.4237512704516,9.357142857142858,13034.5,724.1388888888889,1393.0,83,41.540735012359164
jax_0.3.15,jax/_src/distributed.py,153,70,77,8,17,15,30,25,45,93.48686830125578,7.0588235294117645,1475.107260281383,81.95040334896572,208.9735285398626,21,69.9207029843055
jax_0.3.15,jax/_src/api_util.py,443,274,303,18,106,73,135,124,208,788.2182182096607,11.462264150943396,16579.853693971425,921.1029829984125,1446.4728325604701,85,38.132046760928326
jax_0.3.15,jax/_src/__init__.py,13,0,0,0,0,0,0,0,0,0,0,0,0.0,0,1,100.0
jax_0.3.15,jax/_src/util.py,563,409,386,16,111,74,134,127,208,818.1801611648618,9.657657657657658,14038.819429889287,779.9344127716271,1453.6464148486107,97,31.99582138612835
jax_0.3.15,jax/_src/device_array.py,328,205,197,10,49,28,55,59,83,308.3400633105188,5.612244897959184,2740.231175544572,152.23506530803178,488.25937309703284,39,52.54669098985711
jax_0.3.15,jax/_src/debugging.py,165,84,96,7,13,7,13,20,20,67.75720079023742,3.5,302.53496664211536,16.807498146784187,86.43856189774725,9,72.27858823069708
jax_0.3.15,jax/_src/config.py,1022,373,690,12,71,45,87,83,132,479.6515954934863,7.352112676056338,6186.8410841905425,343.71339356614124,841.5052049377941,67,40.016244773930275
jax_0.3.15,jax/_src/custom_derivatives.py,1230,578,668,14,124,81,151,138,232,915.6233113967791,8.524193548387096,14057.909688620726,780.9949827011515,1649.1776739725356,125,29.647110631839926
jax_0.3.15,jax/_src/prng.py,589,349,384,16,151,91,166,167,257,1156.999115638087,8.794701986754967,16688.932054332614,927.1628919073675,1897.6120031658315,76,35.92029380221402
jax_0.3.15,jax/_src/checkify.py,828,494,535,17,98,55,104,115,159,717.7284330245462,9.020408163265307,9818.109179597324,545.4505099776292,1088.4329181001558,65,38.210605809066514
jax_0.3.15,jax/_src/custom_transpose.py,229,130,148,8,24,16,30,32,46,134.03910001730776,5.0,1150.0,63.888888888888886,230.0,20,59.384147483118085
jax_0.3.15,jax/_src/test_util.py,1036,709,735,16,210,124,232,226,356,1683.9915587098858,8.838095238095239,24605.11317576363,1366.9507319868683,2783.983710619807,132,15.155782180162138
jax_0.3.15,jax/_src/stages.py,514,241,227,8,33,21,39,41,60,190.46500593882897,4.7272727272727275,1519.5965685825838,84.42203158792132,321.453120277085,73,48.93042100750078
jax_0.3.15,jax/_src/tree_util.py,544,249,284,10,50,28,53,60,81,315.41209043760983,5.3,2535.828132694737,140.8793407052632,478.45813824429,53,51.06504837502212
jax_0.3.15,jax/_src/dlpack.py,66,23,27,1,2,2,2,3,4,2.0,0.5,3.1699250014423126,0.17610694452457293,6.339850002884625,4,88.05093112423323
jax_0.3.15,jax/_src/abstract_arrays.py,75,40,46,0,0,0,0,0,0,0,0,0,0.0,0,3,100.0
jax_0.3.15,jax/_src/profiler.py,342,136,127,5,17,9,18,22,27,81.0965087756926,2.6470588235294117,318.71820097907744,17.706566721059858,120.40465370320703,16,60.920911960317994
jax_0.3.15,jax/_src/public_test_util.py,270,159,182,12,37,28,51,49,79,235.76932453692504,8.27027027027027,3668.378264098407,203.7987924499115,443.5620776851015,23,53.641967957090976
jax_0.3.15,jax/_src/source_info_util.py,233,173,169,6,20,14,23,26,37,101.94833690207419,3.45,600.0111300207105,33.33395166781725,173.91626957122043,33,50.17570501520083
jax_0.3.15,jax/_src/iree.py,207,109,136,7,21,12,22,28,34,111.8901503327572,3.6666666666666665,599.3169136165145,33.29538408980636,163.45006734995852,37,58.69698437167049
jax_0.3.15,jax/_src/ad_util.py,91,62,55,2,3,2,3,5,5,6.754887502163469,1.0,11.60964047443681,0.6449800263576005,11.60964047443681,6,77.35839230982945
jax_0.3.15,jax/_src/api.py,3366,1119,1551,17,304,212,375,321,587,2576.856832388106,10.485197368421053,51247.598592923605,2847.088810717978,4887.614108940792,184,9.948605297120375
jax_0.3.15,jax/_src/third_party/__init__.py,0,0,0,0,0,0,0,0,0,0,0,0,0.0,0,1,100.0
jax_0.3.15,jax/_src/third_party/scipy/linalg.py,77,53,61,11,48,42,84,59,126,306.1319478396258,9.625,7134.175358113574,396.3430754507541,741.2130242195921,6,49.15101299578774
jax_0.3.15,jax/_src/third_party/scipy/__init__.py,0,0,0,0,0,0,0,0,0,0,0,0,0.0,0,1,100.0
jax_0.3.15,jax/_src/third_party/scipy/signal_helper.py,79,28,26,7,12,11,22,19,33,62.67103446305711,6.416666666666667,899.4986509716792,49.9721472762044,140.1816079436383,8,67.34693227827228
jax_0.3.15,jax/_src/third_party/scipy/interpolate.py,158,103,124,15,73,54,98,88,152,510.460551732369,10.068493150684931,9885.584937454232,549.1991631919018,981.8336060328693,33,49.45572551885715
jax_0.3.15,jax/_src/third_party/numpy/linalg.py,207,136,135,15,85,71,121,100,192,603.4015885058325,10.676470588235293,13619.123558898214,756.6179754943453,1275.6203884367474,35,52.44156611163639
jax_0.3.15,jax/_src/third_party/numpy/__init__.py,0,0,0,0,0,0,0,0,0,0,0,0,0.0,0,1,100.0
jax_0.3.15,jax/_src/ops/scatter.py,410,96,154,10,29,22,43,39,65,174.10072980757323,7.413793103448276,2547.017103744825,141.50095020804582,343.5511442260462,22,57.81648615360021
jax_0.3.15,jax/_src/ops/__init__.py,13,0,0,0,0,0,0,0,0,0,0,0,0.0,0,1,100.0
jax_0.3.15,jax/_src/nn/functions.py,463,145,147,13,83,52,100,96,152,577.233989137629,7.831325301204819,7838.485482786147,435.4714157103415,1000.9143001096157,7,48.12466288888468
jax_0.3.15,jax/_src/nn/__init__.py,13,0,0,0,0,0,0,0,0,0,0,0,0.0,0,1,100.0
jax_0.3.15,jax/_src/nn/initializers.py,564,165,171,10,88,68,128,98,196,601.6492633889558,7.2727272727272725,9428.968214156952,523.831567453164,1296.483129446581,7,41.306434934946
jax_0.3.15,jax/_src/debugger/core.py,134,87,95,5,8,5,8,13,13,35.60964047443681,2.5,120.26429083958548,6.681349491088082,48.105716335834195,13,67.10372329102803
jax_0.3.15,jax/_src/debugger/colab_lib.py,168,115,104,2,3,2,3,5,5,6.754887502163469,1.0,11.60964047443681,0.6449800263576005,11.60964047443681,26,65.8242684935842
jax_0.3.15,jax/_src/debugger/__init__.py,19,5,5,0,0,0,0,0,0,0,0,0,0.0,0,1,100.0
jax_0.3.15,jax/_src/debugger/cli_debugger.py,117,81,83,7,21,16,29,28,45,111.8901503327572,4.833333333333333,1045.5996955475287,58.088871974862705,216.33097149259217,26,59.9002437649148
jax_0.3.15,jax/_src/debugger/colab_debugger.py,313,209,237,9,23,18,34,32,52,132.57125000229212,6.6521739130434785,1729.5652173913045,96.08695652173914,260.0,57,40.999432181877275
jax_0.3.15,jax/_src/scipy/special.py,1472,612,880,20,581,463,813,601,1276,5421.409681225779,13.993115318416523,164825.44024467497,9156.968902481944,11779.038226587474,44,33.174851541403065
jax_0.3.15,jax/_src/scipy/signal.py,616,388,440,20,263,272,485,283,757,2200.6742560816224,18.44106463878327,113698.50002146431,6316.583334525795,6165.506289823735,122,23.868206531154517
jax_0.3.15,jax/_src/scipy/linalg.py,850,547,617,22,382,260,505,404,765,3374.6853079196767,14.541884816753926,96318.63628747371,5351.035349304095,6623.531784305123,73,25.9900991956226
jax_0.3.15,jax/_src/scipy/__init__.py,13,0,0,0,0,0,0,0,0,0,0,0,0.0,0,1,100.0
jax_0.3.15,jax/_src/scipy/ndimage.py,137,79,95,10,39,25,50,49,75,239.34996748450132,6.410256410256411,2699.3797327476964,149.96554070820537,421.10323830864064,14,60.320456196276645
jax_0.3.15,jax/_src/scipy/fft.py,99,62,65,10,56,34,66,66,100,358.4311565840995,5.892857142857143,3561.8751060505174,197.88195033613985,604.4394119358453,26,63.43155706171496
jax_0.3.15,jax/_src/scipy/cluster/__init__.py,13,0,0,0,0,0,0,0,0,0,0,0,0.0,0,1,100.0
jax_0.3.15,jax/_src/scipy/cluster/vq.py,47,23,25,4,5,6,10,9,16,19.60964047443681,4.0,202.875200092308,11.270844449572667,50.718800023077,4,87.05149466182766
jax_0.3.15,jax/_src/scipy/optimize/line_search.py,425,198,319,18,193,158,293,211,451,1540.4028582187013,13.663212435233161,47578.25332041452,2643.2362955785848,3482.2157341069405,10,47.033442978905406
jax_0.3.15,jax/_src/scipy/optimize/minimize.py,128,43,55,5,11,7,12,16,19,49.663388279447084,2.727272727272727,207.27272727272725,11.515151515151514,76.0,5,75.62550362724534
jax_0.3.15,jax/_src/scipy/optimize/__init__.py,13,0,0,0,0,0,0,0,0,0,0,0,0.0,0,1,100.0
jax_0.3.15,jax/_src/scipy/optimize/_lbfgs.py,235,103,133,12,68,45,83,80,128,456.967023213677,7.323529411764706,5926.249771772058,329.236098431781,809.2067961455823,7,63.98077302828789
jax_0.3.15,jax/_src/scipy/optimize/bfgs.py,179,70,109,9,43,25,48,52,73,261.858709465171,5.023255813953488,2090.337987805785,116.1298882114325,416.1320994242998,2,70.19761433120354
jax_0.3.15,jax/_src/scipy/sparse/linalg.py,765,344,352,17,164,109,208,181,317,1276.1253970586217,10.78048780487805,25630.083088360396,1423.893504908911,2377.451146205376,26,45.80781318532471
jax_0.3.15,jax/_src/scipy/sparse/__init__.py,13,0,0,0,0,0,0,0,0,0,0,0,0.0,0,1,100.0
jax_0.3.15,jax/_src/scipy/stats/kde.py,270,195,203,15,112,74,143,127,217,821.0271102045793,9.575892857142858,14522.2683827161,806.7926879286722,1516.54457702956,43,41.10333161625921
jax_0.3.15,jax/_src/scipy/stats/norm.py,54,29,29,3,6,4,7,9,11,20.264662506490406,1.75,61.021056277764515,3.3900586820980285,34.86917501586544,1,85.91362934143528
jax_0.3.15,jax/_src/scipy/stats/nbinom.py,42,20,20,1,1,1,1,2,2,0.0,0.5,1.0,0.05555555555555555,2.0,1,98.47142826388624
jax_0.3.15,jax/_src/scipy/stats/laplace.py,43,22,24,0,0,0,0,0,0,0,0,0,0.0,0,1,100.0
jax_0.3.15,jax/_src/scipy/stats/chi2.py,41,19,19,1,1,1,1,2,2,0.0,0.5,1.0,0.05555555555555555,2.0,1,98.80361971046804
jax_0.3.15,jax/_src/scipy/stats/betabinom.py,47,25,23,1,1,1,1,2,2,0.0,0.5,1.0,0.05555555555555555,2.0,1,96.50036789165006
jax_0.3.15,jax/_src/scipy/stats/gennorm.py,32,15,15,5,16,10,20,21,30,75.60964047443682,3.125,411.77975838550884,22.87665324363938,131.76952268336282,1,86.75117272199955
jax_0.3.15,jax/_src/scipy/stats/beta.py,38,18,20,1,1,1,1,2,2,0.0,0.5,1.0,0.05555555555555555,2.0,1,99.4695805174867
jax_0.3.15,jax/_src/scipy/stats/__init__.py,13,0,0,0,0,0,0,0,0,0,0,0,0.0,0,1,100.0
jax_0.3.15,jax/_src/scipy/stats/gamma.py,36,18,18,1,1,1,1,2,2,0.0,0.5,1.0,0.05555555555555555,2.0,1,99.08805717012652
jax_0.3.15,jax/_src/scipy/stats/logistic.py,50,28,28,1,1,1,1,2,2,0.0,0.5,1.0,0.05555555555555555,2.0,1,95.06077065245223
jax_0.3.15,jax/_src/scipy/stats/dirichlet.py,55,28,33,9,22,14,27,31,41,126.63682062300134,5.5227272727272725,1121.7876781905554,62.321537677253076,203.1220487258619,5,79.77865752873493
jax_0.3.15,jax/_src/scipy/stats/bernoulli.py,37,17,18,2,4,3,4,6,7,10.0,1.0,18.094737505048094,1.0052631947248942,18.094737505048094,1,92.93197627008955
jax_0.3.15,jax/_src/scipy/stats/geom.py,34,17,17,2,4,3,4,6,7,10.0,1.0,18.094737505048094,1.0052631947248942,18.094737505048094,1,92.6125776683254
jax_0.3.15,jax/_src/scipy/stats/uniform.py,33,12,14,1,1,1,1,2,2,0.0,0.5,1.0,0.05555555555555555,2.0,1,100.0
jax_0.3.15,jax/_src/scipy/stats/cauchy.py,35,16,16,0,0,0,0,0,0,0,0,0,0.0,0,1,100.0
jax_0.3.15,jax/_src/scipy/stats/expon.py,32,14,14,1,1,1,1,2,2,0.0,0.5,1.0,0.05555555555555555,2.0,1,99.38367921311516
jax_0.3.15,jax/_src/scipy/stats/t.py,41,21,22,0,0,0,0,0,0,0,0,0,0.0,0,1,100.0
jax_0.3.15,jax/_src/scipy/stats/poisson.py,43,23,23,3,9,5,9,12,14,33.28421251514428,1.5,75.28421251514428,4.182456250841349,50.18947501009619,1,87.4904027555101
jax_0.3.15,jax/_src/scipy/stats/multivariate_normal.py,55,28,36,10,45,40,70,55,110,280.35267028370896,7.777777777777778,4946.274421571097,274.7930234206165,635.9495684877126,6,75.69830593242342
jax_0.3.15,jax/_src/scipy/stats/pareto.py,35,16,16,1,1,1,1,2,2,0.0,0.5,1.0,0.05555555555555555,2.0,1,99.45109031614453
jax_0.3.15,jax/_src/scipy/interpolate/__init__.py,13,0,0,0,0,0,0,0,0,0,0,0,0.0,0,1,100.0
jax_0.3.15,jax/_src/lax/svd.py,238,84,108,6,20,12,22,26,34,101.94833690207419,3.3,527.3893363754306,29.29940757641281,159.81495041679716,11,68.95872222114636
jax_0.3.15,jax/_src/lax/utils.py,117,72,85,4,18,12,23,22,35,83.05865002596161,2.5555555555555554,398.87138366700265,22.15952131483348,156.0801066523054,26,64.00998591879319
jax_0.3.15,jax/_src/lax/convolution.py,970,454,636,20,242,175,338,262,513,2002.8034653181992,13.96694214876033,57559.80776564399,3197.767098091333,4121.145999788712,106,30.398137834447567
jax_0.3.15,jax/_src/lax/qdwh.py,239,111,114,12,105,75,150,117,225,748.0153293635967,8.571428571428571,13249.989102053709,736.1105056696505,1545.832061906266,11,60.72883861965664
jax_0.3.15,jax/_src/lax/other.py,231,37,80,7,19,12,22,26,34,100.36210720983135,4.052631578947368,647.67111484702,35.98172860261222,159.81495041679716,5,66.29123013005469
jax_0.3.15,jax/_src/lax/stack.py,78,39,37,3,10,6,12,13,18,37.974168451037094,1.8,119.8942468677714,6.660791492653967,66.60791492653966,9,80.55207116522045
jax_0.3.15,jax/_src/lax/linalg.py,1973,1109,1366,21,535,439,760,556,1199,4941.155034367707,14.91588785046729,163084.50572456067,9060.250318031149,10933.610346195484,178,4.7317130123297675
jax_0.3.15,jax/_src/lax/__init__.py,18,3,3,0,0,0,0,0,0,0,0,0,0.0,0,1,100.0
jax_0.3.15,jax/_src/lax/parallel.py,1625,870,1037,21,364,253,467,385,720,3189.0759149106793,13.471153846153847,83303.92526158215,4627.9958478656745,6183.874537619231,242,4.756234967544162
jax_0.3.15,jax/_src/lax/lax.py,4756,2971,3370,24,1058,718,1314,1082,2032,10739.896199033947,14.903591682419659,305248.10799342784,16958.2282218571,20481.51308073609,696,0.0
jax_0.3.15,jax/_src/lax/windowed_reductions.py,853,439,711,15,218,134,263,233,397,1752.0675417354976,9.04816513761468,28249.11259917998,1569.3951443988879,3122.0818994277492,96,20.91057155910525
jax_0.3.15,jax/_src/lax/eigh.py,426,161,157,15,54,40,78,69,118,369.36728405095516,10.833333333333334,7808.730430581428,433.8183572545238,720.805885899824,17,49.26762851757756
jax_0.3.15,jax/_src/lax/slicing.py,2083,911,1342,19,362,232,434,381,666,3157.6548338795487,11.38950276243094,65034.61916515827,3613.0343980643484,5710.0490268705535,207,8.574444873623905
jax_0.3.15,jax/_src/lax/ann.py,366,108,174,8,26,19,33,34,52,146.2114326716684,5.076923076923077,1343.09019009009,74.61612167167166,264.5480677450177,22,63.34787830242616
jax_0.3.15,jax/_src/lax/fft.py,168,118,123,8,56,39,70,64,109,349.21187563522585,5.0,3270.0,181.66666666666666,654.0,17,55.98231466193795
jax_0.3.15,jax/_src/lax/control_flow/common.py,140,81,91,7,16,9,16,23,25,83.65148445440323,3.5,395.81167115498863,21.989537286388256,113.08904890142533,17,67.57508987360868
jax_0.3.15,jax/_src/lax/control_flow/solves.py,470,223,269,12,93,58,111,105,169,651.1613194417009,7.161290322580645,8125.969784896696,451.44276582759426,1134.7074924855747,37,50.6342628763337
jax_0.3.15,jax/_src/lax/control_flow/__init__.py,34,7,17,0,0,0,0,0,0,0,0,0,0.0,0,1,100.0
jax_0.3.15,jax/_src/lax/control_flow/remat_impl.py,152,85,98,6,13,8,15,19,23,63.61549134016113,3.4615384615384617,338.2003828010854,18.788910155615856,97.70233280920246,12,68.77382933491992
jax_0.3.15,jax/_src/lax/control_flow/conditionals.py,677,388,476,12,147,87,166,159,253,1101.3713846995995,6.775510204081633,12535.7738104503,696.43187835835,1850.159387686942,126,27.874970379905974
jax_0.3.15,jax/_src/lax/control_flow/for_loop.py,833,475,542,10,142,85,154,152,239,1048.4833719185385,5.422535211267606,9393.211973936784,521.8451096631547,1732.2546757130171,96,33.58027405429257
jax_0.3.15,jax/_src/lax/control_flow/loops.py,1909,958,1239,16,620,378,724,636,1102,5815.197131270028,9.341935483870968,95874.38761429308,5326.354867460726,10262.797016723362,248,0.7497704311757522
jax_0.3.15,jax/_src/image/scale.py,340,122,156,13,96,65,126,109,191,680.2621164050653,8.53125,11028.544851463852,612.6969361924362,1292.723206032393,29,56.681091519813116
jax_0.3.15,jax/_src/image/__init__.py,13,0,0,0,0,0,0,0,0,0,0,0,0.0,0,1,100.0
jax_0.3.15,jax/_src/lib/xla_bridge.py,540,257,309,15,76,50,96,91,146,533.4458499558403,9.473684210526315,9001.307533916934,500.07264077316296,950.1380174690097,54,47.58679787874039
jax_0.3.15,jax/_src/lib/__init__.py,135,62,71,4,6,4,7,10,11,23.509775004326936,2.3333333333333335,85.26282110210897,4.736823394561609,36.541209043760986,7,78.11885955666926
jax_0.3.15,jax/_src/lib/mlir/__init__.py,16,1,1,0,0,0,0,0,0,0,0,0,0.0,0,1,100.0
jax_0.3.15,jax/_src/lib/mlir/dialects/__init__.py,34,12,12,0,0,0,0,0,0,0,0,0,0.0,0,3,100.0
jax_0.3.15,jax/_src/numpy/setops.py,326,214,255,13,76,64,114,89,178,522.9482073575467,9.75,11238.635369442185,624.3686316356769,1152.6805507120189,46,42.724061942108825
jax_0.3.15,jax/_src/numpy/polynomial.py,318,212,253,14,119,87,164,133,251,873.7862827424517,9.647058823529411,17083.74389264535,949.0968829247417,1770.8758913107986,42,39.45742101447898
jax_0.3.15,jax/_src/numpy/linalg.py,607,400,446,19,291,283,479,310,762,2462.509347541739,15.637457044673539,98616.16539149388,5478.675855082994,6306.406796818969,89,27.83912322807802
jax_0.3.15,jax/_src/numpy/__init__.py,13,0,0,0,0,0,0,0,0,0,0,0,0.0,0,1,100.0
jax_0.3.15,jax/_src/numpy/util.py,409,253,262,12,101,64,118,113,182,715.4989097665853,7.00990099009901,8701.197825554174,483.39987919745414,1241.2725711595644,62,44.11734247192164
jax_0.3.15,jax/_src/numpy/ndarray.py,296,331,246,1,2,1,2,3,3,2.0,0.5,2.3774437510817346,0.1320802083934297,4.754887502163469,105,44.409110705821625
jax_0.3.15,jax/_src/numpy/vectorize.py,313,118,147,14,52,32,58,66,90,349.7258342521433,7.8076923076923075,4247.3492523338045,235.96384735187803,543.9954707422607,22,61.161613770575634
jax_0.3.15,jax/_src/numpy/lax_numpy.py,5119,3430,3896,26,1655,1222,2289,1681,3511,17818.4900879762,17.980060422960726,676423.0017280808,37579.05565156005,37620.73017642819,926,0.0
jax_0.3.15,jax/_src/numpy/index_tricks.py,321,112,102,11,34,28,47,45,75,211.02748440752185,7.602941176470588,3131.5677030909283,173.97598350505157,411.8889822247256,23,53.99283420790172
jax_0.3.15,jax/_src/numpy/ufuncs.py,713,520,535,21,141,100,189,162,289,1098.915406566584,14.074468085106384,29854.99605375455,1658.6108918752527,2121.2166508336563,45,27.94061811566503
jax_0.3.15,jax/_src/numpy/reductions.py,592,390,475,15,113,77,142,128,219,829.283581687044,9.424778761061948,14448.185840707965,802.6769911504425,1533.0,74,24.84635834808783
jax_0.3.15,jax/_src/numpy/fft.py,281,175,199,13,119,94,180,132,274,868.5890301694795,9.831932773109244,18977.242578016245,1054.2912543342359,1930.1639887042163,46,40.46616917872656
jax_0.3.15,.github/workflows/parse_logs.py,73,37,43,1,6,3,6,7,9,15.509775004326936,0.5,12.63309714925922,0.701838730514401,25.26619429851844,8,81.95573939497751
jax_0.3.15,examples/kernel_lsq.py,96,53,48,6,23,13,25,29,38,119.55169999363824,3.260869565217391,601.9672102658079,33.44262279254488,184.60327781484776,3,74.7704539833208
jax_0.3.15,examples/control.py,222,133,130,7,74,46,90,81,136,479.1510335109456,4.256756756756757,3670.259109778073,203.9032838765596,862.2196003923091,7,58.67953292687218
jax_0.3.15,examples/examples_test.py,66,39,37,1,2,1,2,3,3,2.0,0.5,2.3774437510817346,0.1320802083934297,4.754887502163469,5,87.4194514304887
jax_0.3.15,examples/spmd_mnist_classifier_fromscratch.py,128,84,79,5,38,24,44,43,68,211.03088598529305,2.8947368421052633,1068.117378030834,59.33985433504634,368.9860033197427,11,66.36779369409138
jax_0.3.15,examples/control_test.py,245,180,170,8,103,72,138,111,210,712.7095542998715,5.359223300970874,7646.686283760237,424.8159046533465,1426.8273319335224,14,43.21372594403545
jax_0.3.15,examples/mnist_classifier.py,97,59,60,5,17,11,20,22,31,81.0965087756926,2.9411764705882355,406.5952358169301,22.58862421205167,138.24238017775622,6,72.0807942967749
jax_0.3.15,examples/__init__.py,13,0,0,0,0,0,0,0,0,0,0,0,0.0,0,1,100.0
jax_0.3.15,examples/onnx2xla.py,134,80,88,9,46,29,57,55,86,282.6131749916034,5.576086956521739,2772.41334610088,154.02296367227112,497.19693536312076,23,60.074636506684904
jax_0.3.15,examples/gaussian_process_regression.py,132,88,86,10,91,57,110,101,167,625.4285932069549,6.043956043956044,6720.403568030247,373.35575377945815,1111.9213176195499,6,62.73435630825075
jax_0.3.15,examples/datasets.py,93,54,49,5,11,7,11,16,18,49.663388279447084,2.5,180.0,10.0,72.0,5,74.69042639190147
jax_0.3.15,examples/mnist_classifier_fromscratch.py,95,61,60,5,33,21,38,38,59,178.07464641326578,2.878787878787879,891.3525367530696,49.51958537517053,309.6277232931715,9,68.05283320166164
jax_0.3.15,examples/mnist_vae.py,137,86,87,8,41,26,46,49,72,243.65963218934144,4.487804878048781,1814.2360003619096,100.79088890899499,404.259108776295,5,62.96836821845701
jax_0.3.15,examples/differentially_private_sgd.py,256,121,151,8,43,26,48,51,74,257.3293844521902,4.465116279069767,1874.2748664821165,104.1263814712287,419.7594753058907,14,62.77063561496691
jax_0.3.15,examples/advi.py,139,81,78,6,15,9,15,21,24,74.11313393845472,3.0,316.2468544400708,17.569269691115046,105.41561814669026,3,72.02332085175419
jax_0.3.15,examples/jax_cpp/prog.py,19,4,3,1,2,1,2,3,3,2.0,0.5,2.3774437510817346,0.1320802083934297,4.754887502163469,1,55.04800712070099
jax_0.3.15,jaxlib/gpu_linalg.py,71,38,44,3,4,7,9,7,16,12.75488750216347,3.375,151.59716579111063,8.422064766172813,44.91767875292167,6,79.55977123619319
jax_0.3.15,jaxlib/mhlo_helpers.py,60,12,38,2,5,3,6,7,9,13.60964047443681,1.2,30.319433158222125,1.6844129532345624,25.26619429851844,7,94.63086903779396
jax_0.3.15,jaxlib/init.py,15,1,1,0,0,0,0,0,0,0,0,0,0.0,0,1,100.0
jax_0.3.15,jaxlib/pocketfft.py,148,82,100,12,50,47,81,62,128,325.2123594973901,9.72,7407.972881530936,411.5540489739409,762.1371277295201,28,55.85988474177422
jax_0.3.15,jaxlib/gpu_solver.py,477,242,395,14,116,152,239,130,391,848.8287643436047,14.422413793103448,39600.2823130851,2200.0156840602835,2745.7458148941255,44,30.189482138585046
jax_0.3.15,jaxlib/setup.py,74,17,54,2,4,2,4,6,6,10.0,1.0,15.509775004326936,0.861654166907052,15.509775004326936,4,89.14876322642513
jax_0.3.15,jaxlib/gpu_prng.py,68,36,41,4,12,9,16,16,25,51.01955000865388,2.6666666666666665,266.66666666666663,14.814814814814813,100.0,10,77.58738431958821
jax_0.3.15,jaxlib/gpu_sparse.py,338,147,252,5,48,26,52,53,78,279.6878405090523,2.7083333333333335,1210.023196026476,67.22351089035978,446.77779545592955,26,45.25145325168511
jax_0.3.15,jaxlib/lapack.py,602,354,516,10,233,242,401,243,643,1865.5746526533208,8.605150214592275,43848.87189629239,2436.0484386829103,5095.654439818517,77,21.427578271005995
